root_id,hemisphere,type,column_id,x,y,p,q
720575940603042272,right,Mi1,1,-6,13,12,1
720575940603200428,right,Mi1,2,-8,2,9,-7
720575940603327916,right,Mi1,3,6,-12,-12,0
720575940603935334,right,Mi1,4,-5,-21,-6,-15
720575940633953965,right,Mi1,5,-1,16,9,7
720575940604151008,right,Mi1,6,-2,-4,0,-4
720575940604191456,right,Mi1,7,-6,-6,3,-9
720575940604255712,right,Mi1,8,-4,26,17,9
720575940604508332,right,Mi1,9,4,9,0,9
720575940604687532,right,Mi1,10,5,-15,-13,-2
720575940604714929,right,Mi1,11,7,-14,-14,0
720575940604947657,right,Mi1,12,-7,9,11,-2
720575940605029856,right,Mi1,13,-1,-26,-12,-14
720575940638990911,right,Mi1,14,0,-27,-14,-13
720575940605215665,right,Mi1,15,2,-3,-4,1
720575940605262880,right,Mi1,16,-2,-16,-6,-10
720575940630193255,right,Mi1,17,1,-5,-4,-1
720575940605478321,right,Mi1,18,5,-16,-13,-3
720575940606042814,right,Mi1,19,-7,17,15,2
720575940613120741,right,Mi1,20,3,-11,-9,-2
720575940606333385,right,Mi1,21,-2,19,11,8
720575940606654386,right,Mi1,22,-1,3,2,1
720575940606665564,right,Mi1,23,-3,-16,-5,-11
720575940606712777,right,Mi1,24,-1,-10,-4,-6
720575940606721801,right,Mi1,25,-9,3,10,-7
720575940606944898,right,Mi1,26,1,-3,-3,0
720575940636050271,right,Mi1,27,0,-25,-13,-12
720575940607385283,right,Mi1,28,5,6,-2,8
720575940607730780,right,Mi1,29,-1,-3,-1,-2
720575940607787138,right,Mi1,30,6,16,2,14
720575940608157635,right,Mi1,31,0,16,8,8
720575940608211780,right,Mi1,32,0,12,6,6
720575940608278281,right,Mi1,33,3,18,6,12
720575940608309771,right,Mi1,34,6,18,3,15
720575940629485041,right,Mi1,35,1,-24,-13,-11
720575940608431061,right,Mi1,36,6,8,-2,10
720575940608553155,right,Mi1,37,1,5,1,4
720575940608810798,right,Mi1,38,0,-2,-1,-1
720575940608927534,right,Mi1,39,0,20,10,10
720575940609063800,right,Mi1,40,-2,-6,-1,-5
720575940620343000,right,Mi1,41,-3,28,17,11
720575940609453010,right,Mi1,42,-1,14,8,6
720575940609463620,right,Mi1,43,-5,18,14,4
720575940609555406,right,Mi1,44,5,-10,-10,0
720575940610007598,right,Mi1,45,-5,-1,4,-5
720575940610177941,right,Mi1,46,-5,15,12,3
720575940618350804,right,Mi1,47,-9,-1,8,-9
720575940610277956,right,Mi1,48,-4,-22,-7,-15
720575940610316664,right,Mi1,49,4,-4,-6,2
720575940610418296,right,Mi1,50,-2,21,12,9
720575940639131876,right,Mi1,51,0,-19,-10,-9
720575940610438898,right,Mi1,52,-1,-22,-10,-12
720575940610460402,right,Mi1,53,5,14,2,12
720575940610533582,right,Mi1,54,-4,3,5,-2
720575940629500777,right,Mi1,55,-4,-11,-2,-9
720575940610578786,right,Mi1,56,1,-13,-8,-5
720575940610580578,right,Mi1,57,6,-11,-12,1
720575940610674090,right,Mi1,58,3,12,3,9
720575940610695338,right,Mi1,59,-2,2,3,-1
720575940610739882,right,Mi1,60,-8,8,12,-4
720575940610740394,right,Mi1,61,-4,-4,2,-6
720575940617264245,right,Mi1,62,0,-29,-15,-14
720575940610772174,right,Mi1,63,4,12,2,10
720575940610903854,right,Mi1,64,4,-23,-16,-7
720575940614850088,right,Mi1,65,-1,28,15,13
720575940610952198,right,Mi1,66,2,15,5,10
720575940610952982,right,Mi1,67,-2,-13,-5,-8
720575940610953478,right,Mi1,68,3,16,5,11
720575940610979590,right,Mi1,69,1,8,3,5
720575940611054798,right,Mi1,70,-4,21,14,7
720575940611126648,right,Mi1,71,-2,-3,0,-3
720575940629277289,right,Mi1,72,0,-28,-14,-14
720575940617282747,right,Mi1,73,2,2,-1,3
720575940611216867,right,Mi1,74,-1,-9,-4,-5
720575940611352469,right,Mi1,75,-6,14,13,1
720575940611361378,right,Mi1,76,-3,-4,1,-5
720575940611362965,right,Mi1,77,2,-5,-5,0
720575940619780731,right,Mi1,78,2,20,8,12
720575940611489746,right,Mi1,79,2,1,-2,3
720575940611524835,right,Mi1,80,4,13,2,11
720575940611551857,right,Mi1,81,6,-2,-7,5
720575940611625238,right,Mi1,82,-7,7,10,-3
720575940611685489,right,Mi1,83,2,-21,-13,-8
720575940611686513,right,Mi1,84,-2,12,8,4
720575940611704689,right,Mi1,85,4,-22,-15,-7
720575940611751347,right,Mi1,86,-5,-7,1,-8
720575940611778290,right,Mi1,87,1,11,4,7
720575940611780450,right,Mi1,88,7,4,-5,9
720575940611838577,right,Mi1,89,1,-19,-11,-8
720575940611882725,right,Mi1,90,-4,5,6,-1
720575940611884773,right,Mi1,91,-1,6,4,2
720575940612031694,right,Mi1,92,0,9,4,5
720575940612109619,right,Mi1,93,-6,3,7,-4
720575940612162227,right,Mi1,94,5,18,4,14
720575940612334810,right,Mi1,95,4,-21,-15,-6
720575940612352114,right,Mi1,96,1,-10,-6,-4
720575940612393000,right,Mi1,97,-5,2,6,-4
720575940612410481,right,Mi1,98,-1,-12,-5,-7
720575940612556438,right,Mi1,99,4,15,3,12
720575940612562525,right,Mi1,100,2,-10,-7,-3
720575940612727550,right,Mi1,101,-7,6,10,-4
720575940637260133,right,Mi1,102,3,13,3,10
720575940627920792,right,Mi1,103,7,9,-3,12
720575940612855219,right,Mi1,104,-1,-27,-13,-14
720575940612944298,right,Mi1,105,3,22,8,14
720575940613073918,right,Mi1,106,-7,11,12,-1
720575940613127574,right,Mi1,107,8,-2,-9,7
720575940630446970,right,Mi1,108,-3,-12,-3,-9
720575940613416744,right,Mi1,109,4,-5,-7,2
720575940629500265,right,Mi1,110,-7,0,7,-7
720575940613616559,right,Mi1,111,2,-24,-14,-10
720575940613638290,right,Mi1,112,-6,1,6,-5
720575940613676975,right,Mi1,113,-2,4,4,0
720575940613700305,right,Mi1,114,2,-13,-9,-4
720575940613709983,right,Mi1,115,-4,2,5,-3
720575940613857251,right,Mi1,116,-1,-8,-3,-5
720575940613919135,right,Mi1,117,-8,-2,7,-9
720575940635540887,right,Mi1,118,3,1,-3,4
720575940613956242,right,Mi1,119,-2,6,5,1
720575940613994898,right,Mi1,120,-1,-1,0,-1
720575940614047500,right,Mi1,121,-8,4,10,-6
720575940614104774,right,Mi1,122,-5,9,9,0
720575940640879779,right,Mi1,123,-8,10,13,-3
720575940625061885,right,Mi1,124,1,-7,-5,-2
720575940614212258,right,Mi1,125,5,9,-1,10
720575940614282134,right,Mi1,126,3,11,2,9
720575940614448059,right,Mi1,127,0,15,7,8
720575940614486782,right,Mi1,128,3,-22,-14,-8
720575940614503285,right,Mi1,129,0,-13,-7,-6
720575940614518678,right,Mi1,130,2,12,4,8
720575940614545851,right,Mi1,131,-6,20,16,4
720575940614570705,right,Mi1,132,2,4,0,4
720575940614650163,right,Mi1,133,-3,20,13,7
720575940622000993,right,Mi1,134,-5,-18,-4,-14
720575940614750870,right,Mi1,135,-3,-22,-8,-14
720575940614779026,right,Mi1,136,0,3,1,2
720575940606057900,right,Mi1,137,5,-7,-9,2
720575940614924946,right,Mi1,138,0,27,13,14
720575940614935249,right,Mi1,139,1,-14,-8,-6
720575940631369078,right,Mi1,140,3,8,1,7
720575940614968938,right,Mi1,141,5,-23,-17,-6
720575940621337025,right,Mi1,142,-2,-18,-7,-11
720575940615088034,right,Mi1,143,-4,16,12,4
720575940628423592,right,Mi1,144,7,-11,-13,2
720575940615266866,right,Mi1,145,0,4,2,2
720575940615279419,right,Mi1,146,1,-6,-4,-2
720575940615420358,right,Mi1,147,1,21,9,12
720575940615649366,right,Mi1,148,-7,-11,1,-12
720575940615658713,right,Mi1,149,6,-14,-13,-1
720575940615702621,right,Mi1,150,-8,5,10,-5
720575940615811807,right,Mi1,151,-3,-14,-4,-10
720575940615836450,right,Mi1,152,3,-15,-11,-4
720575940615908353,right,Mi1,153,8,0,-8,8
720575940615912916,right,Mi1,154,-8,0,8,-8
720575940630600951,right,Mi1,155,-8,13,14,-1
720575940616085917,right,Mi1,156,-9,1,9,-8
720575940616095259,right,Mi1,157,-1,-7,-3,-4
720575940616097653,right,Mi1,158,3,-5,-6,1
720575940613102053,right,Mi1,159,7,7,-4,11
720575940616111221,right,Mi1,160,-2,20,12,8
720575940618902811,right,Mi1,161,4,-14,-11,-3
720575940616168276,right,Mi1,162,-4,-2,3,-5
720575940616176852,right,Mi1,163,-9,7,12,-5
720575940616304925,right,Mi1,164,-1,-2,0,-2
720575940616367133,right,Mi1,165,4,16,4,12
720575940616496102,right,Mi1,166,0,18,9,9
720575940616553541,right,Mi1,167,0,-17,-9,-8
720575940616558405,right,Mi1,168,-1,17,9,8
720575940616572992,right,Mi1,169,0,-18,-9,-9
720575940616748096,right,Mi1,170,-5,1,5,-4
720575940616787061,right,Mi1,171,6,-20,-16,-4
720575940628618920,right,Mi1,172,1,22,10,12
720575940628729617,right,Mi1,173,2,-25,-15,-10
720575940617027257,right,Mi1,174,4,-15,-12,-3
720575940617029009,right,Mi1,175,-6,-7,2,-9
720575940617037969,right,Mi1,176,-2,13,8,5
720575940617076258,right,Mi1,177,-2,-1,1,-2
720575940609758217,right,Mi1,178,2,11,3,8
720575940617213557,right,Mi1,179,-5,-16,-3,-13
720575940617320331,right,Mi1,180,2,-27,-16,-11
720575940628314643,right,Mi1,181,1,-4,-3,-1
720575940617449506,right,Mi1,182,7,-10,-12,2
720575940617509716,right,Mi1,183,-5,-15,-3,-12
720575940617578267,right,Mi1,184,-6,-5,3,-8
720575940617620509,right,Mi1,185,2,-11,-8,-3
720575940617637204,right,Mi1,186,-1,26,14,12
720575940617817693,right,Mi1,187,3,21,7,14
720575940617839832,right,Mi1,188,-5,17,13,4
720575940617882342,right,Mi1,189,6,13,0,13
720575940636293739,right,Mi1,190,-3,-5,0,-5
720575940613508210,right,Mi1,191,-1,-11,-5,-6
720575940618995028,right,Mi1,192,7,10,-2,12
720575940618013745,right,Mi1,193,-5,4,7,-3
720575940622893150,right,Mi1,194,0,-5,-3,-2
720575940618148766,right,Mi1,195,-3,-1,2,-3
720575940618156702,right,Mi1,196,-1,8,5,3
720575940606398240,right,Mi1,197,0,-20,-10,-10
720575940638102384,right,Mi1,198,6,2,-5,7
720575940627088330,right,Mi1,199,0,-12,-6,-6
720575940618358838,right,Mi1,200,-5,12,11,1
720575940618364325,right,Mi1,201,-8,9,12,-3
720575940618389054,right,Mi1,202,-1,27,14,13
720575940618420278,right,Mi1,203,3,-1,-4,3
720575940618490782,right,Mi1,204,5,-2,-6,4
720575940618491038,right,Mi1,205,5,-6,-8,2
720575940628589032,right,Mi1,206,-3,5,5,0
720575940618710813,right,Mi1,207,1,29,13,16
720575940618728606,right,Mi1,208,5,-21,-16,-5
720575940618739136,right,Mi1,209,-3,-8,-1,-7
720575940618795099,right,Mi1,210,-6,8,10,-2
720575940618826314,right,Mi1,211,-7,-1,6,-7
720575940628637672,right,Mi1,212,2,-16,-10,-6
720575940619121713,right,Mi1,213,3,-4,-5,1
720575940619213771,right,Mi1,214,-5,3,6,-3
720575940627967101,right,Mi1,215,6,7,-3,10
720575940619265140,right,Mi1,216,2,19,7,12
720575940619308653,right,Mi1,217,6,15,1,14
720575940619962422,right,Mi1,218,2,10,3,7
720575940619471440,right,Mi1,219,6,-4,-8,4
720575940619519061,right,Mi1,220,2,-6,-5,-1
720575940619619510,right,Mi1,221,-7,3,8,-5
720575940619624374,right,Mi1,222,-3,26,16,10
720575940619624630,right,Mi1,223,-2,26,15,11
720575940636275124,right,Mi1,224,0,5,2,3
720575940636051551,right,Mi1,225,2,-26,-15,-11
720575940619876890,right,Mi1,226,5,19,4,15
720575940619905919,right,Mi1,227,-7,5,9,-4
720575940619944360,right,Mi1,228,-7,1,7,-6
720575940627757208,right,Mi1,229,5,2,-4,6
720575940619967435,right,Mi1,230,2,9,2,7
720575940619977087,right,Mi1,231,4,-12,-10,-2
720575940619997121,right,Mi1,232,-4,13,10,3
720575940627723416,right,Mi1,233,4,-13,-11,-2
720575940632787816,right,Mi1,234,1,3,0,3
720575940647860532,right,Mi1,235,4,11,1,10
720575940620101870,right,Mi1,236,-1,4,3,1
720575940620115541,right,Mi1,237,-2,27,15,12
720575940631284342,right,Mi1,238,-8,-3,6,-9
720575940632129295,right,Mi1,239,-6,6,9,-3
720575940620139781,right,Mi1,240,-4,-3,2,-5
720575940620159960,right,Mi1,241,2,-17,-11,-6
720575940620183066,right,Mi1,242,-4,6,7,-1
720575940620210014,right,Mi1,243,-1,-21,-10,-11
720575940620233899,right,Mi1,244,-4,-12,-2,-10
720575940620298754,right,Mi1,245,-5,-3,3,-6
720575940615240103,right,Mi1,246,-4,15,11,4
720575940620415568,right,Mi1,247,-4,-15,-4,-11
720575940632932143,right,Mi1,248,-6,0,6,-6
720575940620462177,right,Mi1,249,2,-12,-8,-4
720575940643285645,right,Mi1,250,-1,1,1,0
720575940620500801,right,Mi1,251,-1,-14,-6,-8
720575940620525076,right,Mi1,252,3,23,8,15
720575940620552973,right,Mi1,253,5,16,3,13
720575940620655854,right,Mi1,254,3,-24,-15,-9
720575940620728710,right,Mi1,255,-6,-13,-1,-12
720575940620739494,right,Mi1,256,5,-20,-15,-5
720575940622913285,right,Mi1,257,2,21,8,13
720575940620780270,right,Mi1,258,-4,-17,-5,-12
720575940620811892,right,Mi1,259,-7,-5,4,-9
720575940620826900,right,Mi1,260,-3,19,12,7
720575940620857776,right,Mi1,261,-1,13,7,6
720575940620859574,right,Mi1,262,1,-11,-7,-4
720575940620916389,right,Mi1,263,-3,4,5,-1
720575940620922644,right,Mi1,264,-1,-6,-2,-4
720575940621003457,right,Mi1,265,-6,-1,5,-6
720575940621096686,right,Mi1,266,-1,-25,-12,-13
720575940621304229,right,Mi1,267,-6,2,7,-5
720575940621181424,right,Mi1,268,7,-6,-10,4
720575940621183624,right,Mi1,269,2,-19,-12,-7
720575940621189358,right,Mi1,270,1,-8,-5,-3
720575940629040714,right,Mi1,271,4,6,-1,7
720575940623946851,right,Mi1,272,3,-2,-4,2
720575940621252451,right,Mi1,273,-6,23,17,6
720575940621263014,right,Mi1,274,6,4,-4,8
720575940619899294,right,Mi1,275,-8,-1,7,-8
720575940621269603,right,Mi1,276,2,3,-1,4
720575940616848140,right,Mi1,277,7,-3,-9,6
720575940644639904,right,Mi1,278,-5,10,10,0
720575940621308912,right,Mi1,279,-4,8,8,0
720575940621314440,right,Mi1,280,-6,-14,-1,-13
720575940621321608,right,Mi1,281,-9,2,10,-8
720575940621447350,right,Mi1,282,0,26,13,13
720575940621491226,right,Mi1,283,-4,4,6,-2
720575940621505718,right,Mi1,284,0,25,12,13
720575940621526655,right,Mi1,285,6,-18,-15,-3
720575940621528703,right,Mi1,286,0,-24,-12,-12
720575940621548543,right,Mi1,287,-5,13,11,2
720575940637238373,right,Mi1,288,-1,30,16,14
720575940621585276,right,Mi1,289,-1,11,6,5
720575940639022911,right,Mi1,290,5,-24,-17,-7
720575940621643132,right,Mi1,291,7,2,-6,8
720575940621647996,right,Mi1,292,-4,18,13,5
720575940621683973,right,Mi1,293,4,-17,-13,-4
720575940618392157,right,Mi1,294,1,-20,-11,-9
720575940621723283,right,Mi1,295,-2,29,16,13
720575940660975745,right,Mi1,296,1,-18,-10,-8
720575940621756336,right,Mi1,297,7,-9,-12,3
720575940621852042,right,Mi1,298,-5,5,7,-2
720575940621902674,right,Mi1,299,-4,12,10,2
720575940630416766,right,Mi1,300,4,-18,-13,-5
720575940621959185,right,Mi1,301,-5,16,13,3
720575940622033110,right,Mi1,302,2,17,6,11
720575940622087245,right,Mi1,303,-5,22,16,6
720575940619393349,right,Mi1,304,6,5,-4,9
720575940622206442,right,Mi1,305,-7,4,9,-5
720575940626861712,right,Mi1,306,3,7,0,7
720575940622211241,right,Mi1,307,5,-25,-18,-7
720575940621699521,right,Mi1,308,-5,8,9,-1
720575940622263815,right,Mi1,309,-6,12,12,0
720575940625383944,right,Mi1,310,2,22,9,13
720575940622286669,right,Mi1,311,-7,15,14,1
720575940622304895,right,Mi1,312,4,-7,-8,1
720575940622447344,right,Mi1,313,7,3,-6,9
720575940622468681,right,Mi1,314,-9,5,11,-6
720575940622490381,right,Mi1,315,-3,-6,0,-6
720575940622516104,right,Mi1,316,5,-4,-7,3
720575940627216484,right,Mi1,317,-5,-4,3,-7
720575940622617736,right,Mi1,318,4,-19,-14,-5
720575940622622502,right,Mi1,319,-2,5,4,1
720575940622697992,right,Mi1,320,-2,-5,-1,-4
720575940622718344,right,Mi1,321,8,4,-6,10
720575940622747772,right,Mi1,322,2,26,11,15
720575940615261235,right,Mi1,323,-7,-13,0,-13
720575940622780118,right,Mi1,324,3,24,9,15
720575940622838408,right,Mi1,325,5,1,-5,6
720575940622864169,right,Mi1,326,2,16,6,10
720575940622930019,right,Mi1,327,5,3,-4,7
720575940622933444,right,Mi1,328,5,-9,-10,1
720575940622954189,right,Mi1,329,0,24,12,12
720575940623989247,right,Mi1,330,3,3,-2,5
720575940622977791,right,Mi1,331,1,-15,-9,-6
720575940621269696,right,Mi1,332,4,-26,-17,-9
720575940623160614,right,Mi1,333,0,-21,-11,-10
720575940623221774,right,Mi1,334,1,-26,-14,-12
720575940633004359,right,Mi1,335,2,8,2,6
720575940623328184,right,Mi1,336,0,23,11,12
720575940623530032,right,Mi1,337,-5,-6,2,-8
720575940623566472,right,Mi1,338,-1,0,1,-1
720575940623571555,right,Mi1,339,6,11,-1,12
720575940623604149,right,Mi1,340,-4,17,12,5
720575940623627460,right,Mi1,341,6,-17,-15,-2
720575940623628105,right,Mi1,342,2,-15,-10,-5
720575940630505463,right,Mi1,343,-3,27,16,11
720575940623666320,right,Mi1,344,-2,-15,-6,-9
720575940629077191,right,Mi1,345,3,-12,-9,-3
720575940623738365,right,Mi1,346,-7,-9,2,-11
720575940621407470,right,Mi1,347,-5,-13,-2,-11
720575940631147484,right,Mi1,348,3,14,4,10
720575940623820523,right,Mi1,349,-5,-14,-2,-12
720575940623877828,right,Mi1,350,1,15,6,9
720575940623942408,right,Mi1,351,-1,-17,-8,-9
720575940623948432,right,Mi1,352,-2,28,16,12
720575940637643950,right,Mi1,353,2,24,10,14
720575940624121322,right,Mi1,354,-2,-26,-11,-15
720575940624136485,right,Mi1,355,-7,-6,4,-10
720575940624177900,right,Mi1,356,0,22,11,11
720575940624185904,right,Mi1,357,4,17,4,13
720575940624217528,right,Mi1,358,-3,17,11,6
720575940624234644,right,Mi1,359,2,23,9,14
720575940624292158,right,Mi1,360,-5,19,14,5
720575940624322341,right,Mi1,361,0,-7,-4,-3
720575940624328167,right,Mi1,362,2,-20,-12,-8
720575940624335399,right,Mi1,363,7,-4,-9,5
720575940624654570,right,Mi1,364,4,4,-2,6
720575940633149324,right,Mi1,365,4,7,-1,8
720575940624374013,right,Mi1,366,-5,-20,-5,-15
720575940624402761,right,Mi1,367,-6,-15,-2,-13
720575940619333701,right,Mi1,368,-4,-20,-6,-14
720575940624467644,right,Mi1,369,5,-5,-8,3
720575940618786205,right,Mi1,370,-3,21,13,8
720575940624599836,right,Mi1,371,6,-5,-9,4
720575940624624432,right,Mi1,372,1,-2,-2,0
720575940618697506,right,Mi1,373,1,-21,-12,-9
720575940629763663,right,Mi1,374,2,13,4,9
720575940624689610,right,Mi1,375,-6,7,9,-2
720575940624733769,right,Mi1,376,-7,-10,2,-12
720575940624769771,right,Mi1,377,0,7,3,4
720575940624785934,right,Mi1,378,-3,18,12,6
720575940634360546,right,Mi1,379,3,-17,-12,-5
720575940624940675,right,Mi1,380,-1,29,15,14
720575940624950676,right,Mi1,381,-8,-9,3,-12
720575940624951560,right,Mi1,382,3,-6,-6,0
720575940625153836,right,Mi1,383,-6,11,11,0
720575940625223954,right,Mi1,384,-6,-2,5,-7
720575940625225085,right,Mi1,385,-3,-18,-6,-12
720575940625269822,right,Mi1,386,-6,19,15,4
720575940625273118,right,Mi1,387,-1,-15,-7,-8
720575940625276958,right,Mi1,388,3,19,6,13
720575940625410441,right,Mi1,389,-6,-16,-2,-14
720575940625428368,right,Mi1,390,-6,-9,1,-10
720575940625448394,right,Mi1,391,4,-3,-6,3
720575940625474106,right,Mi1,392,-4,7,7,0
720575940625478458,right,Mi1,393,-1,22,12,10
720575940625483322,right,Mi1,394,-7,-8,3,-11
720575940625496720,right,Mi1,395,0,-22,-11,-11
720575940625303788,right,Mi1,396,-1,10,6,4
720575940625547909,right,Mi1,397,-3,-19,-7,-12
720575940625568010,right,Mi1,398,-3,22,14,8
720575940625577912,right,Mi1,399,-4,-24,-8,-16
720575940625581605,right,Mi1,400,1,-29,-16,-13
720575940625614101,right,Mi1,401,-2,-19,-8,-11
720575940625668868,right,Mi1,402,3,26,10,16
720575940629504105,right,Mi1,403,-2,-12,-4,-8
720575940625724618,right,Mi1,404,-1,20,11,9
720575940625800209,right,Mi1,405,3,10,2,8
720575940625813054,right,Mi1,406,1,-25,-14,-11
720575940625817768,right,Mi1,407,-5,-10,0,-10
720575940625840146,right,Mi1,408,-6,-4,4,-8
720575940625924995,right,Mi1,409,0,-3,-2,-1
720575940634589922,right,Mi1,410,-2,-2,1,-3
720575940625981327,right,Mi1,411,-5,-19,-5,-14
720575940626026005,right,Mi1,412,-6,21,16,5
720575940626064456,right,Mi1,413,-2,-7,-2,-5
720575940626085264,right,Mi1,414,4,21,6,15
720575940626089609,right,Mi1,415,6,12,0,12
720575940626104648,right,Mi1,416,3,-8,-7,-1
720575940621454427,right,Mi1,417,-6,-10,1,-11
720575940626175619,right,Mi1,418,-2,15,9,6
720575940626192771,right,Mi1,419,-3,-11,-3,-8
720575940626222681,right,Mi1,420,6,-3,-8,5
720575940626235644,right,Mi1,421,-1,12,7,5
720575940626252303,right,Mi1,422,-7,-4,5,-9
720575940621659046,right,Mi1,423,3,-18,-12,-6
720575940626290172,right,Mi1,424,-3,-2,2,-4
720575940626298364,right,Mi1,425,3,20,7,13
720575940626298567,right,Mi1,426,-3,0,3,-3
720575940643285389,right,Mi1,427,5,-18,-14,-4
720575940626425219,right,Mi1,428,-2,23,13,10
720575940626436733,right,Mi1,429,-2,14,9,5
720575940618931229,right,Mi1,430,-3,-7,-1,-6
720575940626525982,right,Mi1,431,-2,-10,-3,-7
720575940609925589,right,Mi1,432,-5,7,8,-1
720575940626607110,right,Mi1,433,0,-8,-4,-4
720575940626644496,right,Mi1,434,-3,7,6,1
720575940626666312,right,Mi1,435,5,-17,-14,-3
720575940626684689,right,Mi1,436,0,-15,-8,-7
720575940626697609,right,Mi1,437,-3,12,9,3
720575940635896255,right,Mi1,438,2,27,11,16
720575940626774026,right,Mi1,439,-3,-9,-2,-7
720575940626810442,right,Mi1,440,1,23,10,13
720575940626850678,right,Mi1,441,3,-16,-11,-5
720575940626852201,right,Mi1,442,-5,25,17,8
720575940626888720,right,Mi1,443,-6,4,8,-4
720575940626900086,right,Mi1,444,4,-10,-9,-1
720575940626917635,right,Mi1,445,-2,8,6,2
720575940632811112,right,Mi1,446,2,-14,-9,-5
720575940626971560,right,Mi1,447,-1,2,2,0
720575940627984650,right,Mi1,448,0,30,15,15
720575940627053329,right,Mi1,449,6,-16,-14,-2
720575940640572733,right,Mi1,450,2,-9,-7,-2
720575940627080945,right,Mi1,451,4,20,6,14
720575940627082329,right,Mi1,452,1,-9,-6,-3
720575940627116318,right,Mi1,453,3,25,9,16
720575940627147080,right,Mi1,454,5,-12,-11,-1
720575940636071519,right,Mi1,455,7,-7,-11,4
720575940627160143,right,Mi1,456,0,21,10,11
720575940625653652,right,Mi1,457,-2,17,10,7
720575940627167253,right,Mi1,458,5,0,-5,5
720575940627176566,right,Mi1,459,5,-3,-7,4
720575940627177491,right,Mi1,460,-3,-20,-7,-13
720575940627189622,right,Mi1,461,7,-5,-10,5
720575940627231290,right,Mi1,462,-1,18,10,8
720575940627273274,right,Mi1,463,5,17,3,14
720575940627344783,right,Mi1,464,4,0,-4,4
720575940634689561,right,Mi1,465,3,0,-3,3
720575940627395345,right,Mi1,466,1,14,6,8
720575940627476040,right,Mi1,467,-2,-20,-8,-12
720575940627539653,right,Mi1,468,-3,11,8,3
720575940627611517,right,Mi1,469,-7,13,13,0
720575940627669239,right,Mi1,470,4,-9,-9,0
720575940621710831,right,Mi1,471,3,-26,-16,-10
720575940627733447,right,Mi1,472,1,25,11,14
720575940627763582,right,Mi1,473,-4,23,15,8
720575940627764350,right,Mi1,474,-3,-17,-6,-11
720575940632155922,right,Mi1,475,-4,-1,3,-4
720575940627864305,right,Mi1,476,-1,15,8,7
720575940627882490,right,Mi1,477,-3,2,4,-2
720575940627928698,right,Mi1,478,-7,16,15,1
720575940625774631,right,Mi1,479,-2,10,7,3
720575940627963978,right,Mi1,480,3,-19,-13,-6
720575940627970122,right,Mi1,481,4,-8,-8,0
720575940628087913,right,Mi1,482,1,17,7,10
720575940628107881,right,Mi1,483,2,-7,-6,-1
720575940628157595,right,Mi1,484,3,-9,-8,-1
720575940628177738,right,Mi1,485,-3,-3,1,-4
720575940628196908,right,Mi1,486,0,1,0,1
720575940628273468,right,Mi1,487,1,-1,-2,1
720575940628951036,right,Mi1,488,7,5,-5,10
720575940628359223,right,Mi1,489,-3,10,8,2
720575940615590034,right,Mi1,490,-5,6,8,-2
720575940628437776,right,Mi1,491,7,-1,-8,7
720575940628439356,right,Mi1,492,-7,-2,6,-8
720575940628444688,right,Mi1,493,-3,23,14,9
720575940644342688,right,Mi1,494,0,29,14,15
720575940610934340,right,Mi1,495,4,5,-2,7
720575940632814648,right,Mi1,496,7,8,-3,11
720575940628544828,right,Mi1,497,6,1,-6,7
720575940628576335,right,Mi1,498,6,10,-1,11
720575940628590235,right,Mi1,499,5,10,0,10
720575940628748816,right,Mi1,500,7,-8,-11,3
720575940628863994,right,Mi1,501,1,2,0,2
720575940628877161,right,Mi1,502,5,8,-1,9
720575940628892432,right,Mi1,503,3,17,5,12
720575940629042639,right,Mi1,504,-2,9,6,3
720575940629070339,right,Mi1,505,6,-22,-17,-5
720575940629090048,right,Mi1,506,1,-12,-7,-5
720575940629098878,right,Mi1,507,-5,-12,-1,-11
720575940629104377,right,Mi1,508,-5,11,10,1
720575940629129679,right,Mi1,509,-4,10,9,1
720575940629170220,right,Mi1,510,-2,11,7,4
720575940629246586,right,Mi1,511,5,-11,-11,0
720575940629287034,right,Mi1,512,6,0,-6,6
720575940629349826,right,Mi1,513,-4,-13,-3,-10
720575940631668475,right,Mi1,514,-4,-10,-1,-9
720575940629377551,right,Mi1,515,-8,-7,4,-11
720575940629387051,right,Mi1,516,7,-18,-16,-2
720575940638557406,right,Mi1,517,6,3,-5,8
720575940629418110,right,Mi1,518,-4,22,15,7
720575940629426450,right,Mi1,519,-5,-5,2,-7
720575940629545803,right,Mi1,520,-2,-22,-9,-13
720575940629588891,right,Mi1,521,6,-9,-11,2
720575940626812222,right,Mi1,522,-4,0,4,-4
720575940629678124,right,Mi1,523,2,14,5,9
720575940629703724,right,Mi1,524,4,-20,-14,-6
720575940629714999,right,Mi1,525,-1,-20,-9,-11
720575940629829275,right,Mi1,526,0,-10,-5,-5
720575940629855964,right,Mi1,527,-4,-8,0,-8
720575940629866434,right,Mi1,528,2,7,1,6
720575940630000399,right,Mi1,529,2,-2,-3,1
720575940630011961,right,Mi1,530,-3,-13,-4,-9
720575940630012923,right,Mi1,531,1,0,-1,1
720575940630034243,right,Mi1,532,-8,7,11,-4
720575940630050920,right,Mi1,533,0,-16,-8,-8
720575940630055272,right,Mi1,534,3,2,-2,4
720575940623458428,right,Mi1,535,8,-4,-10,6
720575940627113162,right,Mi1,536,3,4,-1,5
720575940630142265,right,Mi1,537,0,-23,-12,-11
720575940630146668,right,Mi1,538,-4,1,4,-3
720575940630171207,right,Mi1,539,-6,15,13,2
720575940630201206,right,Mi1,540,-2,-9,-3,-6
720575940630201851,right,Mi1,541,-4,14,11,3
720575940617236923,right,Mi1,542,6,-13,-13,0
720575940630294902,right,Mi1,543,-1,-4,-1,-3
720575940630299276,right,Mi1,544,3,-13,-10,-3
720575940624161171,right,Mi1,545,5,11,0,11
720575940630369068,right,Mi1,546,3,6,0,6
720575940630379884,right,Mi1,547,-1,21,11,10
720575940630386060,right,Mi1,548,1,-16,-9,-7
720575940630407751,right,Mi1,549,0,-9,-5,-4
720575940630440007,right,Mi1,550,-2,3,3,0
720575940634907161,right,Mi1,551,-4,-9,-1,-8
720575940630505297,right,Mi1,552,4,-1,-5,4
720575940630508495,right,Mi1,553,-3,16,11,5
720575940630535564,right,Mi1,554,-9,-3,7,-10
720575940630542663,right,Mi1,555,-4,9,8,1
720575940630567698,right,Mi1,556,0,10,5,5
720575940630588101,right,Mi1,557,6,-10,-11,1
720575940630697124,right,Mi1,558,-4,-21,-7,-14
720575940630697576,right,Mi1,559,-6,22,17,5
720575940630720204,right,Mi1,560,-7,14,14,0
720575940630799226,right,Mi1,561,5,7,-2,9
720575940630745036,right,Mi1,562,-5,-2,4,-6
720575940630767631,right,Mi1,563,5,-13,-12,-1
720575940630787599,right,Mi1,564,3,-23,-15,-8
720575940631087831,right,Mi1,565,0,-26,-13,-13
720575940630827339,right,Mi1,566,5,-8,-9,1
720575940630845348,right,Mi1,567,-2,22,13,9
720575940630919763,right,Mi1,568,-6,-8,2,-10
720575940630936315,right,Mi1,569,6,6,-3,9
720575940630944505,right,Mi1,570,2,25,10,15
720575940644950216,right,Mi1,571,0,-14,-7,-7
720575940627077834,right,Mi1,572,-8,3,9,-6
720575940630964551,right,Mi1,573,4,14,3,11
720575940631016275,right,Mi1,574,-6,5,8,-3
720575940634569442,right,Mi1,575,6,9,-2,11
720575940631083215,right,Mi1,576,0,28,14,14
720575940631102509,right,Mi1,577,5,-14,-12,-2
720575940631103007,right,Mi1,578,4,-11,-10,-1
720575940631116586,right,Mi1,579,-3,-10,-2,-8
720575940631162410,right,Mi1,580,-2,-23,-10,-13
720575940631195333,right,Mi1,581,3,9,1,8
720575940631379512,right,Mi1,582,-1,23,12,11
720575940631432901,right,Mi1,583,3,-25,-16,-9
720575940631433487,right,Mi1,584,4,23,7,16
720575940631440697,right,Mi1,585,-1,-23,-11,-12
720575940631539397,right,Mi1,586,2,18,7,11
720575940631544082,right,Mi1,587,4,22,7,15
720575940631593297,right,Mi1,588,1,4,1,3
720575940631644719,right,Mi1,589,-1,-5,-2,-3
720575940631679530,right,Mi1,590,1,9,3,6
720575940631681095,right,Mi1,591,3,-3,-5,2
720575940631681298,right,Mi1,592,3,-28,-17,-11
720575940631682003,right,Mi1,593,3,-14,-10,-4
720575940631717906,right,Mi1,594,7,-16,-15,-1
720575940631718028,right,Mi1,595,7,-12,-13,1
720575940631726440,right,Mi1,596,-4,-16,-4,-12
720575940631816332,right,Mi1,597,4,1,-4,5
720575940609667083,right,Mi1,598,2,-18,-11,-7
720575940631865874,right,Mi1,599,-1,9,5,4
720575940631894753,right,Mi1,600,3,-10,-8,-2
720575940606513342,right,Mi1,601,1,16,7,9
720575940632034724,right,Mi1,602,4,-2,-5,3
720575940632055912,right,Mi1,603,-3,-23,-9,-14
720575940632094824,right,Mi1,604,-6,-17,-3,-14
720575940632107033,right,Mi1,605,3,15,4,11
720575940632113439,right,Mi1,606,-1,-19,-9,-10
720575940632164044,right,Mi1,607,1,18,8,10
720575940632194221,right,Mi1,608,1,10,4,6
720575940632213933,right,Mi1,609,-2,0,2,-2
720575940632232418,right,Mi1,610,2,-23,-14,-9
720575940632238675,right,Mi1,611,-1,-18,-8,-10
720575940609312860,right,Mi1,612,-3,-26,-10,-16
720575940646215022,right,Mi1,613,-8,-4,6,-10
720575940632378695,right,Mi1,614,-2,-8,-2,-6
720575940632396444,right,Mi1,615,-7,-7,3,-10
720575940632433052,right,Mi1,616,-3,15,10,5
720575940632443804,right,Mi1,617,-2,-17,-7,-10
720575940632460077,right,Mi1,618,-1,24,13,11
720575940632606509,right,Mi1,619,-4,-19,-6,-13
720575940636136799,right,Mi1,620,7,1,-7,8
720575940632700256,right,Mi1,621,1,24,11,13
720575940632717359,right,Mi1,622,-5,20,15,5
720575940611667154,right,Mi1,623,1,13,5,8
720575940629262922,right,Mi1,624,1,-17,-10,-7
720575940632769678,right,Mi1,625,-2,24,14,10
720575940632807359,right,Mi1,626,-5,-8,1,-9
720575940632845463,right,Mi1,627,0,-1,-1,0
720575940632856289,right,Mi1,628,0,0,0,0
720575940628683516,right,Mi1,629,4,24,8,16
720575940621194405,right,Mi1,630,4,8,0,8
720575940633027539,right,Mi1,631,1,26,12,14
720575940633074783,right,Mi1,632,3,-20,-13,-7
720575940633076691,right,Mi1,633,-1,-24,-11,-13
720575940633138330,right,Mi1,634,-3,-15,-5,-10
720575940621472750,right,Mi1,635,6,-6,-9,3
720575940633345375,right,Mi1,636,0,6,3,3
720575940633468385,right,Mi1,637,3,-21,-14,-7
720575940633476141,right,Mi1,638,-1,7,4,3
720575940633611883,right,Mi1,639,-4,19,13,6
720575940644945352,right,Mi1,640,-1,-16,-7,-9
720575940633711540,right,Mi1,641,-8,-5,5,-10
720575940633731832,right,Mi1,642,-5,-11,-1,-10
720575940633827996,right,Mi1,643,6,14,1,13
720575940633839796,right,Mi1,644,-6,18,15,3
720575940633872865,right,Mi1,645,-4,27,17,10
720575940631608315,right,Mi1,646,6,17,2,15
720575940634024303,right,Mi1,647,-4,-7,0,-7
720575940628857604,right,Mi1,648,1,7,2,5
720575940614607912,right,Mi1,649,-1,5,3,2
720575940634215393,right,Mi1,650,-3,-25,-10,-15
720575940618338260,right,Mi1,651,-4,-5,1,-6
720575940634440858,right,Mi1,652,-6,-11,0,-11
720575940634682487,right,Mi1,653,-6,-12,0,-12
720575940634724453,right,Mi1,654,-3,8,7,1
720575940634728043,right,Mi1,655,6,-1,-7,6
720575940634766699,right,Mi1,656,0,-11,-6,-5
720575940634769562,right,Mi1,657,-2,-25,-11,-14
720575940634823822,right,Mi1,658,1,20,9,11
720575940634978222,right,Mi1,659,-4,-6,1,-7
720575940635149466,right,Mi1,660,2,28,12,16
720575940635225495,right,Mi1,661,-3,14,10,4
720575940617246395,right,Mi1,662,2,-1,-3,2
720575940628290618,right,Mi1,663,0,8,4,4
720575940648422532,right,Mi1,664,1,-27,-15,-12
720575940635542895,right,Mi1,665,7,-2,-8,6
720575940635757168,right,Mi1,666,7,-13,-14,1
720575940635825144,right,Mi1,667,1,-28,-15,-13
720575940635889015,right,Mi1,668,1,19,8,11
720575940636028261,right,Mi1,669,4,-16,-12,-4
720575940623093854,right,Mi1,670,5,5,-3,8
720575940636151032,right,Mi1,671,-4,-23,-8,-15
720575940636169705,right,Mi1,672,-8,11,13,-2
720575940629180422,right,Mi1,673,2,5,0,5
720575940636304218,right,Mi1,674,-4,-14,-3,-11
720575940627009598,right,Mi1,675,-7,19,16,3
720575940635689626,right,Mi1,676,-3,-21,-8,-13
720575940623887128,right,Mi1,677,0,11,5,6
720575940636425870,right,Mi1,678,3,-7,-7,0
720575940636481513,right,Mi1,679,4,18,5,13
720575940626100238,right,Mi1,680,-1,25,13,12
720575940618860445,right,Mi1,681,-2,-21,-9,-12
720575940636847167,right,Mi1,682,6,-8,-10,2
720575940636890224,right,Mi1,683,2,6,1,5
720575940636894022,right,Mi1,684,-6,17,14,3
720575940636962138,right,Mi1,685,-5,-9,0,-9
720575940636988813,right,Mi1,686,5,-22,-16,-6
720575940637106573,right,Mi1,687,-6,-3,4,-7
720575940637161013,right,Mi1,688,-7,10,12,-2
720575940637177054,right,Mi1,689,-2,18,11,7
720575940637201461,right,Mi1,690,-7,-3,5,-8
720575940637228206,right,Mi1,691,-9,4,11,-7
720575940637228341,right,Mi1,692,-4,24,16,8
720575940637230766,right,Mi1,693,-3,25,15,10
720575940624959927,right,Mi1,694,4,3,-3,6
720575940620960020,right,Mi1,695,-6,10,11,-1
720575940637431110,right,Mi1,696,-2,16,10,6
720575940637471054,right,Mi1,697,1,-22,-12,-10
720575940637571812,right,Mi1,698,6,-7,-10,3
720575940631758423,right,Mi1,699,-5,0,5,-5
720575940637651034,right,Mi1,700,5,15,2,13
720575940637746493,right,Mi1,701,0,-4,-2,-2
720575940606476478,right,Mi1,702,-5,23,16,7
720575940637885043,right,Mi1,703,-3,1,3,-2
720575940640562749,right,Mi1,704,-7,8,11,-3
720575940637977149,right,Mi1,705,1,1,-1,2
720575940638169688,right,Mi1,706,-7,-12,1,-13
720575940638312006,right,Mi1,707,-2,25,14,11
720575940638318399,right,Mi1,708,-4,-25,-9,-16
720575940620605776,right,Mi1,709,-2,-24,-10,-14
720575940638341353,right,Mi1,710,4,-25,-17,-8
720575940638407494,right,Mi1,711,-1,19,10,9
720575940638827984,right,Mi1,712,-7,12,13,-1
720575940639065296,right,Mi1,713,-6,16,14,2
720575940618311892,right,Mi1,714,5,12,1,11
720575940639223203,right,Mi1,715,4,10,1,9
720575940639250741,right,Mi1,716,4,-6,-7,1
720575940639258200,right,Mi1,717,2,-22,-13,-9
720575940639311488,right,Mi1,718,-5,24,17,7
720575940636264952,right,Mi1,719,1,27,12,15
720575940639404605,right,Mi1,720,-5,21,15,6
720575940635506528,right,Mi1,721,5,13,1,12
720575940639421016,right,Mi1,722,6,-15,-14,-1
720575940639546933,right,Mi1,723,-2,-11,-4,-7
720575940614989107,right,Mi1,724,4,2,-3,5
720575940640212413,right,Mi1,725,-3,-24,-9,-15
720575940640143192,right,Mi1,726,2,-28,-16,-12
720575940640180339,right,Mi1,727,7,6,-4,10
720575940625666488,right,Mi1,728,7,12,-1,13
720575940640250496,right,Mi1,729,-3,29,17,12
720575940640318552,right,Mi1,730,7,0,-7,7
720575940640355213,right,Mi1,731,-6,9,10,-1
720575940616893638,right,Mi1,732,-3,6,6,0
720575940612523669,right,Mi1,733,-5,-17,-4,-13
720575940640466677,right,Mi1,734,2,0,-2,2
720575940640503640,right,Mi1,735,1,-23,-13,-10
720575940640672501,right,Mi1,736,-8,1,8,-7
720575940641105883,right,Mi1,737,0,19,9,10
720575940641108699,right,Mi1,738,-3,13,9,4
720575940641151284,right,Mi1,739,-7,2,8,-6
720575940641202640,right,Mi1,740,2,-8,-6,-2
720575940643266583,right,Mi1,741,-2,-14,-5,-9
720575940643527112,right,Mi1,742,-4,11,9,2
720575940643572334,right,Mi1,743,6,-19,-16,-3
720575940643633352,right,Mi1,744,-4,25,16,9
720575940643862324,right,Mi1,745,0,13,6,7
720575940643929800,right,Mi1,746,-3,3,4,-1
720575940644093719,right,Mi1,747,0,2,1,1
720575940644391112,right,Mi1,748,-4,20,14,6
720575940644510574,right,Mi1,749,-2,1,2,-1
720575940605581024,right,Mi1,750,4,-24,-16,-8
720575940645541252,right,Mi1,751,1,6,2,4
720575940645669940,right,Mi1,752,-2,7,5,2
720575940646028142,right,Mi1,753,-3,24,15,9
720575940646369588,right,Mi1,754,-1,-13,-6,-7
720575940646413108,right,Mi1,755,4,19,5,14
720575940646428980,right,Mi1,756,5,20,5,15
720575940646433076,right,Mi1,757,0,-6,-3,-3
720575940647995769,right,Mi1,758,5,-1,-6,5
720575940648026756,right,Mi1,759,7,14,0,14
720575940648557689,right,Mi1,760,0,17,8,9
720575940649324153,right,Mi1,761,-4,-18,-5,-13
720575940632406543,right,Mi1,762,0,14,7,7
720575940650403449,right,Mi1,763,-5,14,12,2
720575940650482041,right,Mi1,764,-8,-6,5,-11
720575940650510838,right,Mi1,765,-3,9,7,2
720575940651887094,right,Mi1,766,2,-4,-4,0
720575940652626934,right,Mi1,767,1,28,13,15
720575940624086408,right,Mi1,768,3,5,-1,6
720575940655096481,right,Mi1,769,4,-27,-18,-9
720575940612197986,right,Mi1,770,5,4,-3,7
720575940655608481,right,Mi1,771,3,-27,-17,-10
720575940655611553,right,Mi1,772,1,12,5,7
720575940636037983,right,Mi1,773,5,-19,-15,-4
720575940630271336,right,Mi1,774,-8,6,11,-5
720575940645078984,right,Mi1,775,5,22,6,16
720575940645309988,right,Mi1,776,5,21,5,16
720575940628534827,right,Mi1,777,6,20,4,16
720575940620941703,right,Mi1,778,4,25,8,17
720575940604607678,right,Mi1,779,5,24,7,17
720575940607228629,right,Mi1,780,-6,25,18,7
720575940605668128,right,Mi1,781,-5,26,18,8
720575940622821590,right,Mi1,782,-5,27,18,9
720575940632527524,right,Mi1,783,-4,28,18,10
720575940618405917,right,Mi1,784,-4,29,18,11
720575940641224181,right,Mi1,785,-3,30,18,12
720575940646982964,right,Mi1,786,-2,30,17,13
720575940635864176,right,Mi1,787,3,28,11,17
720575940624864263,right,Mi1,788,3,27,10,17
720575940626772666,right,Mi1,789,-3,-27,-11,-16
720575940616083212,right,Mi1,790,-2,-27,-12,-15
720575940614026280,right,Mi1,791,-1,-28,-13,-15
720575940616046348,right,Mi1,792,8,2,-7,9
720575940620133243,right,Mi1,793,8,-6,-11,5
720575940622574038,right,Mi1,794,5,-26,-18,-8
720575940623210933,right,Mi1,795,6,-21,-17,-4
720575940619018779,right,Mi1,796,4,26,9,17
720575940633860397,right,C2,1,-6,13,12,1
720575940620566772,right,C2,2,-8,2,9,-7
720575940621492912,right,C2,3,6,-12,-12,0
720575940613162675,right,C2,4,-5,-21,-6,-15
720575940620936289,right,C2,5,-1,16,9,7
720575940624386186,right,C2,6,-2,-4,0,-4
720575940630762455,right,C2,7,-6,-6,3,-9
720575940619213888,right,C2,8,-4,26,17,9
720575940623478749,right,C2,9,4,9,0,9
720575940638420302,right,C2,10,5,-15,-13,-2
720575940628714005,right,C2,12,-7,9,11,-2
720575940628696085,right,C2,13,-1,-26,-12,-14
720575940626805296,right,C2,14,0,-27,-14,-13
720575940614521767,right,C2,15,2,-3,-4,1
720575940623280937,right,C2,16,-2,-16,-6,-10
720575940621919152,right,C2,17,1,-5,-4,-1
720575940635957855,right,C2,18,5,-16,-13,-3
720575940636569701,right,C2,19,-7,17,15,2
720575940634158050,right,C2,20,3,-11,-9,-2
720575940626720152,right,C2,21,-2,19,11,8
720575940639055450,right,C2,22,-1,3,2,1
720575940640028494,right,C2,23,-3,-16,-5,-11
720575940630133760,right,C2,24,-1,-10,-4,-6
720575940615083231,right,C2,25,-9,3,10,-7
720575940616302239,right,C2,26,1,-3,-3,0
720575940630892288,right,C2,27,0,-25,-13,-12
720575940631105068,right,C2,28,5,6,-2,8
720575940616568537,right,C2,29,-1,-3,-1,-2
720575940620936583,right,C2,30,6,16,2,14
720575940626462501,right,C2,31,0,16,8,8
720575940617562763,right,C2,32,0,12,6,6
720575940628760835,right,C2,34,6,18,3,15
720575940612202850,right,C2,35,1,-24,-13,-11
720575940627219911,right,C2,37,1,5,1,4
720575940623447690,right,C2,38,0,-2,-1,-1
720575940605886385,right,C2,40,-2,-6,-1,-5
720575940625441511,right,C2,41,-3,28,17,11
720575940620463855,right,C2,42,-1,14,8,6
720575940636864869,right,C2,43,-5,18,14,4
720575940623979498,right,C2,44,5,-10,-10,0
720575940609779524,right,C2,45,-5,-1,4,-5
720575940617042444,right,C2,46,-5,15,12,3
720575940623605994,right,C2,47,-9,-1,8,-9
720575940645376292,right,C2,48,-4,-22,-7,-15
720575940621438448,right,C2,49,4,-4,-6,2
720575940626653336,right,C2,50,-2,21,12,9
720575940615117777,right,C2,51,0,-19,-10,-9
720575940612481941,right,C2,52,-1,-22,-10,-12
720575940621150934,right,C2,53,5,14,2,12
720575940623488234,right,C2,54,-4,3,5,-2
720575940633700179,right,C2,55,-4,-11,-2,-9
720575940616296607,right,C2,56,1,-13,-8,-5
720575940633285843,right,C2,57,6,-11,-12,1
720575940613724131,right,C2,58,3,12,3,9
720575940626719365,right,C2,59,-2,2,3,-1
720575940640594384,right,C2,60,-8,8,12,-4
720575940627270738,right,C2,61,-4,-4,2,-6
720575940612309966,right,C2,63,4,12,2,10
720575940615875003,right,C2,64,4,-23,-16,-7
720575940623897101,right,C2,65,-1,28,15,13
720575940638877237,right,C2,66,2,15,5,10
720575940613268963,right,C2,67,-2,-13,-5,-8
720575940608069554,right,C2,68,3,16,5,11
720575940640745587,right,C2,69,1,8,3,5
720575940624598054,right,C2,70,-4,21,14,7
720575940635142751,right,C2,71,-2,-3,0,-3
720575940637861806,right,C2,72,0,-28,-14,-14
720575940639326835,right,C2,73,2,2,-1,3
720575940619080193,right,C2,74,-1,-9,-4,-5
720575940627209994,right,C2,75,-6,14,13,1
720575940632737325,right,C2,76,-3,-4,1,-5
720575940620847598,right,C2,77,2,-5,-5,0
720575940642085595,right,C2,78,2,20,8,12
720575940623907591,right,C2,79,2,1,-2,3
720575940631273436,right,C2,80,4,13,2,11
720575940631683599,right,C2,81,6,-2,-7,5
720575940623842485,right,C2,82,-7,7,10,-3
720575940650588537,right,C2,83,2,-21,-13,-8
720575940625649850,right,C2,84,-2,12,8,4
720575940635750836,right,C2,85,4,-22,-15,-7
720575940627912444,right,C2,86,-5,-7,1,-8
720575940614808273,right,C2,87,1,11,4,7
720575940627505539,right,C2,88,7,4,-5,9
720575940614879283,right,C2,89,1,-19,-11,-8
720575940622379190,right,C2,90,-4,5,6,-1
720575940617088605,right,C2,91,-1,6,4,2
720575940616662614,right,C2,92,0,9,4,5
720575940623920391,right,C2,95,4,-21,-15,-6
720575940634794391,right,C2,96,1,-10,-6,-4
720575940629979447,right,C2,97,-5,2,6,-4
720575940629991323,right,C2,98,-1,-12,-5,-7
720575940622737288,right,C2,99,4,15,3,12
720575940629874732,right,C2,100,2,-10,-7,-3
720575940629308234,right,C2,101,-7,6,10,-4
720575940629354110,right,C2,102,3,13,3,10
720575940635442071,right,C2,104,-1,-27,-13,-14
720575940628653308,right,C2,105,3,22,8,14
720575940614627112,right,C2,106,-7,11,12,-1
720575940612531921,right,C2,107,8,-2,-9,7
720575940623964853,right,C2,108,-3,-12,-3,-9
720575940621660144,right,C2,109,4,-5,-7,2
720575940617646036,right,C2,110,-7,0,7,-7
720575940610978094,right,C2,111,2,-24,-14,-10
720575940620508075,right,C2,112,-6,1,6,-5
720575940628530023,right,C2,113,-2,4,4,0
720575940619132632,right,C2,114,2,-13,-9,-4
720575940631853113,right,C2,115,-4,2,5,-3
720575940639176681,right,C2,116,-1,-8,-3,-5
720575940619477077,right,C2,117,-8,-2,7,-9
720575940618591266,right,C2,118,3,1,-3,4
720575940625861159,right,C2,119,-2,6,5,1
720575940623508733,right,C2,120,-1,-1,0,-1
720575940631556675,right,C2,122,-5,9,9,0
720575940627694479,right,C2,123,-8,10,13,-3
720575940648376452,right,C2,124,1,-7,-5,-2
720575940650713465,right,C2,125,5,9,-1,10
720575940621604998,right,C2,126,3,11,2,9
720575940644337312,right,C2,127,0,15,7,8
720575940616768268,right,C2,128,3,-22,-14,-8
720575940612565657,right,C2,129,0,-13,-7,-6
720575940638093534,right,C2,130,2,12,4,8
720575940626274050,right,C2,131,-6,20,16,4
720575940618119739,right,C2,132,2,4,0,4
720575940622066014,right,C2,133,-3,20,13,7
720575940613650841,right,C2,134,-5,-18,-4,-14
720575940628266578,right,C2,135,-3,-22,-8,-14
720575940632750879,right,C2,136,0,3,1,2
720575940625721802,right,C2,137,5,-7,-9,2
720575940609820629,right,C2,138,0,27,13,14
720575940613652451,right,C2,139,1,-14,-8,-6
720575940625600868,right,C2,140,3,8,1,7
720575940624984503,right,C2,141,5,-23,-17,-6
720575940620772846,right,C2,142,-2,-18,-7,-11
720575940628288133,right,C2,143,-4,16,12,4
720575940626458652,right,C2,144,7,-11,-13,2
720575940625074446,right,C2,145,0,4,2,2
720575940617143133,right,C2,146,1,-6,-4,-2
720575940627156869,right,C2,147,1,21,9,12
720575940624385160,right,C2,148,-7,-11,1,-12
720575940620135047,right,C2,149,6,-14,-13,-1
720575940617547494,right,C2,150,-8,5,10,-5
720575940610049493,right,C2,151,-3,-14,-4,-10
720575940608057730,right,C2,152,3,-15,-11,-4
720575940616601612,right,C2,153,8,0,-8,8
720575940632927661,right,C2,154,-8,0,8,-8
720575940615978646,right,C2,155,-8,13,14,-1
720575940621279216,right,C2,156,-9,1,9,-8
720575940625026824,right,C2,157,-1,-7,-3,-4
720575940631484409,right,C2,158,3,-5,-6,1
720575940623686365,right,C2,159,7,7,-4,11
720575940625827917,right,C2,161,4,-14,-11,-3
720575940630403269,right,C2,162,-4,-2,3,-5
720575940629887276,right,C2,163,-9,7,12,-5
720575940639316550,right,C2,164,-1,-2,0,-2
720575940641225435,right,C2,165,4,16,4,12
720575940618933302,right,C2,166,0,18,9,9
720575940616395276,right,C2,167,0,-17,-9,-8
720575940621483504,right,C2,168,-1,17,9,8
720575940619836269,right,C2,169,0,-18,-9,-9
720575940624486804,right,C2,170,-5,1,5,-4
720575940608262980,right,C2,171,6,-20,-16,-4
720575940635587832,right,C2,172,1,22,10,12
720575940650734713,right,C2,173,2,-25,-15,-10
720575940612971690,right,C2,174,4,-15,-12,-3
720575940622331305,right,C2,175,-6,-7,2,-9
720575940622362650,right,C2,176,-2,13,8,5
720575940608603331,right,C2,177,-2,-1,1,-2
720575940617927892,right,C2,178,2,11,3,8
720575940619766430,right,C2,179,-5,-16,-3,-13
720575940660268929,right,C2,181,1,-4,-3,-1
720575940621733870,right,C2,182,7,-10,-12,2
720575940618026241,right,C2,183,-5,-15,-3,-12
720575940634921626,right,C2,184,-6,-5,3,-8
720575940653406966,right,C2,185,2,-11,-8,-3
720575940622865917,right,C2,186,-1,26,14,12
720575940646078830,right,C2,187,3,21,7,14
720575940622513652,right,C2,188,-5,17,13,4
720575940628354307,right,C2,189,6,13,0,13
720575940608029826,right,C2,190,-3,-5,0,-5
720575940620139143,right,C2,191,-1,-11,-5,-6
720575940610585442,right,C2,192,7,10,-2,12
720575940622880094,right,C2,193,-5,4,7,-3
720575940623603178,right,C2,194,0,-5,-3,-2
720575940624537095,right,C2,195,-3,-1,2,-3
720575940631641551,right,C2,196,-1,8,5,3
720575940634843031,right,C2,197,0,-20,-10,-10
720575940632224908,right,C2,198,6,2,-5,7
720575940629179035,right,C2,199,0,-12,-6,-6
720575940627404821,right,C2,200,-5,12,11,1
720575940637664654,right,C2,202,-1,27,14,13
720575940624191882,right,C2,203,3,-1,-4,3
720575940634966463,right,C2,204,5,-2,-6,4
720575940621262100,right,C2,205,5,-6,-8,2
720575940623243658,right,C2,206,-3,5,5,0
720575940621294000,right,C2,208,5,-21,-16,-5
720575940638048368,right,C2,209,-3,-8,-1,-7
720575940631981964,right,C2,210,-6,8,10,-2
720575940620396635,right,C2,211,-7,-1,6,-7
720575940637609390,right,C2,212,2,-16,-10,-6
720575940623152264,right,C2,213,3,-4,-5,1
720575940617832276,right,C2,214,-5,3,6,-3
720575940622981912,right,C2,215,6,7,-3,10
720575940643470116,right,C2,216,2,19,7,12
720575940624272425,right,C2,217,6,15,1,14
720575940632314060,right,C2,218,2,10,3,7
720575940652505078,right,C2,219,6,-4,-8,4
720575940635624343,right,C2,220,2,-6,-5,-1
720575940615526210,right,C2,221,-7,3,8,-5
720575940631276631,right,C2,222,-3,26,16,10
720575940632671848,right,C2,223,-2,26,15,11
720575940621361601,right,C2,224,0,5,2,3
720575940632016911,right,C2,225,2,-26,-15,-11
720575940630203333,right,C2,226,5,19,4,15
720575940623355530,right,C2,227,-7,5,9,-4
720575940616058418,right,C2,228,-7,1,7,-6
720575940621680321,right,C2,229,5,2,-4,6
720575940635588788,right,C2,230,2,9,2,7
720575940626262928,right,C2,231,4,-12,-10,-2
720575940630700795,right,C2,232,-4,13,10,3
720575940616252347,right,C2,233,4,-13,-11,-2
720575940628284615,right,C2,234,1,3,0,3
720575940630644239,right,C2,235,4,11,1,10
720575940628334023,right,C2,236,-1,4,3,1
720575940647349795,right,C2,237,-2,27,15,12
720575940621727103,right,C2,238,-8,-3,6,-9
720575940609562635,right,C2,239,-6,6,9,-3
720575940623912455,right,C2,240,-4,-3,2,-5
720575940620246036,right,C2,241,2,-17,-11,-6
720575940625969098,right,C2,242,-4,6,7,-1
720575940632003279,right,C2,243,-1,-21,-10,-11
720575940622931992,right,C2,244,-4,-12,-2,-10
720575940631325515,right,C2,245,-5,-3,3,-6
720575940610915938,right,C2,246,-4,15,11,4
720575940619221824,right,C2,247,-4,-15,-4,-11
720575940616716683,right,C2,248,-6,0,6,-6
720575940621570486,right,C2,249,2,-12,-8,-4
720575940626995880,right,C2,250,-1,1,1,0
720575940627340165,right,C2,251,-1,-14,-6,-8
720575940623824422,right,C2,252,3,23,8,15
720575940606626481,right,C2,253,5,16,3,13
720575940623177084,right,C2,254,3,-24,-15,-9
720575940627574035,right,C2,255,-6,-13,-1,-12
720575940628425640,right,C2,256,5,-20,-15,-5
720575940625970364,right,C2,257,2,21,8,13
720575940633597860,right,C2,258,-4,-17,-5,-12
720575940630220604,right,C2,259,-7,-5,4,-9
720575940630591098,right,C2,260,-3,19,12,7
720575940630466934,right,C2,261,-1,13,7,6
720575940626016408,right,C2,263,-3,4,5,-1
720575940638559302,right,C2,264,-1,-6,-2,-4
720575940636050318,right,C2,265,-6,-1,5,-6
720575940623115177,right,C2,266,-1,-25,-12,-13
720575940627428610,right,C2,267,-6,2,7,-5
720575940632651859,right,C2,268,7,-6,-10,4
720575940631276375,right,C2,269,2,-19,-12,-7
720575940621295536,right,C2,270,1,-8,-5,-3
720575940627383933,right,C2,271,4,6,-1,7
720575940640039229,right,C2,272,3,-2,-4,2
720575940614373630,right,C2,273,-6,23,17,6
720575940649633145,right,C2,275,-8,-1,7,-8
720575940617675521,right,C2,276,2,3,-1,4
720575940615021310,right,C2,277,7,-3,-9,6
720575940615219103,right,C2,278,-5,10,10,0
720575940622839390,right,C2,279,-4,8,8,0
720575940634054425,right,C2,280,-6,-14,-1,-13
720575940618064155,right,C2,281,-9,2,10,-8
720575940624226598,right,C2,282,0,26,13,13
720575940630038327,right,C2,283,-4,4,6,-2
720575940622137665,right,C2,284,0,25,12,13
720575940615732310,right,C2,285,6,-18,-15,-3
720575940636674415,right,C2,286,0,-24,-12,-12
720575940612496497,right,C2,287,-5,13,11,2
720575940625119271,right,C2,289,-1,11,6,5
720575940642653659,right,C2,290,5,-24,-17,-7
720575940625965756,right,C2,291,7,2,-6,8
720575940621126081,right,C2,292,-4,18,13,5
720575940608069298,right,C2,293,4,-17,-13,-4
720575940622045022,right,C2,294,1,-20,-11,-9
720575940620268167,right,C2,296,1,-18,-10,-8
720575940638188254,right,C2,297,7,-9,-12,3
720575940616407106,right,C2,298,-5,5,7,-2
720575940628324170,right,C2,299,-4,12,10,2
720575940624250859,right,C2,300,4,-18,-13,-5
720575940624643047,right,C2,301,-5,16,13,3
720575940610602360,right,C2,302,2,17,6,11
720575940624496874,right,C2,303,-5,22,16,6
720575940623271423,right,C2,305,-7,4,9,-5
720575940612974961,right,C2,306,3,7,0,7
720575940623987199,right,C2,307,5,-25,-18,-7
720575940619523742,right,C2,308,-5,8,9,-1
720575940638559972,right,C2,309,-6,12,12,0
720575940608625419,right,C2,310,2,22,9,13
720575940614889110,right,C2,311,-7,15,14,1
720575940625991868,right,C2,312,4,-7,-8,1
720575940626934202,right,C2,313,7,3,-6,9
720575940621686254,right,C2,314,-9,5,11,-6
720575940626358605,right,C2,315,-3,-6,0,-6
720575940629834240,right,C2,316,5,-4,-7,3
720575940635584504,right,C2,317,-5,-4,3,-7
720575940619581204,right,C2,318,4,-19,-14,-5
720575940628740395,right,C2,319,-2,5,4,1
720575940619436081,right,C2,320,-2,-5,-1,-4
720575940638136944,right,C2,321,8,4,-6,10
720575940611526776,right,C2,322,2,26,11,15
720575940629229840,right,C2,323,-7,-13,0,-13
720575940623134889,right,C2,324,3,24,9,15
720575940616392415,right,C2,325,5,1,-5,6
720575940623933901,right,C2,326,2,16,6,10
720575940629985128,right,C2,328,5,-9,-10,1
720575940632792111,right,C2,329,0,24,12,12
720575940620042107,right,C2,330,3,3,-2,5
720575940638819817,right,C2,331,1,-15,-9,-6
720575940622319792,right,C2,332,4,-26,-17,-9
720575940631036476,right,C2,335,2,8,2,6
720575940625337319,right,C2,336,0,23,11,12
720575940624168521,right,C2,337,-5,-6,2,-8
720575940621127815,right,C2,338,-1,0,1,-1
720575940622721037,right,C2,339,6,11,-1,12
720575940611675854,right,C2,340,-4,17,12,5
720575940623911267,right,C2,341,6,-17,-15,-2
720575940605074144,right,C2,342,2,-15,-10,-5
720575940638895194,right,C2,343,-3,27,16,11
720575940622410153,right,C2,344,-2,-15,-6,-9
720575940618713157,right,C2,345,3,-12,-9,-3
720575940624671724,right,C2,346,-7,-9,2,-11
720575940632113747,right,C2,347,-5,-13,-2,-11
720575940612990435,right,C2,348,3,14,4,10
720575940632488223,right,C2,349,-5,-14,-2,-12
720575940625829520,right,C2,350,1,15,6,9
720575940604650464,right,C2,351,-1,-17,-8,-9
720575940612691093,right,C2,352,-2,28,16,12
720575940613428978,right,C2,353,2,24,10,14
720575940631597819,right,C2,354,-2,-26,-11,-15
720575940625073131,right,C2,355,-7,-6,4,-10
720575940626838821,right,C2,356,0,22,11,11
720575940625926926,right,C2,357,4,17,4,13
720575940643722519,right,C2,359,2,23,9,14
720575940613194354,right,C2,360,-5,19,14,5
720575940619740363,right,C2,361,0,-7,-4,-3
720575940619055444,right,C2,362,2,-20,-12,-8
720575940624245245,right,C2,363,7,-4,-9,5
720575940621577899,right,C2,364,4,4,-2,6
720575940609209948,right,C2,365,4,7,-1,8
720575940638036157,right,C2,366,-5,-20,-5,-15
720575940616231825,right,C2,367,-6,-15,-2,-13
720575940609320713,right,C2,368,-4,-20,-6,-14
720575940634985567,right,C2,369,5,-5,-8,3
720575940631412811,right,C2,371,6,-5,-9,4
720575940615356054,right,C2,372,1,-2,-2,0
720575940624403850,right,C2,373,1,-21,-12,-9
720575940624571430,right,C2,374,2,13,4,9
720575940626372610,right,C2,375,-6,7,9,-2
720575940624765939,right,C2,376,-7,-10,2,-12
720575940637099639,right,C2,377,0,7,3,4
720575940613267222,right,C2,378,-3,18,12,6
720575940623561165,right,C2,379,3,-17,-12,-5
720575940625714215,right,C2,380,-1,29,15,14
720575940627655699,right,C2,381,-8,-9,3,-12
720575940640519587,right,C2,382,3,-6,-6,0
720575940616799883,right,C2,383,-6,11,11,0
720575940620282304,right,C2,384,-6,-2,5,-7
720575940635021081,right,C2,385,-3,-18,-6,-12
720575940644072608,right,C2,386,-6,19,15,4
720575940621111728,right,C2,387,-1,-15,-7,-8
720575940647390340,right,C2,388,3,19,6,13
720575940638781766,right,C2,389,-6,-16,-2,-14
720575940620339334,right,C2,390,-6,-9,1,-10
720575940613865000,right,C2,391,4,-3,-6,3
720575940628376070,right,C2,392,-4,7,7,0
720575940620830656,right,C2,393,-1,22,12,10
720575940631816504,right,C2,394,-7,-8,3,-11
720575940611859922,right,C2,395,0,-22,-11,-11
720575940627204636,right,C2,396,-1,10,6,4
720575940628270321,right,C2,397,-3,-19,-7,-12
720575940642331789,right,C2,398,-3,22,14,8
720575940619614843,right,C2,399,-4,-24,-8,-16
720575940613011861,right,C2,400,1,-29,-16,-13
720575940638598726,right,C2,401,-2,-19,-8,-11
720575940620263663,right,C2,402,3,26,10,16
720575940621799551,right,C2,403,-2,-12,-4,-8
720575940636643214,right,C2,404,-1,20,11,9
720575940627759705,right,C2,405,3,10,2,8
720575940615292071,right,C2,406,1,-25,-14,-11
720575940619184965,right,C2,407,-5,-10,0,-10
720575940615065238,right,C2,408,-6,-4,4,-8
720575940644530848,right,C2,409,0,-3,-2,-1
720575940627991292,right,C2,410,-2,-2,1,-3
720575940619955403,right,C2,411,-5,-19,-5,-14
720575940660834945,right,C2,412,-6,21,16,5
720575940629645391,right,C2,413,-2,-7,-2,-5
720575940618651938,right,C2,414,4,21,6,15
720575940618450065,right,C2,415,6,12,0,12
720575940617582054,right,C2,416,3,-8,-7,-1
720575940634685847,right,C2,417,-6,-10,1,-11
720575940623424982,right,C2,418,-2,15,9,6
720575940651885046,right,C2,419,-3,-11,-3,-8
720575940636724848,right,C2,420,6,-3,-8,5
720575940632665145,right,C2,421,-1,12,7,5
720575940630272615,right,C2,422,-7,-4,5,-9
720575940626940702,right,C2,423,3,-18,-12,-6
720575940620035264,right,C2,424,-3,-2,2,-4
720575940622710366,right,C2,425,3,20,7,13
720575940629860908,right,C2,426,-3,0,3,-3
720575940618056409,right,C2,427,5,-18,-14,-4
720575940622609276,right,C2,428,-2,23,13,10
720575940652190198,right,C2,429,-2,14,9,5
720575940647028515,right,C2,430,-3,-7,-1,-6
720575940633579745,right,C2,431,-2,-10,-3,-7
720575940640245813,right,C2,432,-5,7,8,-1
720575940631162386,right,C2,433,0,-8,-4,-4
720575940623497715,right,C2,434,-3,7,6,1
720575940630804480,right,C2,435,5,-17,-14,-3
720575940634667199,right,C2,436,0,-15,-8,-7
720575940635065369,right,C2,437,-3,12,9,3
720575940660816769,right,C2,438,2,27,11,16
720575940626883453,right,C2,439,-3,-9,-2,-7
720575940615388021,right,C2,440,1,23,10,13
720575940609075157,right,C2,441,3,-16,-11,-5
720575940626964542,right,C2,442,-5,25,17,8
720575940623210281,right,C2,443,-6,4,8,-4
720575940609597193,right,C2,444,4,-10,-9,-1
720575940628524872,right,C2,445,-2,8,6,2
720575940622562943,right,C2,446,2,-14,-9,-5
720575940630437826,right,C2,447,-1,2,2,0
720575940626467453,right,C2,448,0,30,15,15
720575940632602449,right,C2,449,6,-16,-14,-2
720575940621383540,right,C2,450,2,-9,-7,-2
720575940630481399,right,C2,451,4,20,6,14
720575940638810084,right,C2,452,1,-9,-6,-3
720575940618868052,right,C2,453,3,25,9,16
720575940616782534,right,C2,454,5,-12,-11,-1
720575940627515633,right,C2,455,7,-7,-11,4
720575940647690548,right,C2,456,0,21,10,11
720575940621313304,right,C2,457,-2,17,10,7
720575940606673510,right,C2,458,5,0,-5,5
720575940622800903,right,C2,459,5,-3,-7,4
720575940630271799,right,C2,460,-3,-20,-7,-13
720575940606089900,right,C2,461,7,-5,-10,5
720575940627993852,right,C2,462,-1,18,10,8
720575940615269799,right,C2,463,5,17,3,14
720575940612214165,right,C2,464,4,0,-4,4
720575940621007495,right,C2,465,3,0,-3,3
720575940622112609,right,C2,466,1,14,6,8
720575940621962160,right,C2,467,-2,-20,-8,-12
720575940620250049,right,C2,468,-3,11,8,3
720575940620453615,right,C2,469,-7,13,13,0
720575940621873908,right,C2,470,4,-9,-9,0
720575940619557243,right,C2,472,1,25,11,14
720575940638594526,right,C2,473,-4,23,15,8
720575940621275329,right,C2,474,-3,-17,-6,-11
720575940614341551,right,C2,475,-4,-1,3,-4
720575940615680658,right,C2,476,-1,15,8,7
720575940614348967,right,C2,477,-3,2,4,-2
720575940611106094,right,C2,479,-2,10,7,3
720575940610972914,right,C2,480,3,-19,-13,-6
720575940637521118,right,C2,481,4,-8,-8,0
720575940653413622,right,C2,482,1,17,7,10
720575940655073953,right,C2,483,2,-7,-6,-1
720575940622084940,right,C2,484,3,-9,-8,-1
720575940632134737,right,C2,485,-3,-3,1,-4
720575940645619492,right,C2,486,0,1,0,1
720575940622881868,right,C2,487,1,-1,-2,1
720575940617353558,right,C2,488,7,5,-5,10
720575940613563670,right,C2,489,-3,10,8,2
720575940623905031,right,C2,490,-5,6,8,-2
720575940625968371,right,C2,491,7,-1,-8,7
720575940632928337,right,C2,492,-7,-2,6,-8
720575940617625717,right,C2,493,-3,23,14,9
720575940619070493,right,C2,494,0,29,14,15
720575940621312421,right,C2,495,4,5,-2,7
720575940612115313,right,C2,496,7,8,-3,11
720575940618748445,right,C2,497,6,1,-6,7
720575940631086848,right,C2,498,6,10,-1,11
720575940624786412,right,C2,499,5,10,0,10
720575940631304492,right,C2,500,7,-8,-11,3
720575940627843224,right,C2,501,1,2,0,2
720575940627737348,right,C2,503,3,17,5,12
720575940621312176,right,C2,504,-2,9,6,3
720575940622194102,right,C2,505,6,-22,-17,-5
720575940618856246,right,C2,506,1,-12,-7,-5
720575940608157058,right,C2,507,-5,-12,-1,-11
720575940614568338,right,C2,508,-5,11,10,1
720575940624081643,right,C2,509,-4,10,9,1
720575940624531348,right,C2,510,-2,11,7,4
720575940616887435,right,C2,511,5,-11,-11,0
720575940631444522,right,C2,512,6,0,-6,6
720575940622486441,right,C2,513,-4,-13,-3,-10
720575940618130260,right,C2,514,-4,-10,-1,-9
720575940632579411,right,C2,515,-8,-7,4,-11
720575940635262900,right,C2,516,7,-18,-16,-2
720575940623532471,right,C2,518,-4,22,15,7
720575940621571199,right,C2,519,-5,-5,2,-7
720575940614476269,right,C2,520,-2,-22,-9,-13
720575940615463934,right,C2,521,6,-9,-11,2
720575940621555137,right,C2,522,-4,0,4,-4
720575940623684021,right,C2,523,2,14,5,9
720575940632225583,right,C2,524,4,-20,-14,-6
720575940621718182,right,C2,525,-1,-20,-9,-11
720575940627680584,right,C2,526,0,-10,-5,-5
720575940610945122,right,C2,527,-4,-8,0,-8
720575940610564164,right,C2,528,2,7,1,6
720575940624992295,right,C2,529,2,-2,-3,1
720575940621692353,right,C2,530,-3,-13,-4,-9
720575940632747880,right,C2,531,1,0,-1,1
720575940606944130,right,C2,532,-8,7,11,-4
720575940620705995,right,C2,533,0,-16,-8,-8
720575940622554248,right,C2,534,3,2,-2,4
720575940619654193,right,C2,536,3,4,-1,5
720575940628221583,right,C2,537,0,-23,-12,-11
720575940628577402,right,C2,538,-4,1,4,-3
720575940612279961,right,C2,539,-6,15,13,2
720575940641936603,right,C2,540,-2,-9,-3,-6
720575940611872376,right,C2,541,-4,14,11,3
720575940615188586,right,C2,542,6,-13,-13,0
720575940620695022,right,C2,543,-1,-4,-1,-3
720575940625573351,right,C2,544,3,-13,-10,-3
720575940643891104,right,C2,545,5,11,0,11
720575940644317476,right,C2,546,3,6,0,6
720575940635227034,right,C2,547,-1,21,11,10
720575940633096785,right,C2,548,1,-16,-9,-7
720575940621825407,right,C2,549,0,-9,-5,-4
720575940614929770,right,C2,550,-2,3,3,0
720575940616967611,right,C2,551,-4,-9,-1,-8
720575940622662877,right,C2,552,4,-1,-5,4
720575940617836189,right,C2,553,-3,16,11,5
720575940618829083,right,C2,554,-9,-3,7,-10
720575940627783164,right,C2,555,-4,9,8,1
720575940652415734,right,C2,556,0,10,5,5
720575940630054393,right,C2,557,6,-10,-11,1
720575940623792108,right,C2,558,-4,-21,-7,-14
720575940613481113,right,C2,559,-6,22,17,5
720575940612280217,right,C2,560,-7,14,14,0
720575940623081827,right,C2,561,5,7,-2,9
720575940622043998,right,C2,562,-5,-2,4,-6
720575940628069393,right,C2,563,5,-13,-12,-1
720575940622028726,right,C2,564,3,-23,-15,-8
720575940616322783,right,C2,565,0,-26,-13,-13
720575940614790818,right,C2,566,5,-8,-9,1
720575940655418529,right,C2,567,-2,22,13,9
720575940626364197,right,C2,568,-6,-8,2,-10
720575940627700888,right,C2,570,2,25,10,15
720575940615427239,right,C2,571,0,-14,-7,-7
720575940614374910,right,C2,572,-8,3,9,-6
720575940628690453,right,C2,573,4,14,3,11
720575940643633824,right,C2,574,-6,5,8,-3
720575940628368915,right,C2,576,0,28,14,14
720575940617813814,right,C2,577,5,-14,-12,-2
720575940622195700,right,C2,578,4,-11,-10,-1
720575940605974630,right,C2,579,-3,-10,-2,-8
720575940618763291,right,C2,580,-2,-23,-10,-13
720575940615774358,right,C2,581,3,9,1,8
720575940624584231,right,C2,582,-1,23,12,11
720575940634707937,right,C2,583,3,-25,-16,-9
720575940636433076,right,C2,584,4,23,7,16
720575940613497366,right,C2,585,-1,-23,-11,-12
720575940634687388,right,C2,586,2,18,7,11
720575940614560808,right,C2,587,4,22,7,15
720575940621933556,right,C2,588,1,4,1,3
720575940615779046,right,C2,589,-1,-5,-2,-3
720575940634181075,right,C2,590,1,9,3,6
720575940647362083,right,C2,591,3,-3,-5,2
720575940631637243,right,C2,593,3,-14,-10,-4
720575940612839889,right,C2,594,7,-16,-15,-1
720575940635267735,right,C2,595,7,-12,-13,1
720575940623066003,right,C2,596,-4,-16,-4,-12
720575940636883374,right,C2,597,4,1,-4,5
720575940631402870,right,C2,598,2,-18,-11,-7
720575940628138664,right,C2,599,-1,9,5,4
720575940617666443,right,C2,600,3,-10,-8,-2
720575940623959178,right,C2,601,1,16,7,9
720575940633089676,right,C2,602,4,-2,-5,3
720575940623976461,right,C2,603,-3,-23,-9,-14
720575940627902351,right,C2,604,-6,-17,-3,-14
720575940612863858,right,C2,605,3,15,4,11
720575940614277859,right,C2,606,-1,-19,-9,-10
720575940621020737,right,C2,607,1,18,8,10
720575940609090571,right,C2,608,1,10,4,6
720575940620689134,right,C2,609,-2,0,2,-2
720575940631099679,right,C2,610,2,-23,-14,-9
720575940620633560,right,C2,611,-1,-18,-8,-10
720575940621941274,right,C2,613,-8,-4,6,-10
720575940640655824,right,C2,614,-2,-8,-2,-6
720575940644715936,right,C2,616,-3,15,10,5
720575940633057188,right,C2,617,-2,-17,-7,-10
720575940623606313,right,C2,618,-1,24,13,11
720575940618393885,right,C2,619,-4,-19,-6,-13
720575940611627730,right,C2,620,7,1,-7,8
720575940613843251,right,C2,621,1,24,11,13
720575940620109076,right,C2,622,-5,20,15,5
720575940645761303,right,C2,623,1,13,5,8
720575940631866922,right,C2,624,1,-17,-10,-7
720575940624957448,right,C2,625,-2,24,14,10
720575940634984032,right,C2,626,-5,-8,1,-9
720575940621500864,right,C2,627,0,-1,-1,0
720575940625537511,right,C2,628,0,0,0,0
720575940646226467,right,C2,629,4,24,8,16
720575940610260419,right,C2,630,4,8,0,8
720575940629061063,right,C2,631,1,26,12,14
720575940644868296,right,C2,632,3,-20,-13,-7
720575940632473667,right,C2,633,-1,-24,-11,-13
720575940638781417,right,C2,634,-3,-15,-5,-10
720575940630988544,right,C2,635,6,-6,-9,3
720575940617356545,right,C2,636,0,6,3,3
720575940617449913,right,C2,637,3,-21,-14,-7
720575940632663716,right,C2,638,-1,7,4,3
720575940621805172,right,C2,639,-4,19,13,6
720575940629038332,right,C2,640,-1,-16,-7,-9
720575940626550403,right,C2,641,-8,-5,5,-10
720575940613653219,right,C2,642,-5,-11,-1,-10
720575940625341171,right,C2,643,6,14,1,13
720575940609263115,right,C2,644,-6,18,15,3
720575940623786495,right,C2,645,-4,27,17,10
720575940614529261,right,C2,646,6,17,2,15
720575940614282792,right,C2,647,-4,-7,0,-7
720575940647056163,right,C2,648,1,7,2,5
720575940650770297,right,C2,649,-1,5,3,2
720575940629098492,right,C2,650,-3,-25,-10,-15
720575940622489814,right,C2,651,-4,-5,1,-6
720575940610288964,right,C2,653,-6,-12,0,-12
720575940605504446,right,C2,654,-3,8,7,1
720575940615259030,right,C2,655,6,-1,-7,6
720575940640531032,right,C2,656,0,-11,-6,-5
720575940625178376,right,C2,657,-2,-25,-11,-14
720575940621305515,right,C2,658,1,20,9,11
720575940628768528,right,C2,659,-4,-6,1,-7
720575940614151651,right,C2,661,-3,14,10,4
720575940628326922,right,C2,662,2,-1,-3,2
720575940632218984,right,C2,663,0,8,4,4
720575940624431398,right,C2,664,1,-27,-15,-12
720575940631605132,right,C2,665,7,-2,-8,6
720575940635408279,right,C2,666,7,-13,-14,1
720575940640025141,right,C2,667,1,-28,-15,-13
720575940639445923,right,C2,668,1,19,8,11
720575940633403167,right,C2,669,4,-16,-12,-4
720575940614503731,right,C2,671,-4,-23,-8,-15
720575940624080619,right,C2,672,-8,11,13,-2
720575940635590767,right,C2,673,2,5,0,5
720575940631868008,right,C2,674,-4,-14,-3,-11
720575940629555578,right,C2,675,-7,19,16,3
720575940622219340,right,C2,676,-3,-21,-8,-13
720575940630428672,right,C2,677,0,11,5,6
720575940621143617,right,C2,678,3,-7,-7,0
720575940635264924,right,C2,679,4,18,5,13
720575940607199580,right,C2,680,-1,25,13,12
720575940623104862,right,C2,681,-2,-21,-9,-12
720575940614793378,right,C2,682,6,-8,-10,2
720575940620685806,right,C2,683,2,6,1,5
720575940628039250,right,C2,684,-6,17,14,3
720575940626839652,right,C2,685,-5,-9,0,-9
720575940623367050,right,C2,686,5,-22,-16,-6
720575940617042235,right,C2,687,-6,-3,4,-7
720575940625532564,right,C2,688,-7,10,12,-2
720575940621579691,right,C2,690,-7,-3,5,-8
720575940638488553,right,C2,692,-4,24,16,8
720575940627092617,right,C2,693,-3,25,15,10
720575940654444961,right,C2,695,-6,10,11,-1
720575940630975831,right,C2,696,-2,16,10,6
720575940627759961,right,C2,697,1,-22,-12,-10
720575940638405722,right,C2,698,6,-7,-10,3
720575940609178051,right,C2,699,-5,0,5,-5
720575940610960646,right,C2,700,5,15,2,13
720575940641583835,right,C2,701,0,-4,-2,-2
720575940636134495,right,C2,702,-5,23,16,7
720575940613352106,right,C2,703,-3,1,3,-2
720575940622346846,right,C2,704,-7,8,11,-3
720575940626890186,right,C2,705,1,1,-1,2
720575940628899304,right,C2,706,-7,-12,1,-13
720575940614614509,right,C2,707,-2,25,14,11
720575940622711517,right,C2,709,-2,-24,-10,-14
720575940627080122,right,C2,710,4,-25,-17,-8
720575940623720885,right,C2,711,-1,19,10,9
720575940630907729,right,C2,712,-7,12,13,-1
720575940626437732,right,C2,713,-6,16,14,2
720575940605622193,right,C2,714,5,12,1,11
720575940612549910,right,C2,715,4,10,1,9
720575940621791727,right,C2,716,4,-6,-7,1
720575940656148897,right,C2,717,2,-22,-13,-9
720575940648608132,right,C2,718,-5,24,17,7
720575940644585160,right,C2,719,1,27,12,15
720575940628571753,right,C2,720,-5,21,15,6
720575940624963255,right,C2,721,5,13,1,12
720575940634210003,right,C2,722,6,-15,-14,-1
720575940623344086,right,C2,723,-2,-11,-4,-7
720575940636023159,right,C2,724,4,2,-3,5
720575940620570453,right,C2,725,-3,-24,-9,-15
720575940630852396,right,C2,726,2,-28,-16,-12
720575940626065948,right,C2,728,7,12,-1,13
720575940611658389,right,C2,731,-6,9,10,-1
720575940635471540,right,C2,732,-3,6,6,0
720575940630790188,right,C2,733,-5,-17,-4,-13
720575940609237973,right,C2,734,2,0,-2,2
720575940645081288,right,C2,735,1,-23,-13,-10
720575940639645859,right,C2,736,-8,1,8,-7
720575940621029803,right,C2,737,0,19,9,10
720575940626972797,right,C2,738,-3,13,9,4
720575940621913114,right,C2,739,-7,2,8,-6
720575940628434490,right,C2,740,2,-8,-6,-2
720575940649255801,right,C2,741,-2,-14,-5,-9
720575940618342329,right,C2,742,-4,11,9,2
720575940639802557,right,C2,744,-4,25,16,9
720575940614702047,right,C2,745,0,13,6,7
720575940624842791,right,C2,746,-3,3,4,-1
720575940621653718,right,C2,747,0,2,1,1
720575940640403790,right,C2,748,-4,20,14,6
720575940630316375,right,C2,749,-2,1,2,-1
720575940622961441,right,C2,750,4,-24,-16,-8
720575940608310914,right,C2,751,1,6,2,4
720575940624283143,right,C2,752,-2,7,5,2
720575940625845991,right,C2,753,-3,24,15,9
720575940603435232,right,C2,754,-1,-13,-6,-7
720575940621757308,right,C2,755,4,19,5,14
720575940638452190,right,C2,756,5,20,5,15
720575940646427171,right,C2,757,0,-6,-3,-3
720575940645151432,right,C2,758,5,-1,-6,5
720575940625970178,right,C2,760,0,17,8,9
720575940638398185,right,C2,761,-4,-18,-5,-13
720575940629889530,right,C2,762,0,14,7,7
720575940635142495,right,C2,763,-5,14,12,2
720575940626121828,right,C2,764,-8,-6,5,-11
720575940627550376,right,C2,765,-3,9,7,2
720575940629508602,right,C2,766,2,-4,-4,0
720575940627298691,right,C2,767,1,28,13,15
720575940623500295,right,C2,768,3,5,-1,6
720575940629591040,right,C2,769,4,-27,-18,-9
720575940618400230,right,C2,770,5,4,-3,7
720575940636481391,right,C2,772,1,12,5,7
720575940647877252,right,C2,773,5,-19,-15,-4
720575940617859643,right,C2,774,-8,6,11,-5
720575940616311750,right,C2,775,5,22,6,16
720575940621599216,right,C2,776,5,21,5,16
720575940612693544,right,C2,777,6,20,4,16
720575940618589953,right,C2,779,5,24,7,17
720575940620981584,right,C2,780,-6,25,18,7
720575940620731989,right,C2,781,-5,26,18,8
720575940623109658,right,C2,783,-4,28,18,10
720575940634993177,right,C2,787,3,28,11,17
720575940639138281,right,C2,789,-3,-27,-11,-16
720575940612238798,right,C2,790,-2,-27,-12,-15
720575940606613536,right,C2,791,-1,-28,-13,-15
720575940620182182,right,C2,792,8,2,-7,9
720575940630240316,right,C2,793,8,-6,-11,5
720575940639181887,right,C2,794,5,-26,-18,-8
720575940641987829,right,C2,795,6,-21,-17,-4
720575940624400713,right,C3,1,-6,13,12,1
720575940629948983,right,C3,2,-8,2,9,-7
720575940609734357,right,C3,3,6,-12,-12,0
720575940633092492,right,C3,4,-5,-21,-6,-15
720575940622127740,right,C3,5,-1,16,9,7
720575940626359117,right,C3,6,-2,-4,0,-4
720575940646026116,right,C3,7,-6,-6,3,-9
720575940623110426,right,C3,8,-4,26,17,9
720575940613326322,right,C3,9,4,9,0,9
720575940623150728,right,C3,10,5,-15,-13,-2
720575940614791730,right,C3,11,7,-14,-14,0
720575940620613717,right,C3,12,-7,9,11,-2
720575940626049575,right,C3,13,-1,-26,-12,-14
720575940620889547,right,C3,14,0,-27,-14,-13
720575940637690970,right,C3,15,2,-3,-4,1
720575940612544921,right,C3,16,-2,-16,-6,-10
720575940631884359,right,C3,17,1,-5,-4,-1
720575940620613766,right,C3,18,5,-16,-13,-3
720575940635093099,right,C3,19,-7,17,15,2
720575940623810608,right,C3,20,3,-11,-9,-2
720575940634888855,right,C3,21,-2,19,11,8
720575940630183931,right,C3,22,-1,3,2,1
720575940617833762,right,C3,23,-3,-16,-5,-11
720575940612683816,right,C3,24,-1,-10,-4,-6
720575940614726854,right,C3,25,-9,3,10,-7
720575940619767893,right,C3,26,1,-3,-3,0
720575940627979141,right,C3,27,0,-25,-13,-12
720575940628434248,right,C3,28,5,6,-2,8
720575940624134985,right,C3,29,-1,-3,-1,-2
720575940639757683,right,C3,30,6,16,2,14
720575940639075647,right,C3,31,0,16,8,8
720575940613184995,right,C3,32,0,12,6,6
720575940622113633,right,C3,33,3,18,6,12
720575940608176818,right,C3,34,6,18,3,15
720575940635265436,right,C3,35,1,-24,-13,-11
720575940643706784,right,C3,36,6,8,-2,10
720575940639224179,right,C3,37,1,5,1,4
720575940661264001,right,C3,38,0,-2,-1,-1
720575940605834161,right,C3,39,0,20,10,10
720575940623117862,right,C3,40,-2,-6,-1,-5
720575940622448368,right,C3,41,-3,28,17,11
720575940605610784,right,C3,42,-1,14,8,6
720575940619563723,right,C3,43,-5,18,14,4
720575940622704922,right,C3,44,5,-10,-10,0
720575940639071551,right,C3,45,-5,-1,4,-5
720575940639466045,right,C3,46,-5,15,12,3
720575940626207234,right,C3,47,-9,-1,8,-9
720575940624784648,right,C3,48,-4,-22,-7,-15
720575940606709449,right,C3,49,4,-4,-6,2
720575940621180097,right,C3,50,-2,21,12,9
720575940625548728,right,C3,51,0,-19,-10,-9
720575940623590378,right,C3,52,-1,-22,-10,-12
720575940627737725,right,C3,53,5,14,2,12
720575940609088348,right,C3,54,-4,3,5,-2
720575940647264132,right,C3,55,-4,-11,-2,-9
720575940623977059,right,C3,56,1,-13,-8,-5
720575940638023024,right,C3,57,6,-11,-12,1
720575940610974254,right,C3,58,3,12,3,9
720575940622402943,right,C3,59,-2,2,3,-1
720575940636971497,right,C3,60,-8,8,12,-4
720575940610235086,right,C3,61,-4,-4,2,-6
720575940606872241,right,C3,62,0,-29,-15,-14
720575940611179054,right,C3,63,4,12,2,10
720575940626040508,right,C3,64,4,-23,-16,-7
720575940625609452,right,C3,66,2,15,5,10
720575940615359647,right,C3,67,-2,-13,-5,-8
720575940635473503,right,C3,68,3,16,5,11
720575940620852833,right,C3,69,1,8,3,5
720575940610497582,right,C3,70,-4,21,14,7
720575940628767248,right,C3,71,-2,-3,0,-3
720575940621347749,right,C3,72,0,-28,-14,-14
720575940630612987,right,C3,73,2,2,-1,3
720575940632637215,right,C3,74,-1,-9,-4,-5
720575940626029200,right,C3,75,-6,14,13,1
720575940617835547,right,C3,76,-3,-4,1,-5
720575940629408497,right,C3,77,2,-5,-5,0
720575940630283068,right,C3,78,2,20,8,12
720575940632415116,right,C3,79,2,1,-2,3
720575940624543271,right,C3,81,6,-2,-7,5
720575940626648836,right,C3,82,-7,7,10,-3
720575940614528040,right,C3,83,2,-21,-13,-8
720575940644774167,right,C3,84,-2,12,8,4
720575940622740208,right,C3,85,4,-22,-15,-7
720575940632524627,right,C3,86,-5,-7,1,-8
720575940607184329,right,C3,87,1,11,4,7
720575940627505283,right,C3,88,7,4,-5,9
720575940630767097,right,C3,89,1,-19,-11,-8
720575940611973489,right,C3,90,-4,5,6,-1
720575940616839730,right,C3,91,-1,6,4,2
720575940639466054,right,C3,92,0,9,4,5
720575940607235593,right,C3,93,-6,3,7,-4
720575940612552946,right,C3,94,5,18,4,14
720575940611846769,right,C3,95,4,-21,-15,-6
720575940633247569,right,C3,96,1,-10,-6,-4
720575940622480408,right,C3,97,-5,2,6,-4
720575940629497094,right,C3,98,-1,-12,-5,-7
720575940616274827,right,C3,99,4,15,3,12
720575940626572837,right,C3,100,2,-10,-7,-3
720575940621595937,right,C3,101,-7,6,10,-4
720575940613472741,right,C3,102,3,13,3,10
720575940628550916,right,C3,103,7,9,-3,12
720575940614708236,right,C3,105,3,22,8,14
720575940620223281,right,C3,106,-7,11,12,-1
720575940624859623,right,C3,107,8,-2,-9,7
720575940616209932,right,C3,108,-3,-12,-3,-9
720575940614792098,right,C3,109,4,-5,-7,2
720575940625817232,right,C3,110,-7,0,7,-7
720575940619074587,right,C3,111,2,-24,-14,-10
720575940612739989,right,C3,112,-6,1,6,-5
720575940639216499,right,C3,113,-2,4,4,0
720575940631246863,right,C3,114,2,-13,-9,-4
720575940640405582,right,C3,115,-4,2,5,-3
720575940614697127,right,C3,116,-1,-8,-3,-5
720575940652456438,right,C3,117,-8,-2,7,-9
720575940632763935,right,C3,118,3,1,-3,4
720575940608061826,right,C3,119,-2,6,5,1
720575940618882171,right,C3,120,-1,-1,0,-1
720575940616599618,right,C3,121,-8,4,10,-6
720575940629123177,right,C3,122,-5,9,9,0
720575940629976323,right,C3,123,-8,10,13,-3
720575940616568114,right,C3,124,1,-7,-5,-2
720575940626290946,right,C3,125,5,9,-1,10
720575940610426051,right,C3,126,3,11,2,9
720575940604476774,right,C3,127,0,15,7,8
720575940620688110,right,C3,128,3,-22,-14,-8
720575940622053381,right,C3,129,0,-13,-7,-6
720575940613485608,right,C3,130,2,12,4,8
720575940652374518,right,C3,131,-6,20,16,4
720575940631294531,right,C3,132,2,4,0,4
720575940637328198,right,C3,133,-3,20,13,7
720575940625716628,right,C3,134,-5,-18,-4,-14
720575940614839739,right,C3,135,-3,-22,-8,-14
720575940623006758,right,C3,136,0,3,1,2
720575940612455282,right,C3,137,5,-7,-9,2
720575940621870445,right,C3,138,0,27,13,14
720575940630161463,right,C3,139,1,-14,-8,-6
720575940636712055,right,C3,140,3,8,1,7
720575940628077138,right,C3,141,5,-23,-17,-6
720575940614222801,right,C3,142,-2,-18,-7,-11
720575940623012702,right,C3,143,-4,16,12,4
720575940622847749,right,C3,144,7,-11,-13,2
720575940642370011,right,C3,145,0,4,2,2
720575940636108407,right,C3,146,1,-6,-4,-2
720575940620571409,right,C3,147,1,21,9,12
720575940604521440,right,C3,148,-7,-11,1,-12
720575940622829309,right,C3,149,6,-14,-13,-1
720575940630546171,right,C3,150,-8,5,10,-5
720575940631420268,right,C3,151,-3,-14,-4,-10
720575940613819670,right,C3,152,3,-15,-11,-4
720575940608278364,right,C3,153,8,0,-8,8
720575940636717230,right,C3,154,-8,0,8,-8
720575940629646583,right,C3,155,-8,13,14,-1
720575940631115794,right,C3,156,-9,1,9,-8
720575940624492176,right,C3,157,-1,-7,-3,-4
720575940625776115,right,C3,158,3,-5,-6,1
720575940623626995,right,C3,160,-2,20,12,8
720575940631408758,right,C3,161,4,-14,-11,-3
720575940632330344,right,C3,162,-4,-2,3,-5
720575940620968277,right,C3,163,-9,7,12,-5
720575940619964039,right,C3,164,-1,-2,0,-2
720575940624567334,right,C3,165,4,16,4,12
720575940632264040,right,C3,166,0,18,9,9
720575940636601742,right,C3,167,0,-17,-9,-8
720575940615916594,right,C3,168,-1,17,9,8
720575940629573626,right,C3,169,0,-18,-9,-9
720575940640455808,right,C3,170,-5,1,5,-4
720575940625879754,right,C3,171,6,-20,-16,-4
720575940630715518,right,C3,172,1,22,10,12
720575940612421874,right,C3,173,2,-25,-15,-10
720575940615406994,right,C3,174,4,-15,-12,-3
720575940632059532,right,C3,175,-6,-7,2,-9
720575940615466655,right,C3,176,-2,13,8,5
720575940632085063,right,C3,177,-2,-1,1,-2
720575940613692950,right,C3,178,2,11,3,8
720575940614071505,right,C3,179,-5,-16,-3,-13
720575940633542995,right,C3,180,2,-27,-16,-11
720575940638211300,right,C3,181,1,-4,-3,-1
720575940618000541,right,C3,182,7,-10,-12,2
720575940661245825,right,C3,183,-5,-15,-3,-12
720575940627994108,right,C3,184,-6,-5,3,-8
720575940639217085,right,C3,185,2,-11,-8,-3
720575940630870615,right,C3,186,-1,26,14,12
720575940620054101,right,C3,187,3,21,7,14
720575940632264003,right,C3,188,-5,17,13,4
720575940626837117,right,C3,189,6,13,0,13
720575940620262848,right,C3,190,-3,-5,0,-5
720575940609036757,right,C3,191,-1,-11,-5,-6
720575940625937338,right,C3,192,7,10,-2,12
720575940622895885,right,C3,193,-5,4,7,-3
720575940610001109,right,C3,194,0,-5,-3,-2
720575940622921421,right,C3,195,-3,-1,2,-3
720575940613671594,right,C3,196,-1,8,5,3
720575940630315770,right,C3,197,0,-20,-10,-10
720575940605174304,right,C3,198,6,2,-5,7
720575940604692704,right,C3,199,0,-12,-6,-6
720575940630445911,right,C3,200,-5,12,11,1
720575940630243943,right,C3,201,-8,9,12,-3
720575940615601575,right,C3,202,-1,27,14,13
720575940647633460,right,C3,203,3,-1,-4,3
720575940631143724,right,C3,204,5,-2,-6,4
720575940632621988,right,C3,205,5,-6,-8,2
720575940639489955,right,C3,206,-3,5,5,0
720575940623448188,right,C3,207,1,29,13,16
720575940632313931,right,C3,208,5,-21,-16,-5
720575940617200601,right,C3,209,-3,-8,-1,-7
720575940623818421,right,C3,210,-6,8,10,-2
720575940631827256,right,C3,211,-7,-1,6,-7
720575940620826733,right,C3,212,2,-16,-10,-6
720575940604307936,right,C3,213,3,-4,-5,1
720575940634840767,right,C3,214,-5,3,6,-3
720575940630765946,right,C3,215,6,7,-3,10
720575940639939280,right,C3,216,2,19,7,12
720575940621462918,right,C3,217,6,15,1,14
720575940618749238,right,C3,218,2,10,3,7
720575940611274725,right,C3,219,6,-4,-8,4
720575940610902738,right,C3,220,2,-6,-5,-1
720575940615497383,right,C3,221,-7,3,8,-5
720575940635558904,right,C3,222,-3,26,16,10
720575940620639329,right,C3,223,-2,26,15,11
720575940622186793,right,C3,224,0,5,2,3
720575940628350538,right,C3,225,2,-26,-15,-11
720575940641064333,right,C3,226,5,19,4,15
720575940631855185,right,C3,227,-7,5,9,-4
720575940620659053,right,C3,228,-7,1,7,-6
720575940623910349,right,C3,229,5,2,-4,6
720575940638786118,right,C3,230,2,9,2,7
720575940618736448,right,C3,231,4,-12,-10,-2
720575940629991243,right,C3,232,-4,13,10,3
720575940632154439,right,C3,233,4,-13,-11,-2
720575940625022707,right,C3,234,1,3,0,3
720575940640413347,right,C3,235,4,11,1,10
720575940618813248,right,C3,236,-1,4,3,1
720575940625846814,right,C3,237,-2,27,15,12
720575940617602843,right,C3,238,-8,-3,6,-9
720575940621954081,right,C3,239,-6,6,9,-3
720575940611266510,right,C3,240,-4,-3,2,-5
720575940623151496,right,C3,241,2,-17,-11,-6
720575940607332873,right,C3,242,-4,6,7,-1
720575940634003885,right,C3,243,-1,-21,-10,-11
720575940620786342,right,C3,244,-4,-12,-2,-10
720575940612997093,right,C3,245,-5,-3,3,-6
720575940647051043,right,C3,246,-4,15,11,4
720575940617753758,right,C3,247,-4,-15,-4,-11
720575940627242737,right,C3,248,-6,0,6,-6
720575940623921159,right,C3,249,2,-12,-8,-4
720575940644675694,right,C3,250,-1,1,1,0
720575940627394314,right,C3,251,-1,-14,-6,-8
720575940637474928,right,C3,252,3,23,8,15
720575940623724899,right,C3,253,5,16,3,13
720575940627416457,right,C3,254,3,-24,-15,-9
720575940620707098,right,C3,255,-6,-13,-1,-12
720575940625969594,right,C3,256,5,-20,-15,-5
720575940612037594,right,C3,257,2,21,8,13
720575940621966249,right,C3,258,-4,-17,-5,-12
720575940618084445,right,C3,259,-7,-5,4,-9
720575940633792737,right,C3,260,-3,19,12,7
720575940612551321,right,C3,261,-1,13,7,6
720575940620830635,right,C3,262,1,-11,-7,-4
720575940621269884,right,C3,263,-3,4,5,-1
720575940628256655,right,C3,264,-1,-6,-2,-4
720575940631257508,right,C3,265,-6,-1,5,-6
720575940629124551,right,C3,266,-1,-25,-12,-13
720575940605553598,right,C3,267,-6,2,7,-5
720575940620735878,right,C3,268,7,-6,-10,4
720575940635308444,right,C3,269,2,-19,-12,-7
720575940609862667,right,C3,270,1,-8,-5,-3
720575940632534476,right,C3,271,4,6,-1,7
720575940611104462,right,C3,272,3,-2,-4,2
720575940626636176,right,C3,273,-6,23,17,6
720575940628637937,right,C3,275,-8,-1,7,-8
720575940627728657,right,C3,276,2,3,-1,4
720575940622021452,right,C3,277,7,-3,-9,6
720575940632504801,right,C3,278,-5,10,10,0
720575940632185130,right,C3,279,-4,8,8,0
720575940644937751,right,C3,280,-6,-14,-1,-13
720575940611780761,right,C3,281,-9,2,10,-8
720575940612728342,right,C3,282,0,26,13,13
720575940639286899,right,C3,283,-4,4,6,-2
720575940610720120,right,C3,284,0,25,12,13
720575940623108301,right,C3,285,6,-18,-15,-3
720575940647626804,right,C3,286,0,-24,-12,-12
720575940624041924,right,C3,287,-5,13,11,2
720575940624169001,right,C3,289,-1,11,6,5
720575940617892219,right,C3,290,5,-24,-17,-7
720575940640144829,right,C3,291,7,2,-6,8
720575940633855513,right,C3,292,-4,18,13,5
720575940625745808,right,C3,293,4,-17,-13,-4
720575940634288339,right,C3,294,1,-20,-11,-9
720575940627160266,right,C3,296,1,-18,-10,-8
720575940631754703,right,C3,297,7,-9,-12,3
720575940631729103,right,C3,298,-5,5,7,-2
720575940620015892,right,C3,299,-4,12,10,2
720575940632756781,right,C3,300,4,-18,-13,-5
720575940625522667,right,C3,301,-5,16,13,3
720575940606423840,right,C3,302,2,17,6,11
720575940630804933,right,C3,303,-5,22,16,6
720575940614342823,right,C3,305,-7,4,9,-5
720575940624289205,right,C3,306,3,7,0,7
720575940628893160,right,C3,307,5,-25,-18,-7
720575940626963593,right,C3,308,-5,8,9,-1
720575940644751639,right,C3,309,-6,12,12,0
720575940624994557,right,C3,310,2,22,9,13
720575940631057679,right,C3,311,-7,15,14,1
720575940636889456,right,C3,312,4,-7,-8,1
720575940629453553,right,C3,313,7,3,-6,9
720575940612153622,right,C3,314,-9,5,11,-6
720575940605469286,right,C3,315,-3,-6,0,-6
720575940622083845,right,C3,316,5,-4,-7,3
720575940632748648,right,C3,317,-5,-4,3,-7
720575940614525351,right,C3,318,4,-19,-14,-5
720575940613796630,right,C3,319,-2,5,4,1
720575940611865713,right,C3,320,-2,-5,-1,-4
720575940630242295,right,C3,322,2,26,11,15
720575940616515814,right,C3,323,-7,-13,0,-13
720575940641694197,right,C3,324,3,24,9,15
720575940630872428,right,C3,325,5,1,-5,6
720575940628125948,right,C3,326,2,16,6,10
720575940647599492,right,C3,328,5,-9,-10,1
720575940619903625,right,C3,329,0,24,12,12
720575940620976048,right,C3,330,3,3,-2,5
720575940633830445,right,C3,331,1,-15,-9,-6
720575940627484297,right,C3,332,4,-26,-17,-9
720575940627839881,right,C3,333,0,-21,-11,-10
720575940632780077,right,C3,334,1,-26,-14,-12
720575940624018249,right,C3,335,2,8,2,6
720575940622213289,right,C3,336,0,23,11,12
720575940633892435,right,C3,337,-5,-6,2,-8
720575940626342745,right,C3,338,-1,0,1,-1
720575940613686993,right,C3,339,6,11,-1,12
720575940617805405,right,C3,340,-4,17,12,5
720575940628981975,right,C3,341,6,-17,-15,-2
720575940621581317,right,C3,342,2,-15,-10,-5
720575940622132406,right,C3,343,-3,27,16,11
720575940621383796,right,C3,344,-2,-15,-6,-9
720575940624389159,right,C3,345,3,-12,-9,-3
720575940639795571,right,C3,346,-7,-9,2,-11
720575940636140407,right,C3,347,-5,-13,-2,-11
720575940625114957,right,C3,349,-5,-14,-2,-12
720575940620108715,right,C3,350,1,15,6,9
720575940616530210,right,C3,351,-1,-17,-8,-9
720575940631920079,right,C3,352,-2,28,16,12
720575940631020495,right,C3,353,2,24,10,14
720575940631332828,right,C3,354,-2,-26,-11,-15
720575940626101450,right,C3,355,-7,-6,4,-10
720575940623135210,right,C3,356,0,22,11,11
720575940617834681,right,C3,357,4,17,4,13
720575940628358662,right,C3,358,-3,17,11,6
720575940619210667,right,C3,359,2,23,9,14
720575940620062110,right,C3,360,-5,19,14,5
720575940623819619,right,C3,361,0,-7,-4,-3
720575940621362241,right,C3,362,2,-20,-12,-8
720575940608752651,right,C3,363,7,-4,-9,5
720575940612171470,right,C3,364,4,4,-2,6
720575940624159123,right,C3,365,4,7,-1,8
720575940611797458,right,C3,366,-5,-20,-5,-15
720575940635484852,right,C3,367,-6,-15,-2,-13
720575940635590324,right,C3,368,-4,-20,-6,-14
720575940627379987,right,C3,369,5,-5,-8,3
720575940625907044,right,C3,370,-3,21,13,8
720575940610958290,right,C3,371,6,-5,-9,4
720575940632171083,right,C3,372,1,-2,-2,0
720575940624819785,right,C3,373,1,-21,-12,-9
720575940632456490,right,C3,374,2,13,4,9
720575940610373752,right,C3,375,-6,7,9,-2
720575940619723885,right,C3,376,-7,-10,2,-12
720575940617717282,right,C3,377,0,7,3,4
720575940615184031,right,C3,378,-3,18,12,6
720575940640419491,right,C3,379,3,-17,-12,-5
720575940622934601,right,C3,381,-8,-9,3,-12
720575940626801726,right,C3,382,3,-6,-6,0
720575940609790987,right,C3,383,-6,11,11,0
720575940616417878,right,C3,384,-6,-2,5,-7
720575940608043954,right,C3,385,-3,-18,-6,-12
720575940639650109,right,C3,386,-6,19,15,4
720575940623363978,right,C3,387,-1,-15,-7,-8
720575940629161713,right,C3,388,3,19,6,13
720575940628359430,right,C3,389,-6,-16,-2,-14
720575940635635892,right,C3,390,-6,-9,1,-10
720575940620061387,right,C3,391,4,-3,-6,3
720575940661057665,right,C3,392,-4,7,7,0
720575940629972418,right,C3,393,-1,22,12,10
720575940611015010,right,C3,394,-7,-8,3,-11
720575940607221426,right,C3,395,0,-22,-11,-11
720575940629859371,right,C3,396,-1,10,6,4
720575940624803303,right,C3,397,-3,-19,-7,-12
720575940618232861,right,C3,398,-3,22,14,8
720575940614320611,right,C3,399,-4,-24,-8,-16
720575940625889317,right,C3,401,-2,-19,-8,-11
720575940623554311,right,C3,402,3,26,10,16
720575940614624935,right,C3,403,-2,-12,-4,-8
720575940618886747,right,C3,404,-1,20,11,9
720575940625563429,right,C3,405,3,10,2,8
720575940619016315,right,C3,406,1,-25,-14,-11
720575940622275248,right,C3,407,-5,-10,0,-10
720575940611235534,right,C3,408,-6,-4,4,-8
720575940633436324,right,C3,409,0,-3,-2,-1
720575940619509894,right,C3,410,-2,-2,1,-3
720575940623740935,right,C3,411,-5,-19,-5,-14
720575940617540582,right,C3,412,-6,21,16,5
720575940629497338,right,C3,413,-2,-7,-2,-5
720575940636414126,right,C3,414,4,21,6,15
720575940624029704,right,C3,415,6,12,0,12
720575940628750185,right,C3,416,3,-8,-7,-1
720575940618783808,right,C3,417,-6,-10,1,-11
720575940618873115,right,C3,418,-2,15,9,6
720575940627850312,right,C3,420,6,-3,-8,5
720575940619243313,right,C3,421,-1,12,7,5
720575940630467948,right,C3,422,-7,-4,5,-9
720575940627081502,right,C3,423,3,-18,-12,-6
720575940630172571,right,C3,424,-3,-2,2,-4
720575940632753837,right,C3,425,3,20,7,13
720575940628541801,right,C3,426,-3,0,3,-3
720575940620490587,right,C3,427,5,-18,-14,-4
720575940619983262,right,C3,428,-2,23,13,10
720575940617525177,right,C3,429,-2,14,9,5
720575940626595074,right,C3,430,-3,-7,-1,-6
720575940623291177,right,C3,431,-2,-10,-3,-7
720575940638447523,right,C3,432,-5,7,8,-1
720575940625441684,right,C3,433,0,-8,-4,-4
720575940614761647,right,C3,434,-3,7,6,1
720575940629741694,right,C3,435,5,-17,-14,-3
720575940626532354,right,C3,436,0,-15,-8,-7
720575940621294768,right,C3,437,-3,12,9,3
720575940608302002,right,C3,438,2,27,11,16
720575940614444328,right,C3,439,-3,-9,-2,-7
720575940621343670,right,C3,440,1,23,10,13
720575940623148424,right,C3,441,3,-16,-11,-5
720575940633506079,right,C3,442,-5,25,17,8
720575940632695204,right,C3,443,-6,4,8,-4
720575940629292806,right,C3,444,4,-10,-9,-1
720575940639647651,right,C3,445,-2,8,6,2
720575940625075726,right,C3,446,2,-14,-9,-5
720575940625351780,right,C3,447,-1,2,2,0
720575940640412635,right,C3,449,6,-16,-14,-2
720575940620678022,right,C3,450,2,-9,-7,-2
720575940631544659,right,C3,451,4,20,6,14
720575940633171108,right,C3,452,1,-9,-6,-3
720575940622515461,right,C3,453,3,25,9,16
720575940629062138,right,C3,454,5,-12,-11,-1
720575940626387458,right,C3,455,7,-7,-11,4
720575940644497188,right,C3,456,0,21,10,11
720575940620543323,right,C3,457,-2,17,10,7
720575940624929789,right,C3,458,5,0,-5,5
720575940627838333,right,C3,459,5,-3,-7,4
720575940631379707,right,C3,460,-3,-20,-7,-13
720575940606090412,right,C3,461,7,-5,-10,5
720575940620384080,right,C3,462,-1,18,10,8
720575940634440343,right,C3,463,5,17,3,14
720575940628981035,right,C3,464,4,0,-4,4
720575940630613356,right,C3,465,3,0,-3,3
720575940610346030,right,C3,466,1,14,6,8
720575940621774360,right,C3,467,-2,-20,-8,-12
720575940624886712,right,C3,468,-3,11,8,3
720575940636912986,right,C3,469,-7,13,13,0
720575940631694136,right,C3,470,4,-9,-9,0
720575940630898284,right,C3,471,3,-26,-16,-10
720575940624229970,right,C3,472,1,25,11,14
720575940633087535,right,C3,473,-4,23,15,8
720575940620390127,right,C3,474,-3,-17,-6,-11
720575940620417473,right,C3,475,-4,-1,3,-4
720575940625018109,right,C3,476,-1,15,8,7
720575940619137307,right,C3,477,-3,2,4,-2
720575940622315754,right,C3,478,-7,16,15,1
720575940637625456,right,C3,479,-2,10,7,3
720575940609040341,right,C3,480,3,-19,-13,-6
720575940621270637,right,C3,481,4,-8,-8,0
720575940616476555,right,C3,482,1,17,7,10
720575940619014685,right,C3,483,2,-7,-6,-1
720575940623608870,right,C3,484,3,-9,-8,-1
720575940630215127,right,C3,485,-3,-3,1,-4
720575940633340959,right,C3,486,0,1,0,1
720575940621591536,right,C3,487,1,-1,-2,1
720575940621564864,right,C3,488,7,5,-5,10
720575940631411983,right,C3,489,-3,10,8,2
720575940624542183,right,C3,490,-5,6,8,-2
720575940612470757,right,C3,491,7,-1,-8,7
720575940621423296,right,C3,492,-7,-2,6,-8
720575940623125793,right,C3,493,-3,23,14,9
720575940632058063,right,C3,494,0,29,14,15
720575940616047116,right,C3,496,7,8,-3,11
720575940621303024,right,C3,497,6,1,-6,7
720575940630716534,right,C3,498,6,10,-1,11
720575940614623634,right,C3,499,5,10,0,10
720575940619582118,right,C3,500,7,-8,-11,3
720575940627078417,right,C3,501,1,2,0,2
720575940647379764,right,C3,502,5,8,-1,9
720575940627432469,right,C3,503,3,17,5,12
720575940617274836,right,C3,504,-2,9,6,3
720575940623432141,right,C3,505,6,-22,-17,-5
720575940612520933,right,C3,506,1,-12,-7,-5
720575940624916286,right,C3,507,-5,-12,-1,-11
720575940638198342,right,C3,508,-5,11,10,1
720575940622900237,right,C3,509,-4,10,9,1
720575940621810437,right,C3,510,-2,11,7,4
720575940648558980,right,C3,511,5,-11,-11,0
720575940624279549,right,C3,512,6,0,-6,6
720575940631225119,right,C3,513,-4,-13,-3,-10
720575940620658285,right,C3,514,-4,-10,-1,-9
720575940627284101,right,C3,515,-8,-7,4,-11
720575940626882762,right,C3,518,-4,22,15,7
720575940612298389,right,C3,519,-5,-5,2,-7
720575940617935138,right,C3,520,-2,-22,-9,-13
720575940645243427,right,C3,521,6,-9,-11,2
720575940615600690,right,C3,522,-4,0,4,-4
720575940630307835,right,C3,523,2,14,5,9
720575940611438968,right,C3,524,4,-20,-14,-6
720575940621864986,right,C3,525,-1,-20,-9,-11
720575940634250336,right,C3,526,0,-10,-5,-5
720575940639159886,right,C3,527,-4,-8,0,-8
720575940623315836,right,C3,528,2,7,1,6
720575940627694824,right,C3,529,2,-2,-3,1
720575940620893761,right,C3,530,-3,-13,-4,-9
720575940611730642,right,C3,531,1,0,-1,1
720575940615343825,right,C3,532,-8,7,11,-4
720575940630625918,right,C3,533,0,-16,-8,-8
720575940633458124,right,C3,534,3,2,-2,4
720575940605682720,right,C3,535,8,-4,-10,6
720575940609497867,right,C3,536,3,4,-1,5
720575940627019876,right,C3,537,0,-23,-12,-11
720575940634536858,right,C3,538,-4,1,4,-3
720575940605861310,right,C3,539,-6,15,13,2
720575940620339078,right,C3,540,-2,-9,-3,-6
720575940615838358,right,C3,541,-4,14,11,3
720575940633319628,right,C3,542,6,-13,-13,0
720575940608761924,right,C3,543,-1,-4,-1,-3
720575940623281416,right,C3,544,3,-13,-10,-3
720575940622983081,right,C3,545,5,11,0,11
720575940624532459,right,C3,546,3,6,0,6
720575940637442270,right,C3,547,-1,21,11,10
720575940605894833,right,C3,549,0,-9,-5,-4
720575940639648163,right,C3,550,-2,3,3,0
720575940629734522,right,C3,551,-4,-9,-1,-8
720575940626993683,right,C3,552,4,-1,-5,4
720575940639688320,right,C3,553,-3,16,11,5
720575940621123393,right,C3,554,-9,-3,7,-10
720575940640228979,right,C3,555,-4,9,8,1
720575940633662628,right,C3,556,0,10,5,5
720575940619521950,right,C3,557,6,-10,-11,1
720575940612480151,right,C3,558,-4,-21,-7,-14
720575940639761059,right,C3,559,-6,22,17,5
720575940627074566,right,C3,560,-7,14,14,0
720575940613320434,right,C3,561,5,7,-2,9
720575940629830782,right,C3,562,-5,-2,4,-6
720575940618254917,right,C3,563,5,-13,-12,-1
720575940626575653,right,C3,564,3,-23,-15,-8
720575940627469840,right,C3,565,0,-26,-13,-13
720575940613373667,right,C3,566,5,-8,-9,1
720575940632670056,right,C3,567,-2,22,13,9
720575940626968862,right,C3,568,-6,-8,2,-10
720575940622146625,right,C3,569,6,6,-3,9
720575940615184434,right,C3,570,2,25,10,15
720575940623498790,right,C3,571,0,-14,-7,-7
720575940629901074,right,C3,572,-8,3,9,-6
720575940630542329,right,C3,573,4,14,3,11
720575940623901901,right,C3,574,-6,5,8,-3
720575940622477823,right,C3,575,6,9,-2,11
720575940639858485,right,C3,576,0,28,14,14
720575940620519685,right,C3,577,5,-14,-12,-2
720575940621694657,right,C3,578,4,-11,-10,-1
720575940618459200,right,C3,579,-3,-10,-2,-8
720575940612990003,right,C3,580,-2,-23,-10,-13
720575940631136274,right,C3,581,3,9,1,8
720575940624796052,right,C3,582,-1,23,12,11
720575940632320274,right,C3,583,3,-25,-16,-9
720575940637835182,right,C3,584,4,23,7,16
720575940632256583,right,C3,585,-1,-23,-11,-12
720575940632176012,right,C3,586,2,18,7,11
720575940636500069,right,C3,587,4,22,7,15
720575940622594292,right,C3,588,1,4,1,3
720575940632959535,right,C3,589,-1,-5,-2,-3
720575940622971928,right,C3,590,1,9,3,6
720575940629167878,right,C3,591,3,-3,-5,2
720575940632704339,right,C3,593,3,-14,-10,-4
720575940638450404,right,C3,594,7,-16,-15,-1
720575940614750358,right,C3,595,7,-12,-13,1
720575940626279196,right,C3,596,-4,-16,-4,-12
720575940612740374,right,C3,597,4,1,-4,5
720575940610111556,right,C3,598,2,-18,-11,-7
720575940632559928,right,C3,599,-1,9,5,4
720575940620315969,right,C3,600,3,-10,-8,-2
720575940617214395,right,C3,601,1,16,7,9
720575940607471538,right,C3,602,4,-2,-5,3
720575940629316763,right,C3,603,-3,-23,-9,-14
720575940627612945,right,C3,604,-6,-17,-3,-14
720575940622957311,right,C3,605,3,15,4,11
720575940629391354,right,C3,606,-1,-19,-9,-10
720575940622997628,right,C3,607,1,18,8,10
720575940639832125,right,C3,608,1,10,4,6
720575940634689175,right,C3,609,-2,0,2,-2
720575940619924816,right,C3,610,2,-23,-14,-9
720575940631968843,right,C3,611,-1,-18,-8,-10
720575940627726937,right,C3,612,-3,-26,-10,-16
720575940621923678,right,C3,613,-8,-4,6,-10
720575940620701889,right,C3,614,-2,-8,-2,-6
720575940607936898,right,C3,615,-7,-7,3,-10
720575940630434876,right,C3,616,-3,15,10,5
720575940620256960,right,C3,617,-2,-17,-7,-10
720575940631127158,right,C3,618,-1,24,13,11
720575940635770815,right,C3,619,-4,-19,-6,-13
720575940621064277,right,C3,620,7,1,-7,8
720575940619225537,right,C3,621,1,24,11,13
720575940636907376,right,C3,622,-5,20,15,5
720575940614625698,right,C3,623,1,13,5,8
720575940637608878,right,C3,624,1,-17,-10,-7
720575940623138559,right,C3,625,-2,24,14,10
720575940623024166,right,C3,626,-5,-8,1,-9
720575940636487054,right,C3,627,0,-1,-1,0
720575940639040445,right,C3,628,0,0,0,0
720575940628971850,right,C3,629,4,24,8,16
720575940624347430,right,C3,630,4,8,0,8
720575940613182122,right,C3,631,1,26,12,14
720575940610484782,right,C3,632,3,-20,-13,-7
720575940627410690,right,C3,633,-1,-24,-11,-13
720575940633909677,right,C3,634,-3,-15,-5,-10
720575940644408100,right,C3,635,6,-6,-9,3
720575940627174417,right,C3,636,0,6,3,3
720575940633546700,right,C3,637,3,-21,-14,-7
720575940636070392,right,C3,638,-1,7,4,3
720575940616367291,right,C3,639,-4,19,13,6
720575940605706430,right,C3,640,-1,-16,-7,-9
720575940618833310,right,C3,641,-8,-5,5,-10
720575940629953079,right,C3,642,-5,-11,-1,-10
720575940632961567,right,C3,643,6,14,1,13
720575940629564794,right,C3,644,-6,18,15,3
720575940624119944,right,C3,645,-4,27,17,10
720575940612569457,right,C3,647,-4,-7,0,-7
720575940616210738,right,C3,648,1,7,2,5
720575940636481204,right,C3,649,-1,5,3,2
720575940617013516,right,C3,650,-3,-25,-10,-15
720575940625063411,right,C3,651,-4,-5,1,-6
720575940616120669,right,C3,652,-6,-11,0,-11
720575940623654669,right,C3,653,-6,-12,0,-12
720575940634449890,right,C3,654,-3,8,7,1
720575940632572185,right,C3,655,6,-1,-7,6
720575940630520643,right,C3,656,0,-11,-6,-5
720575940605190624,right,C3,657,-2,-25,-11,-14
720575940631544618,right,C3,658,1,20,9,11
720575940628006855,right,C3,659,-4,-6,1,-7
720575940633439827,right,C3,660,2,28,12,16
720575940624612327,right,C3,661,-3,14,10,4
720575940620519616,right,C3,662,2,-1,-3,2
720575940625837242,right,C3,663,0,8,4,4
720575940617507894,right,C3,664,1,-27,-15,-12
720575940633387212,right,C3,665,7,-2,-8,6
720575940628345160,right,C3,666,7,-13,-14,1
720575940640134589,right,C3,667,1,-28,-15,-13
720575940632804920,right,C3,668,1,19,8,11
720575940640727896,right,C3,669,4,-16,-12,-4
720575940625977788,right,C3,670,5,5,-3,8
720575940625325861,right,C3,671,-4,-23,-8,-15
720575940628639473,right,C3,672,-8,11,13,-2
720575940659946625,right,C3,673,2,5,0,5
720575940615314498,right,C3,674,-4,-14,-3,-11
720575940625893159,right,C3,675,-7,19,16,3
720575940607202057,right,C3,676,-3,-21,-8,-13
720575940620905638,right,C3,677,0,11,5,6
720575940630266471,right,C3,678,3,-7,-7,0
720575940640812240,right,C3,679,4,18,5,13
720575940628355689,right,C3,680,-1,25,13,12
720575940615042479,right,C3,681,-2,-21,-9,-12
720575940615756866,right,C3,682,6,-8,-10,2
720575940624324169,right,C3,683,2,6,1,5
720575940633829145,right,C3,684,-6,17,14,3
720575940626506371,right,C3,685,-5,-9,0,-9
720575940628520710,right,C3,686,5,-22,-16,-6
720575940607105714,right,C3,687,-6,-3,4,-7
720575940617284820,right,C3,688,-7,10,12,-2
720575940620609006,right,C3,689,-2,18,11,7
720575940656083617,right,C3,690,-7,-3,5,-8
720575940609170371,right,C3,691,-9,4,11,-7
720575940609722889,right,C3,692,-4,24,16,8
720575940637836009,right,C3,693,-3,25,15,10
720575940612179173,right,C3,695,-6,10,11,-1
720575940639460467,right,C3,696,-2,16,10,6
720575940629793552,right,C3,697,1,-22,-12,-10
720575940628292168,right,C3,698,6,-7,-10,3
720575940618631253,right,C3,699,-5,0,5,-5
720575940633974172,right,C3,700,5,15,2,13
720575940632181585,right,C3,701,0,-4,-2,-2
720575940655640993,right,C3,702,-5,23,16,7
720575940605544736,right,C3,703,-3,1,3,-2
720575940622216624,right,C3,704,-7,8,11,-3
720575940637840218,right,C3,705,1,1,-1,2
720575940623387869,right,C3,707,-2,25,14,11
720575940635699095,right,C3,709,-2,-24,-10,-14
720575940634519392,right,C3,710,4,-25,-17,-8
720575940620609262,right,C3,711,-1,19,10,9
720575940610184654,right,C3,712,-7,12,13,-1
720575940625656300,right,C3,713,-6,16,14,2
720575940630904261,right,C3,714,5,12,1,11
720575940621814789,right,C3,715,4,10,1,9
720575940620411307,right,C3,716,4,-6,-7,1
720575940605796542,right,C3,717,2,-22,-13,-9
720575940654774689,right,C3,718,-5,24,17,7
720575940632737347,right,C3,719,1,27,12,15
720575940611944402,right,C3,720,-5,21,15,6
720575940620102772,right,C3,721,5,13,1,12
720575940638219497,right,C3,722,6,-15,-14,-1
720575940629769669,right,C3,723,-2,-11,-4,-7
720575940638138846,right,C3,724,4,2,-3,5
720575940635249052,right,C3,725,-3,-24,-9,-15
720575940615666399,right,C3,726,2,-28,-16,-12
720575940633423897,right,C3,727,7,6,-4,10
720575940616540043,right,C3,728,7,12,-1,13
720575940621887112,right,C3,729,-3,29,17,12
720575940641302736,right,C3,730,7,0,-7,7
720575940635164852,right,C3,731,-6,9,10,-1
720575940622202077,right,C3,732,-3,6,6,0
720575940633160495,right,C3,733,-5,-17,-4,-13
720575940632901191,right,C3,734,2,0,-2,2
720575940629286218,right,C3,735,1,-23,-13,-10
720575940606650754,right,C3,736,-8,1,8,-7
720575940605998257,right,C3,737,0,19,9,10
720575940629803458,right,C3,738,-3,13,9,4
720575940635867248,right,C3,739,-7,2,8,-6
720575940628813060,right,C3,740,2,-8,-6,-2
720575940615482434,right,C3,741,-2,-14,-5,-9
720575940614930794,right,C3,742,-4,11,9,2
720575940621244848,right,C3,743,6,-19,-16,-3
720575940655983777,right,C3,744,-4,25,16,9
720575940637751017,right,C3,745,0,13,6,7
720575940614844566,right,C3,746,-3,3,4,-1
720575940628215963,right,C3,747,0,2,1,1
720575940614321123,right,C3,748,-4,20,14,6
720575940608410307,right,C3,749,-2,1,2,-1
720575940621656230,right,C3,750,4,-24,-16,-8
720575940629320704,right,C3,751,1,6,2,4
720575940616162626,right,C3,752,-2,7,5,2
720575940608412508,right,C3,753,-3,24,15,9
720575940632046509,right,C3,754,-1,-13,-6,-7
720575940621106961,right,C3,755,4,19,5,14
720575940618203348,right,C3,756,5,20,5,15
720575940640615485,right,C3,757,0,-6,-3,-3
720575940638989658,right,C3,758,5,-1,-6,5
720575940625914686,right,C3,759,7,14,0,14
720575940627074332,right,C3,760,0,17,8,9
720575940633845037,right,C3,761,-4,-18,-5,-13
720575940610718328,right,C3,762,0,14,7,7
720575940641459419,right,C3,763,-5,14,12,2
720575940612461977,right,C3,764,-8,-6,5,-11
720575940623073833,right,C3,765,-3,9,7,2
720575940616478806,right,C3,766,2,-4,-4,0
720575940638430185,right,C3,767,1,28,13,15
720575940620482753,right,C3,768,3,5,-1,6
720575940629528592,right,C3,769,4,-27,-18,-9
720575940646381678,right,C3,770,5,4,-3,7
720575940622773929,right,C3,771,3,-27,-17,-10
720575940616054175,right,C3,772,1,12,5,7
720575940624326071,right,C3,773,5,-19,-15,-4
720575940626280573,right,C3,774,-8,6,11,-5
720575940628629191,right,C3,775,5,22,6,16
720575940631342167,right,C3,776,5,21,5,16
720575940605592608,right,C3,777,6,20,4,16
720575940624639159,right,C3,778,4,25,8,17
720575940645631511,right,C3,779,5,24,7,17
720575940626542142,right,C3,780,-6,25,18,7
720575940622794623,right,C3,781,-5,26,18,8
720575940608739523,right,C3,783,-4,28,18,10
720575940635330661,right,C3,784,-4,29,18,11
720575940628642216,right,C3,785,-3,30,18,12
720575940623108521,right,C3,787,3,28,11,17
720575940626641098,right,C3,788,3,27,10,17
720575940630708094,right,C3,790,-2,-27,-12,-15
720575940627339346,right,C3,792,8,2,-7,9
720575940623612125,right,C3,794,5,-26,-18,-8
720575940639191229,right,C3,795,6,-21,-17,-4
720575940620921424,right,C3,796,4,26,9,17
720575940636561838,right,L1,1,-6,13,12,1
720575940629723006,right,L1,2,-8,2,9,-7
720575940621153702,right,L1,3,6,-12,-12,0
720575940607560370,right,L1,4,-5,-21,-6,-15
720575940628893937,right,L1,5,-1,16,9,7
720575940618854228,right,L1,6,-2,-4,0,-4
720575940632654440,right,L1,7,-6,-6,3,-9
720575940620875741,right,L1,8,-4,26,17,9
720575940622451197,right,L1,9,4,9,0,9
720575940623092044,right,L1,10,5,-15,-13,-2
720575940619416113,right,L1,11,7,-14,-14,0
720575940627241747,right,L1,12,-7,9,11,-2
720575940628018565,right,L1,13,-1,-26,-12,-14
720575940640408435,right,L1,14,0,-27,-14,-13
720575940631787577,right,L1,15,2,-3,-4,1
720575940620354008,right,L1,16,-2,-16,-6,-10
720575940641512656,right,L1,17,1,-5,-4,-1
720575940622808745,right,L1,18,5,-16,-13,-3
720575940622892056,right,L1,19,-7,17,15,2
720575940614504342,right,L1,20,3,-11,-9,-2
720575940631839140,right,L1,21,-2,19,11,8
720575940617734976,right,L1,22,-1,3,2,1
720575940618608029,right,L1,23,-3,-16,-5,-11
720575940613506582,right,L1,24,-1,-10,-4,-6
720575940628400149,right,L1,25,-9,3,10,-7
720575940609591817,right,L1,26,1,-3,-3,0
720575940618867796,right,L1,27,0,-25,-13,-12
720575940636112747,right,L1,28,5,6,-2,8
720575940636892590,right,L1,29,-1,-3,-1,-2
720575940618322617,right,L1,30,6,16,2,14
720575940618427015,right,L1,31,0,16,8,8
720575940641517008,right,L1,32,0,12,6,6
720575940626709029,right,L1,33,3,18,6,12
720575940608177330,right,L1,34,6,18,3,15
720575940612019150,right,L1,35,1,-24,-13,-11
720575940613632114,right,L1,36,6,8,-2,10
720575940631433167,right,L1,37,1,5,1,4
720575940630784055,right,L1,38,0,-2,-1,-1
720575940626150448,right,L1,39,0,20,10,10
720575940634193815,right,L1,40,-2,-6,-1,-5
720575940633518381,right,L1,41,-3,28,17,11
720575940630498942,right,L1,42,-1,14,8,6
720575940622269445,right,L1,43,-5,18,14,4
720575940627686942,right,L1,44,5,-10,-10,0
720575940621905729,right,L1,45,-5,-1,4,-5
720575940606631014,right,L1,46,-5,15,12,3
720575940623394440,right,L1,47,-9,-1,8,-9
720575940628630248,right,L1,48,-4,-22,-7,-15
720575940624102397,right,L1,49,4,-4,-6,2
720575940623993783,right,L1,50,-2,21,12,9
720575940625623795,right,L1,51,0,-19,-10,-9
720575940613513330,right,L1,52,-1,-22,-10,-12
720575940606524802,right,L1,53,5,14,2,12
720575940642512603,right,L1,54,-4,3,5,-2
720575940631022807,right,L1,55,-4,-11,-2,-9
720575940624183690,right,L1,56,1,-13,-8,-5
720575940638525150,right,L1,57,6,-11,-12,1
720575940613377945,right,L1,58,3,12,3,9
720575940639115608,right,L1,59,-2,2,3,-1
720575940607194546,right,L1,60,-8,8,12,-4
720575940616616053,right,L1,61,-4,-4,2,-6
720575940612647025,right,L1,62,0,-29,-15,-14
720575940624617450,right,L1,63,4,12,2,10
720575940605541822,right,L1,64,4,-23,-16,-7
720575940621610587,right,L1,65,-1,28,15,13
720575940624372263,right,L1,66,2,15,5,10
720575940624616486,right,L1,67,-2,-13,-5,-8
720575940617855537,right,L1,68,3,16,5,11
720575940631735121,right,L1,69,1,8,3,5
720575940626661168,right,L1,70,-4,21,14,7
720575940623537043,right,L1,71,-2,-3,0,-3
720575940628279183,right,L1,72,0,-28,-14,-14
720575940632680100,right,L1,73,2,2,-1,3
720575940621563072,right,L1,74,-1,-9,-4,-5
720575940640153216,right,L1,75,-6,14,13,1
720575940617225118,right,L1,76,-3,-4,1,-5
720575940616241339,right,L1,77,2,-5,-5,0
720575940635607220,right,L1,78,2,20,8,12
720575940636482734,right,L1,79,2,1,-2,3
720575940616665915,right,L1,80,4,13,2,11
720575940636027290,right,L1,81,6,-2,-7,5
720575940628037257,right,L1,82,-7,7,10,-3
720575940622609669,right,L1,83,2,-21,-13,-8
720575940627819338,right,L1,84,-2,12,8,4
720575940628453448,right,L1,85,4,-22,-15,-7
720575940620399740,right,L1,86,-5,-7,1,-8
720575940624825271,right,L1,87,1,11,4,7
720575940638737085,right,L1,88,7,4,-5,9
720575940633136209,right,L1,89,1,-19,-11,-8
720575940647118883,right,L1,90,-4,5,6,-1
720575940629649411,right,L1,91,-1,6,4,2
720575940612777434,right,L1,92,0,9,4,5
720575940639339709,right,L1,93,-6,3,7,-4
720575940631757624,right,L1,94,5,18,4,14
720575940613504882,right,L1,95,4,-21,-15,-6
720575940633441996,right,L1,96,1,-10,-6,-4
720575940632281359,right,L1,97,-5,2,6,-4
720575940626691984,right,L1,98,-1,-12,-5,-7
720575940629507279,right,L1,99,4,15,3,12
720575940636006751,right,L1,100,2,-10,-7,-3
720575940633568924,right,L1,101,-7,6,10,-4
720575940616323999,right,L1,102,3,13,3,10
720575940623075610,right,L1,103,7,9,-3,12
720575940628316945,right,L1,104,-1,-27,-13,-14
720575940660156545,right,L1,105,3,22,8,14
720575940630610302,right,L1,106,-7,11,12,-1
720575940615432866,right,L1,107,8,-2,-9,7
720575940624391914,right,L1,108,-3,-12,-3,-9
720575940627143098,right,L1,109,4,-5,-7,2
720575940629500521,right,L1,110,-7,0,7,-7
720575940631298809,right,L1,111,2,-24,-14,-10
720575940628769768,right,L1,112,-6,1,6,-5
720575940626919882,right,L1,113,-2,4,4,0
720575940624792051,right,L1,114,2,-13,-9,-4
720575940605621862,right,L1,115,-4,2,5,-3
720575940608226261,right,L1,116,-1,-8,-3,-5
720575940629972076,right,L1,117,-8,-2,7,-9
720575940614971944,right,L1,118,3,1,-3,4
720575940627505241,right,L1,119,-2,6,5,1
720575940632304146,right,L1,120,-1,-1,0,-1
720575940605774014,right,L1,121,-8,4,10,-6
720575940631894815,right,L1,122,-5,9,9,0
720575940643577198,right,L1,123,-8,10,13,-3
720575940638456798,right,L1,124,1,-7,-5,-2
720575940640687861,right,L1,125,5,9,-1,10
720575940637938409,right,L1,126,3,11,2,9
720575940614123491,right,L1,127,0,15,7,8
720575940628311098,right,L1,128,3,-22,-14,-8
720575940636107615,right,L1,129,0,-13,-7,-6
720575940620457813,right,L1,130,2,12,4,8
720575940619890512,right,L1,131,-6,20,16,4
720575940608181515,right,L1,132,2,4,0,4
720575940632260623,right,L1,133,-3,20,13,7
720575940627998739,right,L1,134,-5,-18,-4,-14
720575940604747953,right,L1,135,-3,-22,-8,-14
720575940621343252,right,L1,136,0,3,1,2
720575940621766566,right,L1,137,5,-7,-9,2
720575940627743400,right,L1,138,0,27,13,14
720575940646305827,right,L1,139,1,-14,-8,-6
720575940608144050,right,L1,140,3,8,1,7
720575940632455272,right,L1,141,5,-23,-17,-6
720575940618379554,right,L1,142,-2,-18,-7,-11
720575940635803802,right,L1,143,-4,16,12,4
720575940629755774,right,L1,144,7,-11,-13,2
720575940606253489,right,L1,145,0,4,2,2
720575940625652272,right,L1,146,1,-6,-4,-2
720575940609729035,right,L1,147,1,21,9,12
720575940630540023,right,L1,148,-7,-11,1,-12
720575940634827671,right,L1,149,6,-14,-13,-1
720575940622266025,right,L1,150,-8,5,10,-5
720575940622564869,right,L1,151,-3,-14,-4,-10
720575940629531639,right,L1,152,3,-15,-11,-4
720575940653597174,right,L1,153,8,0,-8,8
720575940619592102,right,L1,154,-8,0,8,-8
720575940637450974,right,L1,155,-8,13,14,-1
720575940620647407,right,L1,156,-9,1,9,-8
720575940634252700,right,L1,157,-1,-7,-3,-4
720575940626993338,right,L1,158,3,-5,-6,1
720575940612733667,right,L1,159,7,7,-4,11
720575940642334965,right,L1,160,-2,20,12,8
720575940631796175,right,L1,161,4,-14,-11,-3
720575940635696120,right,L1,162,-4,-2,3,-5
720575940613580269,right,L1,163,-9,7,12,-5
720575940612646642,right,L1,164,-1,-2,0,-2
720575940628519665,right,L1,165,4,16,4,12
720575940632696889,right,L1,166,0,18,9,9
720575940624931768,right,L1,167,0,-17,-9,-8
720575940612349363,right,L1,168,-1,17,9,8
720575940621052069,right,L1,169,0,-18,-9,-9
720575940632659364,right,L1,170,-5,1,5,-4
720575940631211382,right,L1,171,6,-20,-16,-4
720575940626353916,right,L1,172,1,22,10,12
720575940632452456,right,L1,173,2,-25,-15,-10
720575940637260389,right,L1,174,4,-15,-12,-3
720575940624334532,right,L1,176,-2,13,8,5
720575940606406530,right,L1,177,-2,-1,1,-2
720575940621010196,right,L1,178,2,11,3,8
720575940624002601,right,L1,179,-5,-16,-3,-13
720575940640299325,right,L1,180,2,-27,-16,-11
720575940630042679,right,L1,181,1,-4,-3,-1
720575940624869117,right,L1,182,7,-10,-12,2
720575940635639743,right,L1,183,-5,-15,-3,-12
720575940630422466,right,L1,184,-6,-5,3,-8
720575940625043856,right,L1,185,2,-11,-8,-3
720575940629703015,right,L1,186,-1,26,14,12
720575940629998071,right,L1,187,3,21,7,14
720575940602857696,right,L1,188,-5,17,13,4
720575940614549394,right,L1,189,6,13,0,13
720575940621690236,right,L1,190,-3,-5,0,-5
720575940636656997,right,L1,191,-1,-11,-5,-6
720575940631156781,right,L1,192,7,10,-2,12
720575940612654771,right,L1,193,-5,4,7,-3
720575940611508686,right,L1,194,0,-5,-3,-2
720575940614775954,right,L1,195,-3,-1,2,-3
720575940622638106,right,L1,196,-1,8,5,3
720575940628594664,right,L1,197,0,-20,-10,-10
720575940611758741,right,L1,198,6,2,-5,7
720575940638398278,right,L1,199,0,-12,-6,-6
720575940624885687,right,L1,200,-5,12,11,1
720575940620316632,right,L1,201,-8,9,12,-3
720575940642630619,right,L1,202,-1,27,14,13
720575940627026705,right,L1,203,3,-1,-4,3
720575940616324767,right,L1,204,5,-2,-6,4
720575940625161230,right,L1,205,5,-6,-8,2
720575940609746187,right,L1,206,-3,5,5,0
720575940632408847,right,L1,207,1,29,13,16
720575940613506162,right,L1,208,5,-21,-16,-5
720575940654966945,right,L1,209,-3,-8,-1,-7
720575940629888043,right,L1,210,-6,8,10,-2
720575940620346840,right,L1,211,-7,-1,6,-7
720575940631840824,right,L1,212,2,-16,-10,-6
720575940638004457,right,L1,213,3,-4,-5,1
720575940618408166,right,L1,214,-5,3,6,-3
720575940624416403,right,L1,215,6,7,-3,10
720575940618704182,right,L1,216,2,19,7,12
720575940615650271,right,L1,217,6,15,1,14
720575940628171407,right,L1,218,2,10,3,7
720575940640405667,right,L1,219,6,-4,-8,4
720575940618463813,right,L1,220,2,-6,-5,-1
720575940629995308,right,L1,221,-7,3,8,-5
720575940613894883,right,L1,222,-3,26,16,10
720575940633026980,right,L1,223,-2,26,15,11
720575940621193456,right,L1,224,0,5,2,3
720575940611660498,right,L1,225,2,-26,-15,-11
720575940612595349,right,L1,226,5,19,4,15
720575940640609187,right,L1,227,-7,5,9,-4
720575940615853206,right,L1,228,-7,1,7,-6
720575940628279610,right,L1,229,5,2,-4,6
720575940626470146,right,L1,230,2,9,2,7
720575940605032364,right,L1,231,4,-12,-10,-2
720575940638818623,right,L1,232,-4,13,10,3
720575940626820964,right,L1,233,4,-13,-11,-2
720575940644925038,right,L1,234,1,3,0,3
720575940622489727,right,L1,235,4,11,1,10
720575940619341447,right,L1,236,-1,4,3,1
720575940615370407,right,L1,237,-2,27,15,12
720575940639113405,right,L1,238,-8,-3,6,-9
720575940627633384,right,L1,239,-6,6,9,-3
720575940619149982,right,L1,240,-4,-3,2,-5
720575940613906147,right,L1,241,2,-17,-11,-6
720575940610106692,right,L1,242,-4,6,7,-1
720575940613515798,right,L1,243,-1,-21,-10,-11
720575940611749233,right,L1,244,-4,-12,-2,-10
720575940645458542,right,L1,245,-5,-3,3,-6
720575940627311491,right,L1,246,-4,15,11,4
720575940631279119,right,L1,247,-4,-15,-4,-11
720575940614875176,right,L1,248,-6,0,6,-6
720575940616853772,right,L1,249,2,-12,-8,-4
720575940623532426,right,L1,250,-1,1,1,0
720575940607807177,right,L1,251,-1,-14,-6,-8
720575940623435533,right,L1,252,3,23,8,15
720575940624217323,right,L1,253,5,16,3,13
720575940628410792,right,L1,254,3,-24,-15,-9
720575940610731076,right,L1,255,-6,-13,-1,-12
720575940628593384,right,L1,256,5,-20,-15,-5
720575940622106534,right,L1,257,2,21,8,13
720575940627731837,right,L1,258,-4,-17,-5,-12
720575940620402853,right,L1,259,-7,-5,4,-9
720575940620827156,right,L1,260,-3,19,12,7
720575940640038333,right,L1,261,-1,13,7,6
720575940632187407,right,L1,262,1,-11,-7,-4
720575940626974297,right,L1,263,-3,4,5,-1
720575940615385403,right,L1,264,-1,-6,-2,-4
720575940628148873,right,L1,265,-6,-1,5,-6
720575940621546688,right,L1,266,-1,-25,-12,-13
720575940620103509,right,L1,267,-6,2,7,-5
720575940623664664,right,L1,268,7,-6,-10,4
720575940628594408,right,L1,269,2,-19,-12,-7
720575940626733699,right,L1,270,1,-8,-5,-3
720575940623449368,right,L1,271,4,6,-1,7
720575940620811758,right,L1,272,3,-2,-4,2
720575940629871319,right,L1,273,-6,23,17,6
720575940625258219,right,L1,275,-8,-1,7,-8
720575940624160196,right,L1,276,2,3,-1,4
720575940620598181,right,L1,277,7,-3,-9,6
720575940610684586,right,L1,278,-5,10,10,0
720575940618753088,right,L1,279,-4,8,8,0
720575940630539511,right,L1,280,-6,-14,-1,-13
720575940628703720,right,L1,281,-9,2,10,-8
720575940635493999,right,L1,282,0,26,13,13
720575940638053744,right,L1,283,-4,4,6,-2
720575940624677012,right,L1,284,0,25,12,13
720575940623910919,right,L1,285,6,-18,-15,-3
720575940640400243,right,L1,286,0,-24,-12,-12
720575940627601753,right,L1,287,-5,13,11,2
720575940622870004,right,L1,288,-1,30,16,14
720575940631730402,right,L1,289,-1,11,6,5
720575940614937494,right,L1,290,5,-24,-17,-7
720575940621145716,right,L1,291,7,2,-6,8
720575940608063106,right,L1,292,-4,18,13,5
720575940638054000,right,L1,293,4,-17,-13,-4
720575940628936747,right,L1,294,1,-20,-11,-9
720575940642385397,right,L1,295,-2,29,16,13
720575940613905891,right,L1,296,1,-18,-10,-8
720575940618338961,right,L1,297,7,-9,-12,3
720575940617537117,right,L1,298,-5,5,7,-2
720575940642565851,right,L1,299,-4,12,10,2
720575940633252812,right,L1,300,4,-18,-13,-5
720575940608164994,right,L1,301,-5,16,13,3
720575940629278726,right,L1,302,2,17,6,11
720575940621765876,right,L1,303,-5,22,16,6
720575940632414226,right,L1,304,6,5,-4,9
720575940636805733,right,L1,305,-7,4,9,-5
720575940631268140,right,L1,306,3,7,0,7
720575940647577140,right,L1,307,5,-25,-18,-7
720575940617012678,right,L1,308,-5,8,9,-1
720575940634104019,right,L1,309,-6,12,12,0
720575940628855595,right,L1,310,2,22,9,13
720575940612306382,right,L1,311,-7,15,14,1
720575940630702585,right,L1,312,4,-7,-8,1
720575940622404212,right,L1,313,7,3,-6,9
720575940643788960,right,L1,314,-9,5,11,-6
720575940622513481,right,L1,315,-3,-6,0,-6
720575940621340080,right,L1,316,5,-4,-7,3
720575940612277454,right,L1,317,-5,-4,3,-7
720575940632457320,right,L1,318,4,-19,-14,-5
720575940607674754,right,L1,319,-2,5,4,1
720575940639337781,right,L1,320,-2,-5,-1,-4
720575940618442726,right,L1,321,8,4,-6,10
720575940632521064,right,L1,322,2,26,11,15
720575940621234859,right,L1,323,-7,-13,0,-13
720575940625550996,right,L1,324,3,24,9,15
720575940626683834,right,L1,325,5,1,-5,6
720575940612867045,right,L1,326,2,16,6,10
720575940628679400,right,L1,327,5,3,-4,7
720575940625023475,right,L1,328,5,-9,-10,1
720575940614077491,right,L1,329,0,24,12,12
720575940615205087,right,L1,330,3,3,-2,5
720575940631307769,right,L1,331,1,-15,-9,-6
720575940617263221,right,L1,332,4,-26,-17,-9
720575940633663917,right,L1,333,0,-21,-11,-10
720575940640403827,right,L1,334,1,-26,-14,-12
720575940634490594,right,L1,335,2,8,2,6
720575940613877151,right,L1,336,0,23,11,12
720575940629867599,right,L1,337,-5,-6,2,-8
720575940635249775,right,L1,338,-1,0,1,-1
720575940612661683,right,L1,339,6,11,-1,12
720575940631086636,right,L1,340,-4,17,12,5
720575940637157232,right,L1,341,6,-17,-15,-2
720575940628099154,right,L1,342,2,-15,-10,-5
720575940623488477,right,L1,343,-3,27,16,11
720575940622986279,right,L1,344,-2,-15,-6,-9
720575940627856200,right,L1,345,3,-12,-9,-3
720575940614750102,right,L1,346,-7,-9,2,-11
720575940637518510,right,L1,347,-5,-13,-2,-11
720575940637549486,right,L1,348,3,14,4,10
720575940609405963,right,L1,349,-5,-14,-2,-12
720575940641623515,right,L1,350,1,15,6,9
720575940647580468,right,L1,351,-1,-17,-8,-9
720575940633870125,right,L1,352,-2,28,16,12
720575940625803620,right,L1,353,2,24,10,14
720575940628558084,right,L1,354,-2,-26,-11,-15
720575940632667987,right,L1,355,-7,-6,4,-10
720575940606798537,right,L1,356,0,22,11,11
720575940622342689,right,L1,357,4,17,4,13
720575940622788702,right,L1,358,-3,17,11,6
720575940623631850,right,L1,359,2,23,9,14
720575940612877937,right,L1,360,-5,19,14,5
720575940611508942,right,L1,361,0,-7,-4,-3
720575940613513842,right,L1,362,2,-20,-12,-8
720575940608522761,right,L1,363,7,-4,-9,5
720575940624948553,right,L1,364,4,4,-2,6
720575940619692965,right,L1,365,4,7,-1,8
720575940626925754,right,L1,366,-5,-20,-5,-15
720575940632084239,right,L1,367,-6,-15,-2,-13
720575940641361360,right,L1,368,-4,-20,-6,-14
720575940625696270,right,L1,369,5,-5,-8,3
720575940606552422,right,L1,370,-3,21,13,8
720575940636273520,right,L1,371,6,-5,-9,4
720575940618596731,right,L1,372,1,-2,-2,0
720575940628430248,right,L1,373,1,-21,-12,-9
720575940624703792,right,L1,374,2,13,4,9
720575940636928631,right,L1,375,-6,7,9,-2
720575940605747902,right,L1,376,-7,-10,2,-12
720575940623688653,right,L1,377,0,7,3,4
720575940637773486,right,L1,378,-3,18,12,6
720575940625058568,right,L1,379,3,-17,-12,-5
720575940632362809,right,L1,380,-1,29,15,14
720575940658842497,right,L1,381,-8,-9,3,-12
720575940627309394,right,L1,382,3,-6,-6,0
720575940628546759,right,L1,383,-6,11,11,0
720575940631269963,right,L1,384,-6,-2,5,-7
720575940612526997,right,L1,385,-3,-18,-6,-12
720575940639636046,right,L1,386,-6,19,15,4
720575940618992798,right,L1,387,-1,-15,-7,-8
720575940630959704,right,L1,388,3,19,6,13
720575940656058785,right,L1,389,-6,-16,-2,-14
720575940622437885,right,L1,390,-6,-9,1,-10
720575940627197194,right,L1,391,4,-3,-6,3
720575940625798332,right,L1,392,-4,7,7,0
720575940620007919,right,L1,393,-1,22,12,10
720575940630591084,right,L1,394,-7,-8,3,-11
720575940631201142,right,L1,395,0,-22,-11,-11
720575940623578260,right,L1,396,-1,10,6,4
720575940614765487,right,L1,397,-3,-19,-7,-12
720575940625339261,right,L1,398,-3,22,14,8
720575940611796690,right,L1,399,-4,-24,-8,-16
720575940628302735,right,L1,400,1,-29,-16,-13
720575940648239492,right,L1,401,-2,-19,-8,-11
720575940630726108,right,L1,402,3,26,10,16
720575940618044116,right,L1,403,-2,-12,-4,-8
720575940632003640,right,L1,404,-1,20,11,9
720575940634176668,right,L1,405,3,10,2,8
720575940626651338,right,L1,406,1,-25,-14,-11
720575940628680977,right,L1,407,-5,-10,0,-10
720575940620206983,right,L1,408,-6,-4,4,-8
720575940623907533,right,L1,409,0,-3,-2,-1
720575940629153623,right,L1,410,-2,-2,1,-3
720575940631553111,right,L1,411,-5,-19,-5,-14
720575940621692251,right,L1,412,-6,21,16,5
720575940632699715,right,L1,413,-2,-7,-2,-5
720575940620344280,right,L1,414,4,21,6,15
720575940628691655,right,L1,415,6,12,0,12
720575940606273056,right,L1,416,3,-8,-7,-1
720575940633914579,right,L1,417,-6,-10,1,-11
720575940627203843,right,L1,418,-2,15,9,6
720575940637666734,right,L1,419,-3,-11,-3,-8
720575940622705946,right,L1,420,6,-3,-8,5
720575940641654480,right,L1,421,-1,12,7,5
720575940630186907,right,L1,422,-7,-4,5,-9
720575940632060946,right,L1,423,3,-18,-12,-6
720575940624815847,right,L1,424,-3,-2,2,-4
720575940620772369,right,L1,425,3,20,7,13
720575940616116330,right,L1,426,-3,0,3,-3
720575940620320472,right,L1,427,5,-18,-14,-4
720575940615389034,right,L1,428,-2,23,13,10
720575940620711115,right,L1,429,-2,14,9,5
720575940629790506,right,L1,430,-3,-7,-1,-6
720575940630314839,right,L1,431,-2,-10,-3,-7
720575940621391297,right,L1,432,-5,7,8,-1
720575940625293901,right,L1,433,0,-8,-4,-4
720575940610206403,right,L1,434,-3,7,6,1
720575940628859408,right,L1,435,5,-17,-14,-3
720575940619070366,right,L1,436,0,-15,-8,-7
720575940614592175,right,L1,437,-3,12,9,3
720575940635862264,right,L1,438,2,27,11,16
720575940630243626,right,L1,439,-3,-9,-2,-7
720575940605633714,right,L1,440,1,23,10,13
720575940649784185,right,L1,441,3,-16,-11,-5
720575940661120385,right,L1,442,-5,25,17,8
720575940627322122,right,L1,443,-6,4,8,-4
720575940618460229,right,L1,444,4,-10,-9,-1
720575940615226770,right,L1,445,-2,8,6,2
720575940624004095,right,L1,446,2,-14,-9,-5
720575940622892947,right,L1,447,-1,2,2,0
720575940626932682,right,L1,448,0,30,15,15
720575940615257767,right,L1,449,6,-16,-14,-2
720575940623349128,right,L1,450,2,-9,-7,-2
720575940611088482,right,L1,451,4,20,6,14
720575940622760584,right,L1,452,1,-9,-6,-3
720575940620343256,right,L1,453,3,25,9,16
720575940623555780,right,L1,454,5,-12,-11,-1
720575940629775863,right,L1,455,7,-7,-11,4
720575940638254825,right,L1,456,0,21,10,11
720575940614574511,right,L1,457,-2,17,10,7
720575940624101117,right,L1,458,5,0,-5,5
720575940610632494,right,L1,459,5,-3,-7,4
720575940605948332,right,L1,460,-3,-20,-7,-13
720575940629995087,right,L1,461,7,-5,-10,5
720575940639579206,right,L1,462,-1,18,10,8
720575940621003611,right,L1,463,5,17,3,14
720575940622351228,right,L1,464,4,0,-4,4
720575940622762120,right,L1,465,3,0,-3,3
720575940634797724,right,L1,466,1,14,6,8
720575940631007488,right,L1,467,-2,-20,-8,-12
720575940634199778,right,L1,468,-3,11,8,3
720575940620548289,right,L1,470,4,-9,-9,0
720575940632054546,right,L1,471,3,-26,-16,-10
720575940624244818,right,L1,472,1,25,11,14
720575940643811488,right,L1,473,-4,23,15,8
720575940640218446,right,L1,474,-3,-17,-6,-11
720575940613532133,right,L1,475,-4,-1,3,-4
720575940629039100,right,L1,476,-1,15,8,7
720575940607755721,right,L1,477,-3,2,4,-2
720575940633013807,right,L1,478,-7,16,15,1
720575940623606040,right,L1,479,-2,10,7,3
720575940612680817,right,L1,480,3,-19,-13,-6
720575940621449893,right,L1,481,4,-8,-8,0
720575940614527725,right,L1,482,1,17,7,10
720575940632976159,right,L1,483,2,-7,-6,-1
720575940638806854,right,L1,484,3,-9,-8,-1
720575940639453774,right,L1,485,-3,-3,1,-4
720575940625585812,right,L1,486,0,1,0,1
720575940617112321,right,L1,487,1,-1,-2,1
720575940613435363,right,L1,488,7,5,-5,10
720575940636361140,right,L1,489,-3,10,8,2
720575940652575222,right,L1,490,-5,6,8,-2
720575940640144768,right,L1,491,7,-1,-8,7
720575940632928593,right,L1,492,-7,-2,6,-8
720575940627633412,right,L1,493,-3,23,14,9
720575940632771757,right,L1,494,0,29,14,15
720575940619056413,right,L1,495,4,5,-2,7
720575940610656046,right,L1,496,7,8,-3,11
720575940614959144,right,L1,497,6,1,-6,7
720575940637639908,right,L1,498,6,10,-1,11
720575940622641321,right,L1,499,5,10,0,10
720575940630820879,right,L1,500,7,-8,-11,3
720575940636086414,right,L1,501,1,2,0,2
720575940613662834,right,L1,502,5,8,-1,9
720575940627423251,right,L1,503,3,17,5,12
720575940621288216,right,L1,504,-2,9,6,3
720575940626652874,right,L1,505,6,-22,-17,-5
720575940630710009,right,L1,506,1,-12,-7,-5
720575940635639999,right,L1,507,-5,-12,-1,-11
720575940618896197,right,L1,508,-5,11,10,1
720575940625933901,right,L1,509,-4,10,9,1
720575940619699183,right,L1,510,-2,11,7,4
720575940614027951,right,L1,511,5,-11,-11,0
720575940616355670,right,L1,512,6,0,-6,6
720575940634850495,right,L1,513,-4,-13,-3,-10
720575940620141317,right,L1,514,-4,-10,-1,-9
720575940636727726,right,L1,515,-8,-7,4,-11
720575940624026762,right,L1,517,6,3,-5,8
720575940619833723,right,L1,518,-4,22,15,7
720575940624826343,right,L1,519,-5,-5,2,-7
720575940625376660,right,L1,520,-2,-22,-9,-13
720575940614371490,right,L1,521,6,-9,-11,2
720575940618737748,right,L1,522,-4,0,4,-4
720575940633452575,right,L1,523,2,14,5,9
720575940628586728,right,L1,524,4,-20,-14,-6
720575940640411507,right,L1,525,-1,-20,-9,-11
720575940622242684,right,L1,526,0,-10,-5,-5
720575940627648019,right,L1,527,-4,-8,0,-8
720575940618843702,right,L1,528,2,7,1,6
720575940622837272,right,L1,529,2,-2,-3,1
720575940623313080,right,L1,530,-3,-13,-4,-9
720575940630747452,right,L1,531,1,0,-1,1
720575940631300664,right,L1,532,-8,7,11,-4
720575940635819199,right,L1,533,0,-16,-8,-8
720575940627775253,right,L1,534,3,2,-2,4
720575940621217601,right,L1,535,8,-4,-10,6
720575940618573888,right,L1,536,3,4,-1,5
720575940637533870,right,L1,537,0,-23,-12,-11
720575940636117359,right,L1,538,-4,1,4,-3
720575940627126458,right,L1,539,-6,15,13,2
720575940627402633,right,L1,540,-2,-9,-3,-6
720575940634203603,right,L1,541,-4,14,11,3
720575940630706681,right,L1,542,6,-13,-13,0
720575940623699946,right,L1,543,-1,-4,-1,-3
720575940610982242,right,L1,544,3,-13,-10,-3
720575940624133424,right,L1,545,5,11,0,11
720575940624414472,right,L1,546,3,6,0,6
720575940634332697,right,L1,547,-1,21,11,10
720575940620513158,right,L1,548,1,-16,-9,-7
720575940611509198,right,L1,549,0,-9,-5,-4
720575940641671888,right,L1,550,-2,3,3,0
720575940622446227,right,L1,551,-4,-9,-1,-8
720575940625968016,right,L1,552,4,-1,-5,4
720575940633296804,right,L1,553,-3,16,11,5
720575940631339535,right,L1,554,-9,-3,7,-10
720575940631261911,right,L1,555,-4,9,8,1
720575940623061735,right,L1,556,0,10,5,5
720575940633771684,right,L1,557,6,-10,-11,1
720575940625807859,right,L1,558,-4,-21,-7,-14
720575940639427699,right,L1,559,-6,22,17,5
720575940638574662,right,L1,560,-7,14,14,0
720575940627838024,right,L1,562,-5,-2,4,-6
720575940630785730,right,L1,563,5,-13,-12,-1
720575940634924444,right,L1,564,3,-23,-15,-8
720575940648243076,right,L1,565,0,-26,-13,-13
720575940623441449,right,L1,566,5,-8,-9,1
720575940626967448,right,L1,567,-2,22,13,9
720575940625750320,right,L1,568,-6,-8,2,-10
720575940639828339,right,L1,569,6,6,-3,9
720575940613977325,right,L1,570,2,25,10,15
720575940624391146,right,L1,571,0,-14,-7,-7
720575940630089115,right,L1,572,-8,3,9,-6
720575940638067782,right,L1,573,4,14,3,11
720575940623137868,right,L1,574,-6,5,8,-3
720575940627084132,right,L1,575,6,9,-2,11
720575940618679579,right,L1,576,0,28,14,14
720575940621304001,right,L1,577,5,-14,-12,-2
720575940623304230,right,L1,578,4,-11,-10,-1
720575940627095378,right,L1,579,-3,-10,-2,-8
720575940648243588,right,L1,580,-2,-23,-10,-13
720575940623570141,right,L1,581,3,9,1,8
720575940618200788,right,L1,582,-1,23,12,11
720575940612637809,right,L1,583,3,-25,-16,-9
720575940628480840,right,L1,584,4,23,7,16
720575940617262453,right,L1,585,-1,-23,-11,-12
720575940613927139,right,L1,586,2,18,7,11
720575940628229509,right,L1,587,4,22,7,15
720575940623364988,right,L1,588,1,4,1,3
720575940631019607,right,L1,589,-1,-5,-2,-3
720575940626833957,right,L1,590,1,9,3,6
720575940628686864,right,L1,591,3,-3,-5,2
720575940626814782,right,L1,592,3,-28,-17,-11
720575940636991918,right,L1,593,3,-14,-10,-4
720575940630712190,right,L1,594,7,-16,-15,-1
720575940631565817,right,L1,595,7,-12,-13,1
720575940620350680,right,L1,596,-4,-16,-4,-12
720575940626922302,right,L1,597,4,1,-4,5
720575940613516054,right,L1,598,2,-18,-11,-7
720575940623606296,right,L1,599,-1,9,5,4
720575940627107605,right,L1,600,3,-10,-8,-2
720575940616225247,right,L1,601,1,16,7,9
720575940638767423,right,L1,602,4,-2,-5,3
720575940627533854,right,L1,603,-3,-23,-9,-14
720575940628118440,right,L1,604,-6,-17,-3,-14
720575940637490266,right,L1,605,3,15,4,11
720575940648240260,right,L1,606,-1,-19,-9,-10
720575940628885547,right,L1,607,1,18,8,10
720575940635645279,right,L1,608,1,10,4,6
720575940625330931,right,L1,609,-2,0,2,-2
720575940628582888,right,L1,610,2,-23,-14,-9
720575940610081987,right,L1,611,-1,-18,-8,-10
720575940640420771,right,L1,612,-3,-26,-10,-16
720575940628616209,right,L1,613,-8,-4,6,-10
720575940623125735,right,L1,614,-2,-8,-2,-6
720575940612325299,right,L1,615,-7,-7,3,-10
720575940631278031,right,L1,616,-3,15,10,5
720575940623829197,right,L1,617,-2,-17,-7,-10
720575940612819370,right,L1,618,-1,24,13,11
720575940606364262,right,L1,619,-4,-19,-6,-13
720575940624225789,right,L1,620,7,1,-7,8
720575940632256081,right,L1,621,1,24,11,13
720575940621277318,right,L1,622,-5,20,15,5
720575940647679028,right,L1,623,1,13,5,8
720575940623791543,right,L1,624,1,-17,-10,-7
720575940609900100,right,L1,625,-2,24,14,10
720575940627285147,right,L1,626,-5,-8,1,-9
720575940623142349,right,L1,627,0,-1,-1,0
720575940628806824,right,L1,628,0,0,0,0
720575940631121152,right,L1,629,4,24,8,16
720575940629936027,right,L1,630,4,8,0,8
720575940617948500,right,L1,631,1,26,12,14
720575940636552184,right,L1,632,3,-20,-13,-7
720575940625059336,right,L1,633,-1,-24,-11,-13
720575940639655997,right,L1,634,-3,-15,-5,-10
720575940628090387,right,L1,635,6,-6,-9,3
720575940622397940,right,L1,636,0,6,3,3
720575940631869738,right,L1,637,3,-21,-14,-7
720575940606810889,right,L1,638,-1,7,4,3
720575940633194287,right,L1,639,-4,19,13,6
720575940628454728,right,L1,640,-1,-16,-7,-9
720575940631113815,right,L1,641,-8,-5,5,-10
720575940620755366,right,L1,642,-5,-11,-1,-10
720575940621014465,right,L1,643,6,14,1,13
720575940633313444,right,L1,644,-6,18,15,3
720575940615631884,right,L1,645,-4,27,17,10
720575940605330022,right,L1,646,6,17,2,15
720575940614283304,right,L1,647,-4,-7,0,-7
720575940644883479,right,L1,648,1,7,2,5
720575940636303728,right,L1,649,-1,5,3,2
720575940646131566,right,L1,650,-3,-25,-10,-15
720575940627039006,right,L1,651,-4,-5,1,-6
720575940639675480,right,L1,652,-6,-11,0,-11
720575940638721001,right,L1,653,-6,-12,0,-12
720575940605376224,right,L1,654,-3,8,7,1
720575940627489874,right,L1,655,6,-1,-7,6
720575940620862829,right,L1,656,0,-11,-6,-5
720575940634324961,right,L1,657,-2,-25,-11,-14
720575940624233715,right,L1,658,1,20,9,11
720575940616413469,right,L1,659,-4,-6,1,-7
720575940625919928,right,L1,660,2,28,12,16
720575940636124084,right,L1,661,-3,14,10,4
720575940630733330,right,L1,662,2,-1,-3,2
720575940621032384,right,L1,663,0,8,4,4
720575940623686792,right,L1,665,7,-2,-8,6
720575940626706576,right,L1,666,7,-13,-14,1
720575940631990826,right,L1,667,1,-28,-15,-13
720575940632804664,right,L1,668,1,19,8,11
720575940628187450,right,L1,669,4,-16,-12,-4
720575940630986496,right,L1,670,5,5,-3,8
720575940609398539,right,L1,671,-4,-23,-8,-15
720575940624202739,right,L1,672,-8,11,13,-2
720575940622564476,right,L1,673,2,5,0,5
720575940645377828,right,L1,674,-4,-14,-3,-11
720575940642781236,right,L1,675,-7,19,16,3
720575940614760111,right,L1,676,-3,-21,-8,-13
720575940611517048,right,L1,677,0,11,5,6
720575940622011357,right,L1,678,3,-7,-7,0
720575940628912683,right,L1,679,4,18,5,13
720575940623403196,right,L1,680,-1,25,13,12
720575940609440210,right,L1,681,-2,-21,-9,-12
720575940610032579,right,L1,682,6,-8,-10,2
720575940631966777,right,L1,683,2,6,1,5
720575940618430609,right,L1,684,-6,17,14,3
720575940624484843,right,L1,685,-5,-9,0,-9
720575940620602960,right,L1,686,5,-22,-16,-6
720575940638053348,right,L1,687,-6,-3,4,-7
720575940615795871,right,L1,688,-7,10,12,-2
720575940635205783,right,L1,689,-2,18,11,7
720575940607493065,right,L1,690,-7,-3,5,-8
720575940642036187,right,L1,691,-9,4,11,-7
720575940627848841,right,L1,692,-4,24,16,8
720575940637602990,right,L1,693,-3,25,15,10
720575940628173394,right,L1,694,4,3,-3,6
720575940620385556,right,L1,695,-6,10,11,-1
720575940636619621,right,L1,696,-2,16,10,6
720575940612765462,right,L1,697,1,-22,-12,-10
720575940635011996,right,L1,698,6,-7,-10,3
720575940639062350,right,L1,699,-5,0,5,-5
720575940612753557,right,L1,700,5,15,2,13
720575940623448614,right,L1,701,0,-4,-2,-2
720575940625738544,right,L1,702,-5,23,16,7
720575940617330772,right,L1,703,-3,1,3,-2
720575940628753640,right,L1,704,-7,8,11,-3
720575940632183115,right,L1,705,1,1,-1,2
720575940614016749,right,L1,706,-7,-12,1,-13
720575940620234375,right,L1,707,-2,25,14,11
720575940645945111,right,L1,708,-4,-25,-9,-16
720575940615204862,right,L1,709,-2,-24,-10,-14
720575940623441373,right,L1,710,4,-25,-17,-8
720575940617338683,right,L1,711,-1,19,10,9
720575940622127088,right,L1,712,-7,12,13,-1
720575940609480459,right,L1,713,-6,16,14,2
720575940622836521,right,L1,714,5,12,1,11
720575940640555635,right,L1,715,4,10,1,9
720575940627244165,right,L1,716,4,-6,-7,1
720575940640399987,right,L1,717,2,-22,-13,-9
720575940654732193,right,L1,718,-5,24,17,7
720575940625627372,right,L1,719,1,27,12,15
720575940637164151,right,L1,720,-5,21,15,6
720575940614340758,right,L1,721,5,13,1,12
720575940622021146,right,L1,722,6,-15,-14,-1
720575940628208384,right,L1,723,-2,-11,-4,-7
720575940624863783,right,L1,724,4,2,-3,5
720575940613200307,right,L1,725,-3,-24,-9,-15
720575940640409203,right,L1,726,2,-28,-16,-12
720575940616971788,right,L1,727,7,6,-4,10
720575940605153708,right,L1,728,7,12,-1,13
720575940628968444,right,L1,729,-3,29,17,12
720575940618499141,right,L1,730,7,0,-7,7
720575940634583959,right,L1,731,-6,9,10,-1
720575940626281790,right,L1,732,-3,6,6,0
720575940625407380,right,L1,733,-5,-17,-4,-13
720575940619831710,right,L1,734,2,0,-2,2
720575940632754060,right,L1,735,1,-23,-13,-10
720575940623927304,right,L1,736,-8,1,8,-7
720575940620787182,right,L1,737,0,19,9,10
720575940627737481,right,L1,738,-3,13,9,4
720575940607001801,right,L1,739,-7,2,8,-6
720575940630986959,right,L1,740,2,-8,-6,-2
720575940628695751,right,L1,741,-2,-14,-5,-9
720575940623527059,right,L1,742,-4,11,9,2
720575940628426408,right,L1,743,6,-19,-16,-3
720575940622100464,right,L1,744,-4,25,16,9
720575940614275299,right,L1,745,0,13,6,7
720575940647261987,right,L1,746,-3,3,4,-1
720575940637932400,right,L1,747,0,2,1,1
720575940643006349,right,L1,748,-4,20,14,6
720575940623521003,right,L1,749,-2,1,2,-1
720575940612641649,right,L1,750,4,-24,-16,-8
720575940624293578,right,L1,751,1,6,2,4
720575940617961309,right,L1,752,-2,7,5,2
720575940616364866,right,L1,753,-3,24,15,9
720575940627013406,right,L1,754,-1,-13,-6,-7
720575940647109764,right,L1,755,4,19,5,14
720575940620344792,right,L1,756,5,20,5,15
720575940640407128,right,L1,757,0,-6,-3,-3
720575940630252764,right,L1,758,5,-1,-6,5
720575940624769800,right,L1,759,7,14,0,14
720575940616781766,right,L1,760,0,17,8,9
720575940635637951,right,L1,761,-4,-18,-5,-13
720575940627707529,right,L1,762,0,14,7,7
720575940633188689,right,L1,763,-5,14,12,2
720575940633800930,right,L1,764,-8,-6,5,-11
720575940632005674,right,L1,765,-3,9,7,2
720575940618922653,right,L1,766,2,-4,-4,0
720575940640502435,right,L1,767,1,28,13,15
720575940616129642,right,L1,768,3,5,-1,6
720575940629176875,right,L1,769,4,-27,-18,-9
720575940621717441,right,L1,770,5,4,-3,7
720575940640162613,right,L1,771,3,-27,-17,-10
720575940620847124,right,L1,772,1,12,5,7
720575940625354644,right,L1,773,5,-19,-15,-4
720575940625587484,right,L1,774,-8,6,11,-5
720575940616277826,right,L1,775,5,22,6,16
720575940620224785,right,L1,776,5,21,5,16
720575940624054310,right,L1,777,6,20,4,16
720575940612955098,right,L1,778,4,25,8,17
720575940605423532,right,L1,779,5,24,7,17
720575940615054186,right,L1,780,-6,25,18,7
720575940611397218,right,L1,781,-5,26,18,8
720575940625973692,right,L1,783,-4,28,18,10
720575940638951002,right,L1,784,-4,29,18,11
720575940653065462,right,L1,785,-3,30,18,12
720575940631955653,right,L1,786,-2,30,17,13
720575940619702848,right,L1,787,3,28,11,17
720575940633067079,right,L1,788,3,27,10,17
720575940616960699,right,L1,789,-3,-27,-11,-16
720575940621055141,right,L1,790,-2,-27,-12,-15
720575940634395618,right,L1,791,-1,-28,-13,-15
720575940612448790,right,L1,792,8,2,-7,9
720575940624779959,right,L1,793,8,-6,-11,5
720575940630681538,right,L1,794,5,-26,-18,-8
720575940614548655,right,L1,795,6,-21,-17,-4
720575940633647789,right,L1,796,4,26,9,17
720575940626380365,right,L2,1,-6,13,12,1
720575940628140565,right,L2,2,-8,2,9,-7
720575940622880244,right,L2,3,6,-12,-12,0
720575940627097290,right,L2,4,-5,-21,-6,-15
720575940633817569,right,L2,5,-1,16,9,7
720575940618289113,right,L2,6,-2,-4,0,-4
720575940620313685,right,L2,7,-6,-6,3,-9
720575940614856488,right,L2,8,-4,26,17,9
720575940611964330,right,L2,9,4,9,0,9
720575940625066423,right,L2,10,5,-15,-13,-2
720575940621699873,right,L2,11,7,-14,-14,0
720575940606286001,right,L2,12,-7,9,11,-2
720575940629280617,right,L2,13,-1,-26,-12,-14
720575940643901344,right,L2,14,0,-27,-14,-13
720575940642998413,right,L2,15,2,-3,-4,1
720575940625236232,right,L2,16,-2,-16,-6,-10
720575940643779528,right,L2,17,1,-5,-4,-1
720575940610204228,right,L2,18,5,-16,-13,-3
720575940611853522,right,L2,19,-7,17,15,2
720575940626837379,right,L2,20,3,-11,-9,-2
720575940631151324,right,L2,21,-2,19,11,8
720575940614557663,right,L2,22,-1,3,2,1
720575940630210092,right,L2,23,-3,-16,-5,-11
720575940627857278,right,L2,24,-1,-10,-4,-6
720575940624505382,right,L2,25,-9,3,10,-7
720575940627211292,right,L2,26,1,-3,-3,0
720575940626197434,right,L2,27,0,-25,-13,-12
720575940619030853,right,L2,28,5,6,-2,8
720575940624145432,right,L2,29,-1,-3,-1,-2
720575940637097847,right,L2,30,6,16,2,14
720575940629367114,right,L2,31,0,16,8,8
720575940630065720,right,L2,32,0,12,6,6
720575940631124224,right,L2,33,3,18,6,12
720575940605353760,right,L2,34,6,18,3,15
720575940627291198,right,L2,35,1,-24,-13,-11
720575940616988884,right,L2,36,6,8,-2,10
720575940645578532,right,L2,37,1,5,1,4
720575940647104291,right,L2,38,0,-2,-1,-1
720575940615078034,right,L2,39,0,20,10,10
720575940606762418,right,L2,40,-2,-6,-1,-5
720575940617297467,right,L2,41,-3,28,17,11
720575940626023568,right,L2,42,-1,14,8,6
720575940605701036,right,L2,43,-5,18,14,4
720575940625814932,right,L2,44,5,-10,-10,0
720575940639473280,right,L2,45,-5,-1,4,-5
720575940629980163,right,L2,46,-5,15,12,3
720575940619135798,right,L2,47,-9,-1,8,-9
720575940628741638,right,L2,48,-4,-22,-7,-15
720575940616468383,right,L2,49,4,-4,-6,2
720575940633137711,right,L2,50,-2,21,12,9
720575940617259963,right,L2,51,0,-19,-10,-9
720575940627035932,right,L2,52,-1,-22,-10,-12
720575940620582168,right,L2,53,5,14,2,12
720575940625347220,right,L2,54,-4,3,5,-2
720575940660372609,right,L2,55,-4,-11,-2,-9
720575940626784304,right,L2,56,1,-13,-8,-5
720575940613531109,right,L2,57,6,-11,-12,1
720575940627099179,right,L2,58,3,12,3,9
720575940639020122,right,L2,59,-2,2,3,-1
720575940626726704,right,L2,60,-8,8,12,-4
720575940615759682,right,L2,61,-4,-4,2,-6
720575940616751755,right,L2,62,0,-29,-15,-14
720575940623348067,right,L2,63,4,12,2,10
720575940645329774,right,L2,64,4,-23,-16,-7
720575940605573088,right,L2,65,-1,28,15,13
720575940626784560,right,L2,66,2,15,5,10
720575940634283545,right,L2,67,-2,-13,-5,-8
720575940625755576,right,L2,68,3,16,5,11
720575940611313966,right,L2,69,1,8,3,5
720575940635925855,right,L2,70,-4,21,14,7
720575940644518167,right,L2,71,-2,-3,0,-3
720575940618327089,right,L2,72,0,-28,-14,-14
720575940624187575,right,L2,73,2,2,-1,3
720575940640863360,right,L2,74,-1,-9,-4,-5
720575940617401601,right,L2,75,-6,14,13,1
720575940626769957,right,L2,76,-3,-4,1,-5
720575940632072296,right,L2,77,2,-5,-5,0
720575940637864819,right,L2,78,2,20,8,12
720575940627556690,right,L2,79,2,1,-2,3
720575940618431069,right,L2,80,4,13,2,11
720575940621616112,right,L2,81,6,-2,-7,5
720575940629051651,right,L2,82,-7,7,10,-3
720575940637951551,right,L2,83,2,-21,-13,-8
720575940613459314,right,L2,84,-2,12,8,4
720575940617818342,right,L2,85,4,-22,-15,-7
720575940622017121,right,L2,86,-5,-7,1,-8
720575940614965502,right,L2,87,1,11,4,7
720575940620620504,right,L2,88,7,4,-5,9
720575940628552520,right,L2,89,1,-19,-11,-8
720575940616158530,right,L2,90,-4,5,6,-1
720575940633679955,right,L2,91,-1,6,4,2
720575940629099719,right,L2,92,0,9,4,5
720575940634693089,right,L2,93,-6,3,7,-4
720575940607829122,right,L2,94,5,18,4,14
720575940630037751,right,L2,95,4,-21,-15,-6
720575940626813328,right,L2,96,1,-10,-6,-4
720575940606568126,right,L2,97,-5,2,6,-4
720575940623137535,right,L2,98,-1,-12,-5,-7
720575940626545158,right,L2,99,4,15,3,12
720575940628014991,right,L2,100,2,-10,-7,-3
720575940612966422,right,L2,101,-7,6,10,-4
720575940627166564,right,L2,102,3,13,3,10
720575940621349313,right,L2,103,7,9,-3,12
720575940627781272,right,L2,104,-1,-27,-13,-14
720575940632998957,right,L2,105,3,22,8,14
720575940623272035,right,L2,106,-7,11,12,-1
720575940637755310,right,L2,107,8,-2,-9,7
720575940627504015,right,L2,108,-3,-12,-3,-9
720575940633002065,right,L2,109,4,-5,-7,2
720575940630987991,right,L2,110,-7,0,7,-7
720575940647574324,right,L2,111,2,-24,-14,-10
720575940627459642,right,L2,112,-6,1,6,-5
720575940631613743,right,L2,113,-2,4,4,0
720575940621817441,right,L2,114,2,-13,-9,-4
720575940628220682,right,L2,115,-4,2,5,-3
720575940627291291,right,L2,116,-1,-8,-3,-5
720575940609625045,right,L2,117,-8,-2,7,-9
720575940630049947,right,L2,118,3,1,-3,4
720575940623621414,right,L2,119,-2,6,5,1
720575940614654175,right,L2,120,-1,-1,0,-1
720575940623112925,right,L2,121,-8,4,10,-6
720575940624043007,right,L2,122,-5,9,9,0
720575940632587428,right,L2,123,-8,10,13,-3
720575940615552423,right,L2,124,1,-7,-5,-2
720575940643251104,right,L2,125,5,9,-1,10
720575940621286168,right,L2,126,3,11,2,9
720575940617630301,right,L2,127,0,15,7,8
720575940605162668,right,L2,128,3,-22,-14,-8
720575940623889642,right,L2,129,0,-13,-7,-6
720575940639847795,right,L2,130,2,12,4,8
720575940619256222,right,L2,131,-6,20,16,4
720575940634322583,right,L2,132,2,4,0,4
720575940637748446,right,L2,133,-3,20,13,7
720575940626141221,right,L2,134,-5,-18,-4,-14
720575940626250954,right,L2,135,-3,-22,-8,-14
720575940634217114,right,L2,136,0,3,1,2
720575940638914276,right,L2,137,5,-7,-9,2
720575940637236336,right,L2,138,0,27,13,14
720575940616287711,right,L2,139,1,-14,-8,-6
720575940631507275,right,L2,140,3,8,1,7
720575940605907586,right,L2,141,5,-23,-17,-6
720575940633246125,right,L2,142,-2,-18,-7,-11
720575940631388534,right,L2,143,-4,16,12,4
720575940636338283,right,L2,144,7,-11,-13,2
720575940616780731,right,L2,145,0,4,2,2
720575940630873548,right,L2,146,1,-6,-4,-2
720575940614743007,right,L2,147,1,21,9,12
720575940629995386,right,L2,148,-7,-11,1,-12
720575940625969712,right,L2,149,6,-14,-13,-1
720575940634238690,right,L2,150,-8,5,10,-5
720575940632494184,right,L2,151,-3,-14,-4,-10
720575940625626092,right,L2,152,3,-15,-11,-4
720575940605817958,right,L2,153,8,0,-8,8
720575940622434072,right,L2,154,-8,0,8,-8
720575940642039693,right,L2,155,-8,13,14,-1
720575940639447741,right,L2,156,-9,1,9,-8
720575940611760994,right,L2,157,-1,-7,-3,-4
720575940620574190,right,L2,158,3,-5,-6,1
720575940645437476,right,L2,159,7,7,-4,11
720575940624487108,right,L2,160,-2,20,12,8
720575940628086149,right,L2,161,4,-14,-11,-3
720575940636250292,right,L2,162,-4,-2,3,-5
720575940628113655,right,L2,163,-9,7,12,-5
720575940613183923,right,L2,164,-1,-2,0,-2
720575940618212432,right,L2,165,4,16,4,12
720575940614869922,right,L2,166,0,18,9,9
720575940618454621,right,L2,167,0,-17,-9,-8
720575940624446650,right,L2,168,-1,17,9,8
720575940632162883,right,L2,169,0,-18,-9,-9
720575940622005857,right,L2,170,-5,1,5,-4
720575940616470982,right,L2,171,6,-20,-16,-4
720575940638197850,right,L2,172,1,22,10,12
720575940605169580,right,L2,173,2,-25,-15,-10
720575940632754488,right,L2,174,4,-15,-12,-3
720575940628656401,right,L2,175,-6,-7,2,-9
720575940623172632,right,L2,176,-2,13,8,5
720575940619642021,right,L2,177,-2,-1,1,-2
720575940610210372,right,L2,178,2,11,3,8
720575940635245212,right,L2,179,-5,-16,-3,-13
720575940624176787,right,L2,180,2,-27,-16,-11
720575940619142966,right,L2,181,1,-4,-3,-1
720575940620899019,right,L2,182,7,-10,-12,2
720575940627518227,right,L2,183,-5,-15,-3,-12
720575940629037355,right,L2,184,-6,-5,3,-8
720575940621215103,right,L2,185,2,-11,-8,-3
720575940636216500,right,L2,186,-1,26,14,12
720575940614200115,right,L2,187,3,21,7,14
720575940632306706,right,L2,188,-5,17,13,4
720575940620608305,right,L2,189,6,13,0,13
720575940618476317,right,L2,190,-3,-5,0,-5
720575940627485461,right,L2,191,-1,-11,-5,-6
720575940614383535,right,L2,192,7,10,-2,12
720575940628975690,right,L2,193,-5,4,7,-3
720575940618366109,right,L2,194,0,-5,-3,-2
720575940628884606,right,L2,195,-3,-1,2,-3
720575940644555168,right,L2,196,-1,8,5,3
720575940625139640,right,L2,197,0,-20,-10,-10
720575940647137844,right,L2,198,6,2,-5,7
720575940620744664,right,L2,199,0,-12,-6,-6
720575940623253068,right,L2,200,-5,12,11,1
720575940639886755,right,L2,201,-8,9,12,-3
720575940624952051,right,L2,202,-1,27,14,13
720575940639016051,right,L2,203,3,-1,-4,3
720575940647152419,right,L2,204,5,-2,-6,4
720575940637415902,right,L2,205,5,-6,-8,2
720575940621289236,right,L2,206,-3,5,5,0
720575940612369614,right,L2,207,1,29,13,16
720575940647377955,right,L2,208,5,-21,-16,-5
720575940605364396,right,L2,209,-3,-8,-1,-7
720575940634797212,right,L2,210,-6,8,10,-2
720575940620724160,right,L2,211,-7,-1,6,-7
720575940629966848,right,L2,212,2,-16,-10,-6
720575940629681411,right,L2,213,3,-4,-5,1
720575940628310794,right,L2,214,-5,3,6,-3
720575940621443776,right,L2,215,6,7,-3,10
720575940630862843,right,L2,216,2,19,7,12
720575940628742396,right,L2,217,6,15,1,14
720575940629154310,right,L2,218,2,10,3,7
720575940626095504,right,L2,219,6,-4,-8,4
720575940627818001,right,L2,220,2,-6,-5,-1
720575940626880144,right,L2,221,-7,3,8,-5
720575940628230135,right,L2,222,-3,26,16,10
720575940625650151,right,L2,223,-2,26,15,11
720575940628034058,right,L2,224,0,5,2,3
720575940628153914,right,L2,225,2,-26,-15,-11
720575940626796377,right,L2,226,5,19,4,15
720575940611215970,right,L2,227,-7,5,9,-4
720575940615366050,right,L2,228,-7,1,7,-6
720575940637583838,right,L2,229,5,2,-4,6
720575940617567325,right,L2,230,2,9,2,7
720575940608161410,right,L2,231,4,-12,-10,-2
720575940630015055,right,L2,232,-4,13,10,3
720575940622067828,right,L2,233,4,-13,-11,-2
720575940635530687,right,L2,234,1,3,0,3
720575940623871978,right,L2,235,4,11,1,10
720575940611994066,right,L2,236,-1,4,3,1
720575940614293288,right,L2,237,-2,27,15,12
720575940631431439,right,L2,238,-8,-3,6,-9
720575940625527276,right,L2,239,-6,6,9,-3
720575940621901165,right,L2,240,-4,-3,2,-5
720575940631841080,right,L2,241,2,-17,-11,-6
720575940628160004,right,L2,242,-4,6,7,-1
720575940616312898,right,L2,243,-1,-21,-10,-11
720575940628742662,right,L2,244,-4,-12,-2,-10
720575940645007895,right,L2,245,-5,-3,3,-6
720575940616982614,right,L2,246,-4,15,11,4
720575940614855976,right,L2,247,-4,-15,-4,-11
720575940609358603,right,L2,248,-6,0,6,-6
720575940619763358,right,L2,249,2,-12,-8,-4
720575940629010356,right,L2,250,-1,1,1,0
720575940639616189,right,L2,251,-1,-14,-6,-8
720575940622221948,right,L2,252,3,23,8,15
720575940626356557,right,L2,253,5,16,3,13
720575940605662142,right,L2,254,3,-24,-15,-9
720575940621407726,right,L2,255,-6,-13,-1,-12
720575940634880663,right,L2,256,5,-20,-15,-5
720575940627786769,right,L2,257,2,21,8,13
720575940633996973,right,L2,258,-4,-17,-5,-12
720575940613560549,right,L2,259,-7,-5,4,-9
720575940624038340,right,L2,260,-3,19,12,7
720575940643642932,right,L2,261,-1,13,7,6
720575940626997434,right,L2,262,1,-11,-7,-4
720575940620229236,right,L2,263,-3,4,5,-1
720575940623964969,right,L2,264,-1,-6,-2,-4
720575940613706818,right,L2,265,-6,-1,5,-6
720575940626591490,right,L2,266,-1,-25,-12,-13
720575940614758311,right,L2,267,-6,2,7,-5
720575940631152492,right,L2,268,7,-6,-10,4
720575940623452307,right,L2,269,2,-19,-12,-7
720575940628345733,right,L2,270,1,-8,-5,-3
720575940626764746,right,L2,271,4,6,-1,7
720575940618547269,right,L2,272,3,-2,-4,2
720575940629033003,right,L2,273,-6,23,17,6
720575940632315467,right,L2,275,-8,-1,7,-8
720575940624506293,right,L2,276,2,3,-1,4
720575940620384597,right,L2,277,7,-3,-9,6
720575940617175710,right,L2,278,-5,10,10,0
720575940626564426,right,L2,279,-4,8,8,0
720575940623705368,right,L2,280,-6,-14,-1,-13
720575940624302921,right,L2,281,-9,2,10,-8
720575940620716114,right,L2,282,0,26,13,13
720575940639344693,right,L2,283,-4,4,6,-2
720575940625104568,right,L2,284,0,25,12,13
720575940620035638,right,L2,285,6,-18,-15,-3
720575940640139598,right,L2,286,0,-24,-12,-12
720575940612196194,right,L2,287,-5,13,11,2
720575940616307284,right,L2,289,-1,11,6,5
720575940613728674,right,L2,290,5,-24,-17,-7
720575940634694496,right,L2,291,7,2,-6,8
720575940632811880,right,L2,292,-4,18,13,5
720575940627942675,right,L2,293,4,-17,-13,-4
720575940633581516,right,L2,294,1,-20,-11,-9
720575940628136714,right,L2,296,1,-18,-10,-8
720575940623976291,right,L2,297,7,-9,-12,3
720575940625282488,right,L2,298,-5,5,7,-2
720575940637125495,right,L2,299,-4,12,10,2
720575940620034974,right,L2,300,4,-18,-13,-5
720575940613675030,right,L2,301,-5,16,13,3
720575940629290256,right,L2,302,2,17,6,11
720575940614336209,right,L2,303,-5,22,16,6
720575940633429668,right,L2,304,6,5,-4,9
720575940627290686,right,L2,305,-7,4,9,-5
720575940628994054,right,L2,306,3,7,0,7
720575940626578521,right,L2,307,5,-25,-18,-7
720575940624958951,right,L2,308,-5,8,9,-1
720575940627468821,right,L2,309,-6,12,12,0
720575940628238824,right,L2,310,2,22,9,13
720575940621683951,right,L2,311,-7,15,14,1
720575940618238425,right,L2,312,4,-7,-8,1
720575940629401930,right,L2,313,7,3,-6,9
720575940627363870,right,L2,314,-9,5,11,-6
720575940618470996,right,L2,315,-3,-6,0,-6
720575940629350730,right,L2,316,5,-4,-7,3
720575940627973754,right,L2,317,-5,-4,3,-7
720575940628399121,right,L2,318,4,-19,-14,-5
720575940625987256,right,L2,319,-2,5,4,1
720575940631718819,right,L2,320,-2,-5,-1,-4
720575940631095552,right,L2,321,8,4,-6,10
720575940632828068,right,L2,322,2,26,11,15
720575940630925911,right,L2,323,-7,-13,0,-13
720575940628642759,right,L2,324,3,24,9,15
720575940635361375,right,L2,325,5,1,-5,6
720575940615787330,right,L2,326,2,16,6,10
720575940629861419,right,L2,327,5,3,-4,7
720575940629873018,right,L2,328,5,-9,-10,1
720575940605827174,right,L2,329,0,24,12,12
720575940621971126,right,L2,330,3,3,-2,5
720575940632350994,right,L2,331,1,-15,-9,-6
720575940629182055,right,L2,332,4,-26,-17,-9
720575940605833662,right,L2,333,0,-21,-11,-10
720575940626843236,right,L2,334,1,-26,-14,-12
720575940622939869,right,L2,335,2,8,2,6
720575940620778516,right,L2,336,0,23,11,12
720575940641661429,right,L2,337,-5,-6,2,-8
720575940625807388,right,L2,338,-1,0,1,-1
720575940645486103,right,L2,339,6,11,-1,12
720575940618278868,right,L2,340,-4,17,12,5
720575940623835389,right,L2,341,6,-17,-15,-2
720575940628001352,right,L2,342,2,-15,-10,-5
720575940627370302,right,L2,343,-3,27,16,11
720575940647946804,right,L2,344,-2,-15,-6,-9
720575940623650857,right,L2,345,3,-12,-9,-3
720575940630213120,right,L2,346,-7,-9,2,-11
720575940639234621,right,L2,347,-5,-13,-2,-11
720575940626172035,right,L2,348,3,14,4,10
720575940622955525,right,L2,349,-5,-14,-2,-12
720575940621682102,right,L2,350,1,15,6,9
720575940616991371,right,L2,351,-1,-17,-8,-9
720575940630061467,right,L2,352,-2,28,16,12
720575940638334697,right,L2,353,2,24,10,14
720575940619322539,right,L2,354,-2,-26,-11,-15
720575940617249141,right,L2,355,-7,-6,4,-10
720575940632485457,right,L2,356,0,22,11,11
720575940606016288,right,L2,357,4,17,4,13
720575940612970262,right,L2,358,-3,17,11,6
720575940612930582,right,L2,359,2,23,9,14
720575940626014734,right,L2,360,-5,19,14,5
720575940617194379,right,L2,361,0,-7,-4,-3
720575940612648817,right,L2,362,2,-20,-12,-8
720575940628402258,right,L2,363,7,-4,-9,5
720575940611414574,right,L2,364,4,4,-2,6
720575940623312391,right,L2,365,4,7,-1,8
720575940638263518,right,L2,366,-5,-20,-5,-15
720575940626886544,right,L2,367,-6,-15,-2,-13
720575940644212640,right,L2,368,-4,-20,-6,-14
720575940629023740,right,L2,369,5,-5,-8,3
720575940613980712,right,L2,370,-3,21,13,8
720575940633139503,right,L2,371,6,-5,-9,4
720575940618477753,right,L2,372,1,-2,-2,0
720575940623220957,right,L2,373,1,-21,-12,-9
720575940630545274,right,L2,374,2,13,4,9
720575940632766372,right,L2,375,-6,7,9,-2
720575940606063537,right,L2,376,-7,-10,2,-12
720575940606778123,right,L2,377,0,7,3,4
720575940617822438,right,L2,378,-3,18,12,6
720575940630323834,right,L2,379,3,-17,-12,-5
720575940634796954,right,L2,380,-1,29,15,14
720575940641524443,right,L2,381,-8,-9,3,-12
720575940613209002,right,L2,382,3,-6,-6,0
720575940606543490,right,L2,383,-6,11,11,0
720575940622006881,right,L2,384,-6,-2,5,-7
720575940620707916,right,L2,385,-3,-18,-6,-12
720575940617281141,right,L2,386,-6,19,15,4
720575940641618896,right,L2,387,-1,-15,-7,-8
720575940623275278,right,L2,388,3,19,6,13
720575940636690094,right,L2,389,-6,-16,-2,-14
720575940625060327,right,L2,390,-6,-9,1,-10
720575940611708565,right,L2,391,4,-3,-6,3
720575940613866098,right,L2,392,-4,7,7,0
720575940621243007,right,L2,393,-1,22,12,10
720575940621900141,right,L2,394,-7,-8,3,-11
720575940623911448,right,L2,395,0,-22,-11,-11
720575940614755295,right,L2,396,-1,10,6,4
720575940629023228,right,L2,397,-3,-19,-7,-12
720575940640301440,right,L2,398,-3,22,14,8
720575940612822421,right,L2,399,-4,-24,-8,-16
720575940606058924,right,L2,400,1,-29,-16,-13
720575940630228327,right,L2,401,-2,-19,-8,-11
720575940621656158,right,L2,402,3,26,10,16
720575940630805778,right,L2,403,-2,-12,-4,-8
720575940633829933,right,L2,404,-1,20,11,9
720575940618188893,right,L2,405,3,10,2,8
720575940634433180,right,L2,406,1,-25,-14,-11
720575940645172247,right,L2,407,-5,-10,0,-10
720575940617863517,right,L2,408,-6,-4,4,-8
720575940632956371,right,L2,409,0,-3,-2,-1
720575940629125084,right,L2,410,-2,-2,1,-3
720575940617543892,right,L2,411,-5,-19,-5,-14
720575940624835476,right,L2,412,-6,21,16,5
720575940625822820,right,L2,413,-2,-7,-2,-5
720575940623990152,right,L2,414,4,21,6,15
720575940625769037,right,L2,415,6,12,0,12
720575940615790197,right,L2,416,3,-8,-7,-1
720575940616039647,right,L2,417,-6,-10,1,-11
720575940632505898,right,L2,418,-2,15,9,6
720575940635565920,right,L2,419,-3,-11,-3,-8
720575940625609196,right,L2,420,6,-3,-8,5
720575940640507533,right,L2,421,-1,12,7,5
720575940635002137,right,L2,422,-7,-4,5,-9
720575940642756493,right,L2,423,3,-18,-12,-6
720575940627303524,right,L2,424,-3,-2,2,-4
720575940620118864,right,L2,425,3,20,7,13
720575940629022972,right,L2,426,-3,0,3,-3
720575940634900631,right,L2,427,5,-18,-14,-4
720575940631969099,right,L2,428,-2,23,13,10
720575940617293398,right,L2,429,-2,14,9,5
720575940632949218,right,L2,430,-3,-7,-1,-6
720575940624080787,right,L2,431,-2,-10,-3,-7
720575940625549292,right,L2,432,-5,7,8,-1
720575940614108566,right,L2,433,0,-8,-4,-4
720575940606640928,right,L2,434,-3,7,6,1
720575940614526673,right,L2,435,5,-17,-14,-3
720575940633440813,right,L2,436,0,-15,-8,-7
720575940625590460,right,L2,437,-3,12,9,3
720575940623159209,right,L2,438,2,27,11,16
720575940640134077,right,L2,439,-3,-9,-2,-7
720575940642090459,right,L2,440,1,23,10,13
720575940624889870,right,L2,441,3,-16,-11,-5
720575940638348095,right,L2,442,-5,25,17,8
720575940621716207,right,L2,443,-6,4,8,-4
720575940621908720,right,L2,444,4,-10,-9,-1
720575940622715653,right,L2,445,-2,8,6,2
720575940638707940,right,L2,446,2,-14,-9,-5
720575940618933451,right,L2,447,-1,2,2,0
720575940620521777,right,L2,448,0,30,15,15
720575940638817087,right,L2,449,6,-16,-14,-2
720575940626417485,right,L2,450,2,-9,-7,-2
720575940623282893,right,L2,451,4,20,6,14
720575940630637050,right,L2,452,1,-9,-6,-3
720575940606782300,right,L2,453,3,25,9,16
720575940628661647,right,L2,454,5,-12,-11,-1
720575940637293943,right,L2,455,7,-7,-11,4
720575940638139738,right,L2,456,0,21,10,11
720575940613865586,right,L2,457,-2,17,10,7
720575940609412617,right,L2,458,5,0,-5,5
720575940623968400,right,L2,459,5,-3,-7,4
720575940614760367,right,L2,460,-3,-20,-7,-13
720575940626595530,right,L2,461,7,-5,-10,5
720575940645667438,right,L2,462,-1,18,10,8
720575940623145959,right,L2,463,5,17,3,14
720575940640073806,right,L2,464,4,0,-4,4
720575940622353023,right,L2,465,3,0,-3,3
720575940612977834,right,L2,466,1,14,6,8
720575940609061641,right,L2,467,-2,-20,-8,-12
720575940616593221,right,L2,468,-3,11,8,3
720575940607810505,right,L2,469,-7,13,13,0
720575940624303300,right,L2,470,4,-9,-9,0
720575940628001149,right,L2,471,3,-26,-16,-10
720575940627572099,right,L2,472,1,25,11,14
720575940636357231,right,L2,473,-4,23,15,8
720575940631124729,right,L2,474,-3,-17,-6,-11
720575940621643457,right,L2,475,-4,-1,3,-4
720575940629149015,right,L2,476,-1,15,8,7
720575940621292992,right,L2,477,-3,2,4,-2
720575940631463528,right,L2,478,-7,16,15,1
720575940628262738,right,L2,479,-2,10,7,3
720575940632087367,right,L2,480,3,-19,-13,-6
720575940631235692,right,L2,481,4,-8,-8,0
720575940638529087,right,L2,482,1,17,7,10
720575940639720637,right,L2,483,2,-7,-6,-1
720575940620767937,right,L2,484,3,-9,-8,-1
720575940660952449,right,L2,485,-3,-3,1,-4
720575940623537373,right,L2,486,0,1,0,1
720575940618067161,right,L2,487,1,-1,-2,1
720575940645060296,right,L2,488,7,5,-5,10
720575940624468809,right,L2,489,-3,10,8,2
720575940617044018,right,L2,490,-5,6,8,-2
720575940605822654,right,L2,491,7,-1,-8,7
720575940625066935,right,L2,492,-7,-2,6,-8
720575940644552096,right,L2,493,-3,23,14,9
720575940611201486,right,L2,494,0,29,14,15
720575940621944496,right,L2,495,4,5,-2,7
720575940617947675,right,L2,496,7,8,-3,11
720575940632871737,right,L2,497,6,1,-6,7
720575940621711041,right,L2,498,6,10,-1,11
720575940616865083,right,L2,499,5,10,0,10
720575940623130025,right,L2,500,7,-8,-11,3
720575940631647063,right,L2,501,1,2,0,2
720575940628134021,right,L2,502,5,8,-1,9
720575940640266584,right,L2,503,3,17,5,12
720575940617655626,right,L2,504,-2,9,6,3
720575940643830984,right,L2,505,6,-22,-17,-5
720575940620466768,right,L2,506,1,-12,-7,-5
720575940655214241,right,L2,507,-5,-12,-1,-11
720575940620672704,right,L2,508,-5,11,10,1
720575940623441151,right,L2,509,-4,10,9,1
720575940614959628,right,L2,510,-2,11,7,4
720575940624798717,right,L2,511,5,-11,-11,0
720575940644892360,right,L2,512,6,0,-6,6
720575940628363602,right,L2,513,-4,-13,-3,-10
720575940631564306,right,L2,514,-4,-10,-1,-9
720575940614698034,right,L2,515,-8,-7,4,-11
720575940615918146,right,L2,516,7,-18,-16,-2
720575940621479918,right,L2,517,6,3,-5,8
720575940620490661,right,L2,518,-4,22,15,7
720575940626812560,right,L2,519,-5,-5,2,-7
720575940626813072,right,L2,520,-2,-22,-9,-13
720575940627511177,right,L2,521,6,-9,-11,2
720575940616222879,right,L2,522,-4,0,4,-4
720575940633448147,right,L2,523,2,14,5,9
720575940618231124,right,L2,524,4,-20,-14,-6
720575940608093106,right,L2,525,-1,-20,-9,-11
720575940645337454,right,L2,526,0,-10,-5,-5
720575940625101240,right,L2,527,-4,-8,0,-8
720575940620903662,right,L2,528,2,7,1,6
720575940620324774,right,L2,529,2,-2,-3,1
720575940621309349,right,L2,530,-3,-13,-4,-9
720575940624538662,right,L2,531,1,0,-1,1
720575940626097296,right,L2,532,-8,7,11,-4
720575940635833791,right,L2,533,0,-16,-8,-8
720575940609328853,right,L2,534,3,2,-2,4
720575940622728157,right,L2,535,8,-4,-10,6
720575940621089115,right,L2,536,3,4,-1,5
720575940618171878,right,L2,537,0,-23,-12,-11
720575940620223326,right,L2,538,-4,1,4,-3
720575940621391715,right,L2,539,-6,15,13,2
720575940624143821,right,L2,540,-2,-9,-3,-6
720575940639236836,right,L2,541,-4,14,11,3
720575940613354098,right,L2,542,6,-13,-13,0
720575940628644507,right,L2,543,-1,-4,-1,-3
720575940630159611,right,L2,544,3,-13,-10,-3
720575940607521458,right,L2,545,5,11,0,11
720575940621830220,right,L2,546,3,6,0,6
720575940621013185,right,L2,547,-1,21,11,10
720575940628032082,right,L2,548,1,-16,-9,-7
720575940626024496,right,L2,549,0,-9,-5,-4
720575940622005601,right,L2,550,-2,3,3,0
720575940647894068,right,L2,551,-4,-9,-1,-8
720575940613039530,right,L2,552,4,-1,-5,4
720575940629706343,right,L2,553,-3,16,11,5
720575940624459559,right,L2,554,-9,-3,7,-10
720575940605546208,right,L2,555,-4,9,8,1
720575940620740822,right,L2,556,0,10,5,5
720575940619330496,right,L2,557,6,-10,-11,1
720575940620907600,right,L2,558,-4,-21,-7,-14
720575940621907700,right,L2,559,-6,22,17,5
720575940608559964,right,L2,560,-7,14,14,0
720575940609131868,right,L2,561,5,7,-2,9
720575940620939979,right,L2,562,-5,-2,4,-6
720575940640108120,right,L2,563,5,-13,-12,-1
720575940620778587,right,L2,564,3,-23,-15,-8
720575940622963461,right,L2,565,0,-26,-13,-13
720575940614578538,right,L2,566,5,-8,-9,1
720575940620691538,right,L2,567,-2,22,13,9
720575940613558501,right,L2,568,-6,-8,2,-10
720575940625150285,right,L2,569,6,6,-3,9
720575940633170515,right,L2,570,2,25,10,15
720575940641169536,right,L2,571,0,-14,-7,-7
720575940653734049,right,L2,572,-8,3,9,-6
720575940612012714,right,L2,573,4,14,3,11
720575940624155829,right,L2,574,-6,5,8,-3
720575940653342966,right,L2,575,6,9,-2,11
720575940624052715,right,L2,576,0,28,14,14
720575940646592035,right,L2,577,5,-14,-12,-2
720575940652739062,right,L2,578,4,-11,-10,-1
720575940608822539,right,L2,579,-3,-10,-2,-8
720575940627131710,right,L2,580,-2,-23,-10,-13
720575940605871974,right,L2,581,3,9,1,8
720575940626997604,right,L2,582,-1,23,12,11
720575940645491748,right,L2,583,3,-25,-16,-9
720575940621601389,right,L2,584,4,23,7,16
720575940628770472,right,L2,585,-1,-23,-11,-12
720575940613623449,right,L2,586,2,18,7,11
720575940627335549,right,L2,587,4,22,7,15
720575940630863104,right,L2,588,1,4,1,3
720575940615679906,right,L2,589,-1,-5,-2,-3
720575940636562031,right,L2,590,1,9,3,6
720575940604910508,right,L2,591,3,-3,-5,2
720575940613232370,right,L2,592,3,-28,-17,-11
720575940630866681,right,L2,593,3,-14,-10,-4
720575940635565152,right,L2,594,7,-16,-15,-1
720575940623347336,right,L2,595,7,-12,-13,1
720575940632456463,right,L2,596,-4,-16,-4,-12
720575940617462233,right,L2,597,4,1,-4,5
720575940624314406,right,L2,598,2,-18,-11,-7
720575940637314405,right,L2,599,-1,9,5,4
720575940619065373,right,L2,600,3,-10,-8,-2
720575940622000054,right,L2,601,1,16,7,9
720575940644714275,right,L2,602,4,-2,-5,3
720575940637220494,right,L2,603,-3,-23,-9,-14
720575940634949567,right,L2,604,-6,-17,-3,-14
720575940612909226,right,L2,605,3,15,4,11
720575940628343685,right,L2,606,-1,-19,-9,-10
720575940628880646,right,L2,607,1,18,8,10
720575940620474673,right,L2,608,1,10,4,6
720575940655593889,right,L2,609,-2,0,2,-2
720575940618046465,right,L2,610,2,-23,-14,-9
720575940639824499,right,L2,611,-1,-18,-8,-10
720575940617199547,right,L2,612,-3,-26,-10,-16
720575940613511141,right,L2,613,-8,-4,6,-10
720575940614855464,right,L2,614,-2,-8,-2,-6
720575940622599685,right,L2,615,-7,-7,3,-10
720575940625514023,right,L2,616,-3,15,10,5
720575940620889803,right,L2,617,-2,-17,-7,-10
720575940629222087,right,L2,618,-1,24,13,11
720575940630195559,right,L2,619,-4,-19,-6,-13
720575940634435775,right,L2,620,7,1,-7,8
720575940620203870,right,L2,621,1,24,11,13
720575940620086277,right,L2,622,-5,20,15,5
720575940612708010,right,L2,623,1,13,5,8
720575940621409371,right,L2,624,1,-17,-10,-7
720575940621096813,right,L2,625,-2,24,14,10
720575940629466983,right,L2,626,-5,-8,1,-9
720575940610325038,right,L2,627,0,-1,-1,0
720575940640202557,right,L2,628,0,0,0,0
720575940623924429,right,L2,629,4,24,8,16
720575940626763210,right,L2,630,4,8,0,8
720575940620724306,right,L2,631,1,26,12,14
720575940632448616,right,L2,632,3,-20,-13,-7
720575940627830801,right,L2,633,-1,-24,-11,-13
720575940626003600,right,L2,634,-3,-15,-5,-10
720575940616589766,right,L2,635,6,-6,-9,3
720575940623073427,right,L2,636,0,6,3,3
720575940627416339,right,L2,637,3,-21,-14,-7
720575940647428643,right,L2,638,-1,7,4,3
720575940611206008,right,L2,639,-4,19,13,6
720575940635265699,right,L2,640,-1,-16,-7,-9
720575940613323762,right,L2,641,-8,-5,5,-10
720575940624991496,right,L2,642,-5,-11,-1,-10
720575940612959146,right,L2,643,6,14,1,13
720575940612198513,right,L2,644,-6,18,15,3
720575940624288136,right,L2,645,-4,27,17,10
720575940630281078,right,L2,646,6,17,2,15
720575940618449031,right,L2,647,-4,-7,0,-7
720575940633162567,right,L2,648,1,7,2,5
720575940621102677,right,L2,649,-1,5,3,2
720575940619786955,right,L2,650,-3,-25,-10,-15
720575940627828746,right,L2,651,-4,-5,1,-6
720575940628116392,right,L2,652,-6,-11,0,-11
720575940613372402,right,L2,653,-6,-12,0,-12
720575940622074790,right,L2,654,-3,8,7,1
720575940615446270,right,L2,655,6,-1,-7,6
720575940645401124,right,L2,656,0,-11,-6,-5
720575940635037358,right,L2,657,-2,-25,-11,-14
720575940624364952,right,L2,658,1,20,9,11
720575940627686226,right,L2,659,-4,-6,1,-7
720575940631085783,right,L2,660,2,28,12,16
720575940629396841,right,L2,661,-3,14,10,4
720575940611913170,right,L2,662,2,-1,-3,2
720575940606811657,right,L2,663,0,8,4,4
720575940621702497,right,L2,664,1,-27,-15,-12
720575940632988755,right,L2,665,7,-2,-8,6
720575940607227010,right,L2,666,7,-13,-14,1
720575940621195941,right,L2,667,1,-28,-15,-13
720575940615018402,right,L2,668,1,19,8,11
720575940625061117,right,L2,669,4,-16,-12,-4
720575940613070771,right,L2,670,5,5,-3,8
720575940622659798,right,L2,671,-4,-23,-8,-15
720575940624882108,right,L2,672,-8,11,13,-2
720575940605402284,right,L2,673,2,5,0,5
720575940637545038,right,L2,674,-4,-14,-3,-11
720575940625141029,right,L2,675,-7,19,16,3
720575940622329626,right,L2,676,-3,-21,-8,-13
720575940620734544,right,L2,677,0,11,5,6
720575940605091104,right,L2,678,3,-7,-7,0
720575940607219669,right,L2,679,4,18,5,13
720575940630516983,right,L2,680,-1,25,13,12
720575940635576160,right,L2,681,-2,-21,-9,-12
720575940624115859,right,L2,682,6,-8,-10,2
720575940622126945,right,L2,683,2,6,1,5
720575940618876317,right,L2,684,-6,17,14,3
720575940621250113,right,L2,685,-5,-9,0,-9
720575940622571269,right,L2,686,5,-22,-16,-6
720575940618068198,right,L2,687,-6,-3,4,-7
720575940624793673,right,L2,688,-7,10,12,-2
720575940623173921,right,L2,689,-2,18,11,7
720575940625274772,right,L2,690,-7,-3,5,-8
720575940638788585,right,L2,691,-9,4,11,-7
720575940621546066,right,L2,692,-4,24,16,8
720575940639429190,right,L2,693,-3,25,15,10
720575940635303319,right,L2,694,4,3,-3,6
720575940621645238,right,L2,695,-6,10,11,-1
720575940620491712,right,L2,696,-2,16,10,6
720575940615549250,right,L2,697,1,-22,-12,-10
720575940633611980,right,L2,698,6,-7,-10,3
720575940615805855,right,L2,699,-5,0,5,-5
720575940622787805,right,L2,700,5,15,2,13
720575940625120585,right,L2,701,0,-4,-2,-2
720575940607856818,right,L2,702,-5,23,16,7
720575940636065588,right,L2,703,-3,1,3,-2
720575940627265176,right,L2,704,-7,8,11,-3
720575940655871393,right,L2,705,1,1,-1,2
720575940620920429,right,L2,706,-7,-12,1,-13
720575940615444222,right,L2,707,-2,25,14,11
720575940640249934,right,L2,708,-4,-25,-9,-16
720575940634167833,right,L2,709,-2,-24,-10,-14
720575940630700281,right,L2,710,4,-25,-17,-8
720575940620941038,right,L2,711,-1,19,10,9
720575940626299710,right,L2,712,-7,12,13,-1
720575940613711894,right,L2,713,-6,16,14,2
720575940634024403,right,L2,714,5,12,1,11
720575940616865339,right,L2,715,4,10,1,9
720575940627304841,right,L2,716,4,-6,-7,1
720575940624868024,right,L2,717,2,-22,-13,-9
720575940624957529,right,L2,718,-5,24,17,7
720575940618654528,right,L2,719,1,27,12,15
720575940625864530,right,L2,720,-5,21,15,6
720575940638842345,right,L2,721,5,13,1,12
720575940612437454,right,L2,722,6,-15,-14,-1
720575940626950181,right,L2,723,-2,-11,-4,-7
720575940621705897,right,L2,724,4,2,-3,5
720575940637296013,right,L2,725,-3,-24,-9,-15
720575940608087474,right,L2,726,2,-28,-16,-12
720575940627383044,right,L2,727,7,6,-4,10
720575940606574210,right,L2,728,7,12,-1,13
720575940619948854,right,L2,729,-3,29,17,12
720575940623549661,right,L2,730,7,0,-7,7
720575940613935400,right,L2,731,-6,9,10,-1
720575940611568248,right,L2,732,-3,6,6,0
720575940628284426,right,L2,733,-5,-17,-4,-13
720575940628782185,right,L2,734,2,0,-2,2
720575940614807954,right,L2,735,1,-23,-13,-10
720575940625897404,right,L2,736,-8,1,8,-7
720575940633290321,right,L2,737,0,19,9,10
720575940627326978,right,L2,738,-3,13,9,4
720575940628915688,right,L2,739,-7,2,8,-6
720575940620264289,right,L2,740,2,-8,-6,-2
720575940628635409,right,L2,741,-2,-14,-5,-9
720575940645102372,right,L2,742,-4,11,9,2
720575940636123755,right,L2,743,6,-19,-16,-3
720575940629588752,right,L2,744,-4,25,16,9
720575940621093547,right,L2,745,0,13,6,7
720575940627715764,right,L2,746,-3,3,4,-1
720575940624135704,right,L2,747,0,2,1,1
720575940618274489,right,L2,748,-4,20,14,6
720575940630123351,right,L2,749,-2,1,2,-1
720575940623241727,right,L2,750,4,-24,-16,-8
720575940614200722,right,L2,751,1,6,2,4
720575940622173790,right,L2,752,-2,7,5,2
720575940611833208,right,L2,753,-3,24,15,9
720575940626091597,right,L2,754,-1,-13,-6,-7
720575940618313762,right,L2,755,4,19,5,14
720575940632454969,right,L2,756,5,20,5,15
720575940635091993,right,L2,757,0,-6,-3,-3
720575940630964540,right,L2,758,5,-1,-6,5
720575940628885251,right,L2,759,7,14,0,14
720575940615804817,right,L2,760,0,17,8,9
720575940623496486,right,L2,761,-4,-18,-5,-13
720575940625075453,right,L2,762,0,14,7,7
720575940613253874,right,L2,763,-5,14,12,2
720575940612998258,right,L2,764,-8,-6,5,-11
720575940633606052,right,L2,765,-3,9,7,2
720575940639648334,right,L2,766,2,-4,-4,0
720575940616827222,right,L2,767,1,28,13,15
720575940624227366,right,L2,768,3,5,-1,6
720575940648480388,right,L2,769,4,-27,-18,-9
720575940628223802,right,L2,770,5,4,-3,7
720575940609805269,right,L2,771,3,-27,-17,-10
720575940627747082,right,L2,772,1,12,5,7
720575940636098923,right,L2,773,5,-19,-15,-4
720575940637327686,right,L2,774,-8,6,11,-5
720575940628606026,right,L2,775,5,22,6,16
720575940618782021,right,L2,776,5,21,5,16
720575940617261910,right,L2,777,6,20,4,16
720575940618041830,right,L2,778,4,25,8,17
720575940630115454,right,L2,779,5,24,7,17
720575940629902608,right,L2,780,-6,25,18,7
720575940629916176,right,L2,781,-5,26,18,8
720575940625625236,right,L2,782,-5,27,18,9
720575940624382442,right,L2,783,-4,28,18,10
720575940659743105,right,L2,784,-4,29,18,11
720575940620857680,right,L2,787,3,28,11,17
720575940641317328,right,L2,788,3,27,10,17
720575940622016282,right,L2,789,-3,-27,-11,-16
720575940630229095,right,L2,790,-2,-27,-12,-15
720575940622390132,right,L2,791,-1,-28,-13,-15
720575940642058971,right,L2,792,8,2,-7,9
720575940621218881,right,L2,793,8,-6,-11,5
720575940622152948,right,L2,794,5,-26,-18,-8
720575940612105329,right,L2,795,6,-21,-17,-4
720575940631836503,right,L2,796,4,26,9,17
720575940628710933,right,L3,1,-6,13,12,1
720575940652492278,right,L3,2,-8,2,9,-7
720575940621560240,right,L3,3,6,-12,-12,0
720575940631599311,right,L3,4,-5,-21,-6,-15
720575940645807726,right,L3,5,-1,16,9,7
720575940620458305,right,L3,6,-2,-4,0,-4
720575940616280763,right,L3,7,-6,-6,3,-9
720575940635789943,right,L3,9,4,9,0,9
720575940621554864,right,L3,10,5,-15,-13,-2
720575940621648880,right,L3,11,7,-14,-14,0
720575940611279566,right,L3,12,-7,9,11,-2
720575940655977889,right,L3,14,0,-27,-14,-13
720575940617675961,right,L3,15,2,-3,-4,1
720575940626428615,right,L3,16,-2,-16,-6,-10
720575940634695520,right,L3,17,1,-5,-4,-1
720575940618772416,right,L3,18,5,-16,-13,-3
720575940638099689,right,L3,19,-7,17,15,2
720575940623638666,right,L3,20,3,-11,-9,-2
720575940628260368,right,L3,21,-2,19,11,8
720575940624446652,right,L3,22,-1,3,2,1
720575940622493769,right,L3,23,-3,-16,-5,-11
720575940617746105,right,L3,24,-1,-10,-4,-6
720575940638672454,right,L3,25,-9,3,10,-7
720575940628226310,right,L3,26,1,-3,-3,0
720575940627384709,right,L3,27,0,-25,-13,-12
720575940624388331,right,L3,28,5,6,-2,8
720575940618039197,right,L3,29,-1,-3,-1,-2
720575940628460785,right,L3,30,6,16,2,14
720575940611059012,right,L3,31,0,16,8,8
720575940643777844,right,L3,32,0,12,6,6
720575940640913571,right,L3,33,3,18,6,12
720575940616155458,right,L3,34,6,18,3,15
720575940617582941,right,L3,35,1,-24,-13,-11
720575940624256999,right,L3,36,6,8,-2,10
720575940634176537,right,L3,37,1,5,1,4
720575940626805604,right,L3,38,0,-2,-1,-1
720575940618871297,right,L3,39,0,20,10,10
720575940630470348,right,L3,41,-3,28,17,11
720575940620744430,right,L3,42,-1,14,8,6
720575940648528772,right,L3,43,-5,18,14,4
720575940631550539,right,L3,44,5,-10,-10,0
720575940609494741,right,L3,45,-5,-1,4,-5
720575940629899307,right,L3,47,-9,-1,8,-9
720575940622267370,right,L3,48,-4,-22,-7,-15
720575940622498889,right,L3,49,4,-4,-6,2
720575940623637981,right,L3,51,0,-19,-10,-9
720575940614643454,right,L3,52,-1,-22,-10,-12
720575940621445808,right,L3,53,5,14,2,12
720575940619679552,right,L3,54,-4,3,5,-2
720575940652603126,right,L3,55,-4,-11,-2,-9
720575940624121269,right,L3,56,1,-13,-8,-5
720575940627401561,right,L3,57,6,-11,-12,1
720575940623214861,right,L3,58,3,12,3,9
720575940632671336,right,L3,59,-2,2,3,-1
720575940618947230,right,L3,60,-8,8,12,-4
720575940615134870,right,L3,61,-4,-4,2,-6
720575940622516556,right,L3,62,0,-29,-15,-14
720575940618721364,right,L3,63,4,12,2,10
720575940617312729,right,L3,64,4,-23,-16,-7
720575940628661391,right,L3,66,2,15,5,10
720575940612452978,right,L3,67,-2,-13,-5,-8
720575940625337933,right,L3,68,3,16,5,11
720575940646005539,right,L3,69,1,8,3,5
720575940620608853,right,L3,70,-4,21,14,7
720575940625955646,right,L3,71,-2,-3,0,-3
720575940623234729,right,L3,72,0,-28,-14,-14
720575940627464329,right,L3,73,2,2,-1,3
720575940635247267,right,L3,74,-1,-9,-4,-5
720575940614289361,right,L3,76,-3,-4,1,-5
720575940620337799,right,L3,77,2,-5,-5,0
720575940624433300,right,L3,78,2,20,8,12
720575940646547235,right,L3,79,2,1,-2,3
720575940629535217,right,L3,80,4,13,2,11
720575940628486761,right,L3,81,6,-2,-7,5
720575940654887329,right,L3,82,-7,7,10,-3
720575940622678742,right,L3,83,2,-21,-13,-8
720575940629929039,right,L3,84,-2,12,8,4
720575940624255671,right,L3,85,4,-22,-15,-7
720575940627477050,right,L3,86,-5,-7,1,-8
720575940606158514,right,L3,87,1,11,4,7
720575940624276405,right,L3,89,1,-19,-11,-8
720575940622108225,right,L3,90,-4,5,6,-1
720575940630243252,right,L3,91,-1,6,4,2
720575940621161933,right,L3,92,0,9,4,5
720575940624298643,right,L3,94,5,18,4,14
720575940637046903,right,L3,95,4,-21,-15,-6
720575940632640312,right,L3,96,1,-10,-6,-4
720575940635567979,right,L3,97,-5,2,6,-4
720575940627662138,right,L3,98,-1,-12,-5,-7
720575940626024122,right,L3,99,4,15,3,12
720575940634730521,right,L3,100,2,-10,-7,-3
720575940626672906,right,L3,101,-7,6,10,-4
720575940626376188,right,L3,102,3,13,3,10
720575940628258833,right,L3,103,7,9,-3,12
720575940632433100,right,L3,105,3,22,8,14
720575940632700243,right,L3,106,-7,11,12,-1
720575940622189948,right,L3,107,8,-2,-9,7
720575940631206967,right,L3,108,-3,-12,-3,-9
720575940620332167,right,L3,109,4,-5,-7,2
720575940628044154,right,L3,110,-7,0,7,-7
720575940622578526,right,L3,111,2,-24,-14,-10
720575940630218358,right,L3,114,2,-13,-9,-4
720575940614911394,right,L3,116,-1,-8,-3,-5
720575940608163849,right,L3,118,3,1,-3,4
720575940632452626,right,L3,119,-2,6,5,1
720575940646632324,right,L3,120,-1,-1,0,-1
720575940623227016,right,L3,121,-8,4,10,-6
720575940615883067,right,L3,123,-8,10,13,-3
720575940632029241,right,L3,124,1,-7,-5,-2
720575940620059631,right,L3,125,5,9,-1,10
720575940628460548,right,L3,126,3,11,2,9
720575940610708600,right,L3,127,0,15,7,8
720575940624561589,right,L3,128,3,-22,-14,-8
720575940645127447,right,L3,129,0,-13,-7,-6
720575940626863229,right,L3,130,2,12,4,8
720575940630434048,right,L3,131,-6,20,16,4
720575940623140755,right,L3,132,2,4,0,4
720575940627179786,right,L3,133,-3,20,13,7
720575940621267316,right,L3,134,-5,-18,-4,-14
720575940638136154,right,L3,135,-3,-22,-8,-14
720575940620629697,right,L3,136,0,3,1,2
720575940611493347,right,L3,137,5,-7,-9,2
720575940624229629,right,L3,138,0,27,13,14
720575940630131706,right,L3,139,1,-14,-8,-6
720575940609896405,right,L3,140,3,8,1,7
720575940618170949,right,L3,141,5,-23,-17,-6
720575940612374737,right,L3,142,-2,-18,-7,-11
720575940622203312,right,L3,143,-4,16,12,4
720575940614567917,right,L3,144,7,-11,-13,2
720575940622614277,right,L3,145,0,4,2,2
720575940647662388,right,L3,146,1,-6,-4,-2
720575940655612833,right,L3,147,1,21,9,12
720575940620364965,right,L3,149,6,-14,-13,-1
720575940612010865,right,L3,150,-8,5,10,-5
720575940642421493,right,L3,151,-3,-14,-4,-10
720575940627997592,right,L3,152,3,-15,-11,-4
720575940616070250,right,L3,153,8,0,-8,8
720575940624649452,right,L3,154,-8,0,8,-8
720575940643548468,right,L3,155,-8,13,14,-1
720575940634270931,right,L3,156,-9,1,9,-8
720575940626630658,right,L3,157,-1,-7,-3,-4
720575940639398453,right,L3,158,3,-5,-6,1
720575940624291464,right,L3,159,7,7,-4,11
720575940615699306,right,L3,162,-4,-2,3,-5
720575940615065922,right,L3,163,-9,7,12,-5
720575940623677993,right,L3,164,-1,-2,0,-2
720575940630983767,right,L3,165,4,16,4,12
720575940653540513,right,L3,166,0,18,9,9
720575940624218549,right,L3,167,0,-17,-9,-8
720575940626005136,right,L3,168,-1,17,9,8
720575940623583882,right,L3,169,0,-18,-9,-9
720575940616967180,right,L3,170,-5,1,5,-4
720575940618038612,right,L3,171,6,-20,-16,-4
720575940652489718,right,L3,172,1,22,10,12
720575940624107460,right,L3,173,2,-25,-15,-10
720575940613304291,right,L3,174,4,-15,-12,-3
720575940627318794,right,L3,175,-6,-7,2,-9
720575940631433027,right,L3,176,-2,13,8,5
720575940611260821,right,L3,177,-2,-1,1,-2
720575940627855000,right,L3,178,2,11,3,8
720575940636440677,right,L3,179,-5,-16,-3,-13
720575940646108014,right,L3,180,2,-27,-16,-11
720575940620910612,right,L3,181,1,-4,-3,-1
720575940621793371,right,L3,182,7,-10,-12,2
720575940628597135,right,L3,183,-5,-15,-3,-12
720575940629357415,right,L3,184,-6,-5,3,-8
720575940624486909,right,L3,185,2,-11,-8,-3
720575940619081198,right,L3,186,-1,26,14,12
720575940614103347,right,L3,187,3,21,7,14
720575940612771697,right,L3,188,-5,17,13,4
720575940633437357,right,L3,189,6,13,0,13
720575940613646545,right,L3,190,-3,-5,0,-5
720575940630154999,right,L3,191,-1,-11,-5,-6
720575940633926573,right,L3,192,7,10,-2,12
720575940627746393,right,L3,193,-5,4,7,-3
720575940605273772,right,L3,194,0,-5,-3,-2
720575940628179196,right,L3,195,-3,-1,2,-3
720575940620637776,right,L3,196,-1,8,5,3
720575940605268140,right,L3,197,0,-20,-10,-10
720575940617409083,right,L3,198,6,2,-5,7
720575940627544658,right,L3,199,0,-12,-6,-6
720575940626081724,right,L3,200,-5,12,11,1
720575940625971642,right,L3,201,-8,9,12,-3
720575940621925364,right,L3,202,-1,27,14,13
720575940628082793,right,L3,203,3,-1,-4,3
720575940619345221,right,L3,204,5,-2,-6,4
720575940613032598,right,L3,205,5,-6,-8,2
720575940625104904,right,L3,207,1,29,13,16
720575940631509753,right,L3,208,5,-21,-16,-5
720575940635270751,right,L3,209,-3,-8,-1,-7
720575940625858803,right,L3,210,-6,8,10,-2
720575940613032854,right,L3,211,-7,-1,6,-7
720575940660107649,right,L3,212,2,-16,-10,-6
720575940631570007,right,L3,213,3,-4,-5,1
720575940605762528,right,L3,214,-5,3,6,-3
720575940620903760,right,L3,215,6,7,-3,10
720575940621371574,right,L3,216,2,19,7,12
720575940621955354,right,L3,217,6,15,1,14
720575940606608002,right,L3,218,2,10,3,7
720575940624208391,right,L3,219,6,-4,-8,4
720575940624874727,right,L3,220,2,-6,-5,-1
720575940646073879,right,L3,221,-7,3,8,-5
720575940624222472,right,L3,222,-3,26,16,10
720575940639184701,right,L3,223,-2,26,15,11
720575940619152549,right,L3,225,2,-26,-15,-11
720575940629009155,right,L3,226,5,19,4,15
720575940630100839,right,L3,227,-7,5,9,-4
720575940614680210,right,L3,229,5,2,-4,6
720575940625849232,right,L3,230,2,9,2,7
720575940615141782,right,L3,231,4,-12,-10,-2
720575940626915715,right,L3,232,-4,13,10,3
720575940624194707,right,L3,233,4,-13,-11,-2
720575940613189994,right,L3,235,4,11,1,10
720575940634102241,right,L3,236,-1,4,3,1
720575940644030920,right,L3,237,-2,27,15,12
720575940609607435,right,L3,238,-8,-3,6,-9
720575940626985554,right,L3,239,-6,6,9,-3
720575940610609362,right,L3,240,-4,-3,2,-5
720575940647422596,right,L3,241,2,-17,-11,-6
720575940620724417,right,L3,243,-1,-21,-10,-11
720575940623331208,right,L3,244,-4,-12,-2,-10
720575940633989995,right,L3,245,-5,-3,3,-6
720575940628084873,right,L3,246,-4,15,11,4
720575940613909544,right,L3,247,-4,-15,-4,-11
720575940635283903,right,L3,248,-6,0,6,-6
720575940613776365,right,L3,249,2,-12,-8,-4
720575940622472959,right,L3,250,-1,1,1,0
720575940622986535,right,L3,251,-1,-14,-6,-8
720575940626934141,right,L3,252,3,23,8,15
720575940618985541,right,L3,253,5,16,3,13
720575940627870345,right,L3,254,3,-24,-15,-9
720575940613538223,right,L3,255,-6,-13,-1,-12
720575940622733277,right,L3,256,5,-20,-15,-5
720575940608906179,right,L3,257,2,21,8,13
720575940623589770,right,L3,258,-4,-17,-5,-12
720575940628661135,right,L3,259,-7,-5,4,-9
720575940612399822,right,L3,260,-3,19,12,7
720575940627823381,right,L3,261,-1,13,7,6
720575940632981293,right,L3,262,1,-11,-7,-4
720575940628128649,right,L3,263,-3,4,5,-1
720575940625062653,right,L3,264,-1,-6,-2,-4
720575940621985520,right,L3,266,-1,-25,-12,-13
720575940656012193,right,L3,267,-6,2,7,-5
720575940632902739,right,L3,268,7,-6,-10,4
720575940631144143,right,L3,269,2,-19,-12,-7
720575940626690704,right,L3,270,1,-8,-5,-3
720575940618961624,right,L3,271,4,6,-1,7
720575940608509276,right,L3,272,3,-2,-4,2
720575940617373585,right,L3,273,-6,23,17,6
720575940626788144,right,L3,274,6,4,-4,8
720575940631499562,right,L3,275,-8,-1,7,-8
720575940646916404,right,L3,276,2,3,-1,4
720575940613684205,right,L3,277,7,-3,-9,6
720575940609905476,right,L3,278,-5,10,10,0
720575940645569572,right,L3,279,-4,8,8,0
720575940631095095,right,L3,280,-6,-14,-1,-13
720575940627160339,right,L3,281,-9,2,10,-8
720575940622275542,right,L3,282,0,26,13,13
720575940621676422,right,L3,284,0,25,12,13
720575940615681938,right,L3,285,6,-18,-15,-3
720575940622502388,right,L3,286,0,-24,-12,-12
720575940661118593,right,L3,287,-5,13,11,2
720575940621062474,right,L3,289,-1,11,6,5
720575940605686462,right,L3,290,5,-24,-17,-7
720575940616318988,right,L3,291,7,2,-6,8
720575940613378986,right,L3,292,-4,18,13,5
720575940638570974,right,L3,293,4,-17,-13,-4
720575940623543187,right,L3,294,1,-20,-11,-9
720575940622384041,right,L3,296,1,-18,-10,-8
720575940609391113,right,L3,297,7,-9,-12,3
720575940633646637,right,L3,298,-5,5,7,-2
720575940628964849,right,L3,299,-4,12,10,2
720575940628289413,right,L3,300,4,-18,-13,-5
720575940621670127,right,L3,301,-5,16,13,3
720575940639291718,right,L3,302,2,17,6,11
720575940608597084,right,L3,303,-5,22,16,6
720575940606034092,right,L3,304,6,5,-4,9
720575940606586982,right,L3,305,-7,4,9,-5
720575940622485748,right,L3,306,3,7,0,7
720575940632229930,right,L3,307,5,-25,-18,-7
720575940623009050,right,L3,308,-5,8,9,-1
720575940613818134,right,L3,309,-6,12,12,0
720575940627206915,right,L3,310,2,22,9,13
720575940610692676,right,L3,311,-7,15,14,1
720575940616803513,right,L3,312,4,-7,-8,1
720575940626856336,right,L3,313,7,3,-6,9
720575940642277773,right,L3,314,-9,5,11,-6
720575940638490714,right,L3,315,-3,-6,0,-6
720575940622702344,right,L3,316,5,-4,-7,3
720575940628870782,right,L3,317,-5,-4,3,-7
720575940625113068,right,L3,318,4,-19,-14,-5
720575940627019326,right,L3,319,-2,5,4,1
720575940639895203,right,L3,320,-2,-5,-1,-4
720575940616218015,right,L3,322,2,26,11,15
720575940636720558,right,L3,323,-7,-13,0,-13
720575940627685397,right,L3,324,3,24,9,15
720575940607638723,right,L3,325,5,1,-5,6
720575940617748881,right,L3,326,2,16,6,10
720575940635116313,right,L3,327,5,3,-4,7
720575940623666835,right,L3,328,5,-9,-10,1
720575940654764961,right,L3,329,0,24,12,12
720575940616406284,right,L3,330,3,3,-2,5
720575940624105098,right,L3,331,1,-15,-9,-6
720575940621563713,right,L3,332,4,-26,-17,-9
720575940608387442,right,L3,333,0,-21,-11,-10
720575940614277357,right,L3,334,1,-26,-14,-12
720575940618324037,right,L3,335,2,8,2,6
720575940614219518,right,L3,336,0,23,11,12
720575940636583269,right,L3,337,-5,-6,2,-8
720575940627416552,right,L3,338,-1,0,1,-1
720575940641713909,right,L3,339,6,11,-1,12
720575940632065231,right,L3,341,6,-17,-15,-2
720575940627937301,right,L3,342,2,-15,-10,-5
720575940616798732,right,L3,343,-3,27,16,11
720575940613680194,right,L3,344,-2,-15,-6,-9
720575940625492301,right,L3,345,3,-12,-9,-3
720575940630503639,right,L3,346,-7,-9,2,-11
720575940624748948,right,L3,347,-5,-13,-2,-11
720575940623125577,right,L3,348,3,14,4,10
720575940628324112,right,L3,349,-5,-14,-2,-12
720575940612306867,right,L3,350,1,15,6,9
720575940625217294,right,L3,351,-1,-17,-8,-9
720575940627785605,right,L3,352,-2,28,16,12
720575940627832263,right,L3,353,2,24,10,14
720575940628819459,right,L3,354,-2,-26,-11,-15
720575940623294088,right,L3,355,-7,-6,4,-10
720575940622761949,right,L3,356,0,22,11,11
720575940622515839,right,L3,357,4,17,4,13
720575940627935058,right,L3,358,-3,17,11,6
720575940637615838,right,L3,359,2,23,9,14
720575940612075618,right,L3,360,-5,19,14,5
720575940628058440,right,L3,361,0,-7,-4,-3
720575940652611062,right,L3,362,2,-20,-12,-8
720575940620492880,right,L3,363,7,-4,-9,5
720575940614307299,right,L3,364,4,4,-2,6
720575940633023202,right,L3,365,4,7,-1,8
720575940626919623,right,L3,366,-5,-20,-5,-15
720575940632172113,right,L3,367,-6,-15,-2,-13
720575940624585959,right,L3,368,-4,-20,-6,-14
720575940623804157,right,L3,369,5,-5,-8,3
720575940626546992,right,L3,370,-3,21,13,8
720575940635314795,right,L3,371,6,-5,-9,4
720575940628246088,right,L3,372,1,-2,-2,0
720575940616570299,right,L3,373,1,-21,-12,-9
720575940633382752,right,L3,374,2,13,4,9
720575940629070747,right,L3,375,-6,7,9,-2
720575940632334127,right,L3,376,-7,-10,2,-12
720575940618140699,right,L3,377,0,7,3,4
720575940628323461,right,L3,378,-3,18,12,6
720575940612487630,right,L3,379,3,-17,-12,-5
720575940622352972,right,L3,381,-8,-9,3,-12
720575940605586622,right,L3,382,3,-6,-6,0
720575940634444439,right,L3,384,-6,-2,5,-7
720575940623379592,right,L3,385,-3,-18,-6,-12
720575940640653144,right,L3,386,-6,19,15,4
720575940632397327,right,L3,387,-1,-15,-7,-8
720575940624264009,right,L3,388,3,19,6,13
720575940627577105,right,L3,389,-6,-16,-2,-14
720575940632178316,right,L3,390,-6,-9,1,-10
720575940612715175,right,L3,391,4,-3,-6,3
720575940610664601,right,L3,392,-4,7,7,0
720575940630975313,right,L3,393,-1,22,12,10
720575940618294744,right,L3,394,-7,-8,3,-11
720575940627328018,right,L3,395,0,-22,-11,-11
720575940620103558,right,L3,396,-1,10,6,4
720575940621345857,right,L3,397,-3,-19,-7,-12
720575940630499319,right,L3,398,-3,22,14,8
720575940617720550,right,L3,399,-4,-24,-8,-16
720575940632400971,right,L3,400,1,-29,-16,-13
720575940624496969,right,L3,401,-2,-19,-8,-11
720575940631712331,right,L3,402,3,26,10,16
720575940607392898,right,L3,403,-2,-12,-4,-8
720575940619123483,right,L3,404,-1,20,11,9
720575940612580761,right,L3,405,3,10,2,8
720575940625032947,right,L3,406,1,-25,-14,-11
720575940621396718,right,L3,407,-5,-10,0,-10
720575940646990388,right,L3,408,-6,-4,4,-8
720575940621766260,right,L3,409,0,-3,-2,-1
720575940607284610,right,L3,410,-2,-2,1,-3
720575940614442658,right,L3,411,-5,-19,-5,-14
720575940609928971,right,L3,412,-6,21,16,5
720575940625539082,right,L3,414,4,21,6,15
720575940621397089,right,L3,415,6,12,0,12
720575940626822960,right,L3,416,3,-8,-7,-1
720575940611525582,right,L3,417,-6,-10,1,-11
720575940637114743,right,L3,418,-2,15,9,6
720575940626427847,right,L3,419,-3,-11,-3,-8
720575940615507167,right,L3,420,6,-3,-8,5
720575940645381742,right,L3,423,3,-18,-12,-6
720575940629869059,right,L3,424,-3,-2,2,-4
720575940629426475,right,L3,425,3,20,7,13
720575940623586756,right,L3,426,-3,0,3,-3
720575940626784152,right,L3,427,5,-18,-14,-4
720575940634267548,right,L3,428,-2,23,13,10
720575940627905566,right,L3,429,-2,14,9,5
720575940607963826,right,L3,430,-3,-7,-1,-6
720575940625865008,right,L3,431,-2,-10,-3,-7
720575940620517803,right,L3,432,-5,7,8,-1
720575940609411849,right,L3,433,0,-8,-4,-4
720575940619982238,right,L3,434,-3,7,6,1
720575940617304379,right,L3,435,5,-17,-14,-3
720575940625484621,right,L3,436,0,-15,-8,-7
720575940623277667,right,L3,437,-3,12,9,3
720575940622475248,right,L3,438,2,27,11,16
720575940660346241,right,L3,439,-3,-9,-2,-7
720575940620584721,right,L3,440,1,23,10,13
720575940615151446,right,L3,441,3,-16,-11,-5
720575940632815917,right,L3,442,-5,25,17,8
720575940619300766,right,L3,444,4,-10,-9,-1
720575940636721775,right,L3,445,-2,8,6,2
720575940634132380,right,L3,446,2,-14,-9,-5
720575940626136862,right,L3,447,-1,2,2,0
720575940629916571,right,L3,448,0,30,15,15
720575940620271239,right,L3,449,6,-16,-14,-2
720575940628535083,right,L3,450,2,-9,-7,-2
720575940630998359,right,L3,451,4,20,6,14
720575940624142118,right,L3,452,1,-9,-6,-3
720575940629019398,right,L3,453,3,25,9,16
720575940660377729,right,L3,454,5,-12,-11,-1
720575940606095462,right,L3,455,7,-7,-11,4
720575940631477315,right,L3,456,0,21,10,11
720575940641045888,right,L3,457,-2,17,10,7
720575940628167305,right,L3,458,5,0,-5,5
720575940617128593,right,L3,459,5,-3,-7,4
720575940622119518,right,L3,460,-3,-20,-7,-13
720575940647188532,right,L3,461,7,-5,-10,5
720575940624109704,right,L3,462,-1,18,10,8
720575940607648178,right,L3,463,5,17,3,14
720575940631393554,right,L3,464,4,0,-4,4
720575940637494494,right,L3,465,3,0,-3,3
720575940633656365,right,L3,466,1,14,6,8
720575940625624869,right,L3,467,-2,-20,-8,-12
720575940613847249,right,L3,470,4,-9,-9,0
720575940638682458,right,L3,471,3,-26,-16,-10
720575940626974986,right,L3,472,1,25,11,14
720575940610535410,right,L3,473,-4,23,15,8
720575940625021683,right,L3,474,-3,-17,-6,-11
720575940642551515,right,L3,475,-4,-1,3,-4
720575940621155905,right,L3,476,-1,15,8,7
720575940635962559,right,L3,479,-2,10,7,3
720575940618194617,right,L3,480,3,-19,-13,-6
720575940618173341,right,L3,481,4,-8,-8,0
720575940611377926,right,L3,482,1,17,7,10
720575940628533351,right,L3,483,2,-7,-6,-1
720575940612871338,right,L3,484,3,-9,-8,-1
720575940639378485,right,L3,485,-3,-3,1,-4
720575940622672349,right,L3,486,0,1,0,1
720575940620369243,right,L3,487,1,-1,-2,1
720575940618964052,right,L3,488,7,5,-5,10
720575940632495585,right,L3,490,-5,6,8,-2
720575940625539111,right,L3,491,7,-1,-8,7
720575940626035789,right,L3,492,-7,-2,6,-8
720575940633306323,right,L3,493,-3,23,14,9
720575940620752464,right,L3,495,4,5,-2,7
720575940616093599,right,L3,496,7,8,-3,11
720575940635254367,right,L3,497,6,1,-6,7
720575940615402463,right,L3,498,6,10,-1,11
720575940616075570,right,L3,499,5,10,0,10
720575940610814414,right,L3,500,7,-8,-11,3
720575940628534549,right,L3,501,1,2,0,2
720575940624765959,right,L3,502,5,8,-1,9
720575940642382477,right,L3,503,3,17,5,12
720575940612345038,right,L3,504,-2,9,6,3
720575940623162623,right,L3,505,6,-22,-17,-5
720575940635674872,right,L3,506,1,-12,-7,-5
720575940618069531,right,L3,507,-5,-12,-1,-11
720575940630746220,right,L3,508,-5,11,10,1
720575940623392904,right,L3,509,-4,10,9,1
720575940644478880,right,L3,510,-2,11,7,4
720575940631885895,right,L3,511,5,-11,-11,0
720575940621925108,right,L3,512,6,0,-6,6
720575940623557815,right,L3,513,-4,-13,-3,-10
720575940623375692,right,L3,514,-4,-10,-1,-9
720575940632547615,right,L3,515,-8,-7,4,-11
720575940643709344,right,L3,516,7,-18,-16,-2
720575940612875121,right,L3,518,-4,22,15,7
720575940622591446,right,L3,519,-5,-5,2,-7
720575940629579851,right,L3,520,-2,-22,-9,-13
720575940629973698,right,L3,521,6,-9,-11,2
720575940625365996,right,L3,522,-4,0,4,-4
720575940619047169,right,L3,523,2,14,5,9
720575940623559175,right,L3,524,4,-20,-14,-6
720575940628566858,right,L3,525,-1,-20,-9,-11
720575940637251502,right,L3,526,0,-10,-5,-5
720575940647063428,right,L3,527,-4,-8,0,-8
720575940627966218,right,L3,528,2,7,1,6
720575940636654254,right,L3,529,2,-2,-3,1
720575940617360955,right,L3,530,-3,-13,-4,-9
720575940616798813,right,L3,531,1,0,-1,1
720575940627966333,right,L3,532,-8,7,11,-4
720575940625028536,right,L3,533,0,-16,-8,-8
720575940623568324,right,L3,534,3,2,-2,4
720575940614901098,right,L3,535,8,-4,-10,6
720575940621891617,right,L3,536,3,4,-1,5
720575940633470116,right,L3,537,0,-23,-12,-11
720575940606489702,right,L3,538,-4,1,4,-3
720575940616543291,right,L3,540,-2,-9,-3,-6
720575940638926938,right,L3,541,-4,14,11,3
720575940612464882,right,L3,542,6,-13,-13,0
720575940613087766,right,L3,543,-1,-4,-1,-3
720575940639028058,right,L3,544,3,-13,-10,-3
720575940621943557,right,L3,545,5,11,0,11
720575940621113584,right,L3,546,3,6,0,6
720575940621789445,right,L3,548,1,-16,-9,-7
720575940632409903,right,L3,549,0,-9,-5,-4
720575940615983846,right,L3,550,-2,3,3,0
720575940627979909,right,L3,551,-4,-9,-1,-8
720575940644276424,right,L3,552,4,-1,-5,4
720575940621838830,right,L3,553,-3,16,11,5
720575940632958946,right,L3,555,-4,9,8,1
720575940630299855,right,L3,556,0,10,5,5
720575940639182313,right,L3,557,6,-10,-11,1
720575940635138723,right,L3,558,-4,-21,-7,-14
720575940633263277,right,L3,559,-6,22,17,5
720575940640211571,right,L3,560,-7,14,14,0
720575940630516862,right,L3,561,5,7,-2,9
720575940629937516,right,L3,562,-5,-2,4,-6
720575940625992496,right,L3,563,5,-13,-12,-1
720575940635653812,right,L3,564,3,-23,-15,-8
720575940632740127,right,L3,565,0,-26,-13,-13
720575940628068546,right,L3,566,5,-8,-9,1
720575940619992240,right,L3,568,-6,-8,2,-10
720575940625972668,right,L3,569,6,6,-3,9
720575940631324175,right,L3,570,2,25,10,15
720575940615125910,right,L3,571,0,-14,-7,-7
720575940631467001,right,L3,572,-8,3,9,-6
720575940623327231,right,L3,573,4,14,3,11
720575940623057386,right,L3,575,6,9,-2,11
720575940634161634,right,L3,576,0,28,14,14
720575940618028545,right,L3,577,5,-14,-12,-2
720575940632777420,right,L3,578,4,-11,-10,-1
720575940611576526,right,L3,579,-3,-10,-2,-8
720575940604889568,right,L3,580,-2,-23,-10,-13
720575940621320052,right,L3,581,3,9,1,8
720575940645487127,right,L3,582,-1,23,12,11
720575940613915567,right,L3,583,3,-25,-16,-9
720575940626380730,right,L3,584,4,23,7,16
720575940622338428,right,L3,585,-1,-23,-11,-12
720575940627406930,right,L3,586,2,18,7,11
720575940612083057,right,L3,587,4,22,7,15
720575940620343175,right,L3,589,-1,-5,-2,-3
720575940612502514,right,L3,591,3,-3,-5,2
720575940625309116,right,L3,594,7,-16,-15,-1
720575940622411340,right,L3,595,7,-12,-13,1
720575940621765620,right,L3,596,-4,-16,-4,-12
720575940628627456,right,L3,597,4,1,-4,5
720575940626348350,right,L3,598,2,-18,-11,-7
720575940636987767,right,L3,600,3,-10,-8,-2
720575940629379834,right,L3,601,1,16,7,9
720575940621004885,right,L3,602,4,-2,-5,3
720575940624809480,right,L3,603,-3,-23,-9,-14
720575940623007159,right,L3,604,-6,-17,-3,-14
720575940621502068,right,L3,605,3,15,4,11
720575940608846275,right,L3,606,-1,-19,-9,-10
720575940617184315,right,L3,607,1,18,8,10
720575940638541278,right,L3,608,1,10,4,6
720575940620206529,right,L3,609,-2,0,2,-2
720575940645156631,right,L3,610,2,-23,-14,-9
720575940624158903,right,L3,611,-1,-18,-8,-10
720575940617363673,right,L3,612,-3,-26,-10,-16
720575940605345410,right,L3,614,-2,-8,-2,-6
720575940623297318,right,L3,615,-7,-7,3,-10
720575940612717461,right,L3,616,-3,15,10,5
720575940621543028,right,L3,617,-2,-17,-7,-10
720575940620692562,right,L3,618,-1,24,13,11
720575940608684811,right,L3,619,-4,-19,-6,-13
720575940623428829,right,L3,620,7,1,-7,8
720575940620804434,right,L3,621,1,24,11,13
720575940619076987,right,L3,622,-5,20,15,5
720575940641257973,right,L3,623,1,13,5,8
720575940623511532,right,L3,624,1,-17,-10,-7
720575940638336326,right,L3,625,-2,24,14,10
720575940631378959,right,L3,626,-5,-8,1,-9
720575940644772900,right,L3,627,0,-1,-1,0
720575940633084499,right,L3,629,4,24,8,16
720575940639213631,right,L3,630,4,8,0,8
720575940627055749,right,L3,631,1,26,12,14
720575940660306305,right,L3,632,3,-20,-13,-7
720575940618324697,right,L3,633,-1,-24,-11,-13
720575940631130850,right,L3,634,-3,-15,-5,-10
720575940619082478,right,L3,635,6,-6,-9,3
720575940618375569,right,L3,636,0,6,3,3
720575940649887609,right,L3,637,3,-21,-14,-7
720575940641780621,right,L3,638,-1,7,4,3
720575940628077640,right,L3,640,-1,-16,-7,-9
720575940630066176,right,L3,641,-8,-5,5,-10
720575940631602447,right,L3,642,-5,-11,-1,-10
720575940617811293,right,L3,643,6,14,1,13
720575940629064188,right,L3,644,-6,18,15,3
720575940628760848,right,L3,645,-4,27,17,10
720575940630295034,right,L3,646,6,17,2,15
720575940626914960,right,L3,647,-4,-7,0,-7
720575940619012510,right,L3,648,1,7,2,5
720575940627846404,right,L3,649,-1,5,3,2
720575940620199444,right,L3,650,-3,-25,-10,-15
720575940632306962,right,L3,651,-4,-5,1,-6
720575940620706543,right,L3,652,-6,-11,0,-11
720575940628323856,right,L3,653,-6,-12,0,-12
720575940606554558,right,L3,654,-3,8,7,1
720575940614172847,right,L3,655,6,-1,-7,6
720575940609738435,right,L3,656,0,-11,-6,-5
720575940622591709,right,L3,657,-2,-25,-11,-14
720575940640540112,right,L3,658,1,20,9,11
720575940623881924,right,L3,659,-4,-6,1,-7
720575940642079477,right,L3,660,2,28,12,16
720575940619137819,right,L3,661,-3,14,10,4
720575940622779998,right,L3,662,2,-1,-3,2
720575940636935494,right,L3,663,0,8,4,4
720575940615981206,right,L3,664,1,-27,-15,-12
720575940614234258,right,L3,665,7,-2,-8,6
720575940637029744,right,L3,666,7,-13,-14,1
720575940627201380,right,L3,667,1,-28,-15,-13
720575940625315709,right,L3,668,1,19,8,11
720575940635295083,right,L3,669,4,-16,-12,-4
720575940620235456,right,L3,670,5,5,-3,8
720575940630204286,right,L3,671,-4,-23,-8,-15
720575940618919003,right,L3,672,-8,11,13,-2
720575940610839620,right,L3,673,2,5,0,5
720575940633603680,right,L3,674,-4,-14,-3,-11
720575940621265780,right,L3,675,-7,19,16,3
720575940615693218,right,L3,676,-3,-21,-8,-13
720575940636090223,right,L3,677,0,11,5,6
720575940635757560,right,L3,678,3,-7,-7,0
720575940626613178,right,L3,679,4,18,5,13
720575940633385043,right,L3,680,-1,25,13,12
720575940629436519,right,L3,681,-2,-21,-9,-12
720575940630545367,right,L3,682,6,-8,-10,2
720575940617655014,right,L3,683,2,6,1,5
720575940635195804,right,L3,684,-6,17,14,3
720575940644150324,right,L3,685,-5,-9,0,-9
720575940635260511,right,L3,686,5,-22,-16,-6
720575940615151190,right,L3,687,-6,-3,4,-7
720575940623830822,right,L3,688,-7,10,12,-2
720575940617994811,right,L3,689,-2,18,11,7
720575940623799699,right,L3,690,-7,-3,5,-8
720575940631325497,right,L3,691,-9,4,11,-7
720575940631869783,right,L3,692,-4,24,16,8
720575940625408048,right,L3,693,-3,25,15,10
720575940628575631,right,L3,694,4,3,-3,6
720575940606723164,right,L3,695,-6,10,11,-1
720575940618936221,right,L3,696,-2,16,10,6
720575940617027909,right,L3,697,1,-22,-12,-10
720575940631403023,right,L3,698,6,-7,-10,3
720575940644067232,right,L3,700,5,15,2,13
720575940626387044,right,L3,701,0,-4,-2,-2
720575940640429008,right,L3,702,-5,23,16,7
720575940605763040,right,L3,703,-3,1,3,-2
720575940613154739,right,L3,704,-7,8,11,-3
720575940623494438,right,L3,705,1,1,-1,2
720575940611667349,right,L3,707,-2,25,14,11
720575940647354659,right,L3,708,-4,-25,-9,-16
720575940635046574,right,L3,709,-2,-24,-10,-14
720575940617222237,right,L3,710,4,-25,-17,-8
720575940608573707,right,L3,711,-1,19,10,9
720575940624961806,right,L3,712,-7,12,13,-1
720575940619667732,right,L3,713,-6,16,14,2
720575940627220099,right,L3,714,5,12,1,11
720575940614020527,right,L3,715,4,10,1,9
720575940627317002,right,L3,716,4,-6,-7,1
720575940623097121,right,L3,717,2,-22,-13,-9
720575940617653204,right,L3,718,-5,24,17,7
720575940633877293,right,L3,719,1,27,12,15
720575940615323857,right,L3,720,-5,21,15,6
720575940650823289,right,L3,721,5,13,1,12
720575940619625118,right,L3,722,6,-15,-14,-1
720575940634222873,right,L3,723,-2,-11,-4,-7
720575940622674189,right,L3,724,4,2,-3,5
720575940632590540,right,L3,725,-3,-24,-9,-15
720575940611628498,right,L3,726,2,-28,-16,-12
720575940612898417,right,L3,727,7,6,-4,10
720575940626009893,right,L3,728,7,12,-1,13
720575940612289890,right,L3,730,7,0,-7,7
720575940625442960,right,L3,731,-6,9,10,-1
720575940628920316,right,L3,732,-3,6,6,0
720575940629871063,right,L3,733,-5,-17,-4,-13
720575940619728007,right,L3,734,2,0,-2,2
720575940626948185,right,L3,735,1,-23,-13,-10
720575940627832392,right,L3,736,-8,1,8,-7
720575940615915974,right,L3,737,0,19,9,10
720575940633352100,right,L3,738,-3,13,9,4
720575940630627706,right,L3,739,-7,2,8,-6
720575940622526708,right,L3,740,2,-8,-6,-2
720575940660133249,right,L3,741,-2,-14,-5,-9
720575940627334525,right,L3,742,-4,11,9,2
720575940627176222,right,L3,743,6,-19,-16,-3
720575940634627042,right,L3,744,-4,25,16,9
720575940629270778,right,L3,745,0,13,6,7
720575940628215378,right,L3,746,-3,3,4,-1
720575940634800888,right,L3,747,0,2,1,1
720575940634178751,right,L3,749,-2,1,2,-1
720575940612488089,right,L3,750,4,-24,-16,-8
720575940631639627,right,L3,751,1,6,2,4
720575940632748883,right,L3,753,-3,24,15,9
720575940633042989,right,L3,754,-1,-13,-6,-7
720575940618393413,right,L3,755,4,19,5,14
720575940640643901,right,L3,756,5,20,5,15
720575940626345293,right,L3,757,0,-6,-3,-3
720575940620327303,right,L3,758,5,-1,-6,5
720575940633892179,right,L3,759,7,14,0,14
720575940622501449,right,L3,760,0,17,8,9
720575940627063448,right,L3,761,-4,-18,-5,-13
720575940626912787,right,L3,762,0,14,7,7
720575940608253788,right,L3,764,-8,-6,5,-11
720575940647651892,right,L3,765,-3,9,7,2
720575940621665974,right,L3,766,2,-4,-4,0
720575940646092567,right,L3,767,1,28,13,15
720575940630024464,right,L3,768,3,5,-1,6
720575940630938668,right,L3,769,4,-27,-18,-9
720575940615071122,right,L3,770,5,4,-3,7
720575940607513730,right,L3,771,3,-27,-17,-10
720575940637506014,right,L3,772,1,12,5,7
720575940626588700,right,L3,773,5,-19,-15,-4
720575940624335880,right,L3,774,-8,6,11,-5
720575940618490651,right,L3,775,5,22,6,16
720575940619933611,right,L3,776,5,21,5,16
720575940614121699,right,L3,777,6,20,4,16
720575940628709894,right,L3,778,4,25,8,17
720575940605432492,right,L3,779,5,24,7,17
720575940617720806,right,L3,780,-6,25,18,7
720575940627210810,right,L3,781,-5,26,18,8
720575940618561209,right,L3,787,3,28,11,17
720575940622503412,right,L3,788,3,27,10,17
720575940615543975,right,L3,789,-3,-27,-11,-16
720575940620949089,right,L3,790,-2,-27,-12,-15
720575940621700973,right,L3,791,-1,-28,-13,-15
720575940632489645,right,L3,792,8,2,-7,9
720575940618607188,right,L3,793,8,-6,-11,5
720575940624374212,right,L3,794,5,-26,-18,-8
720575940625228828,right,L3,795,6,-21,-17,-4
720575940617114461,right,L3,796,4,26,9,17
720575940620174040,right,L4,1,-6,13,12,1
720575940621364340,right,L4,2,-8,2,9,-7
720575940629690575,right,L4,3,6,-12,-12,0
720575940629563152,right,L4,4,-5,-21,-6,-15
720575940627685739,right,L4,5,-1,16,9,7
720575940623802564,right,L4,6,-2,-4,0,-4
720575940633101759,right,L4,7,-6,-6,3,-9
720575940616532492,right,L4,8,-4,26,17,9
720575940613912487,right,L4,9,4,9,0,9
720575940628055573,right,L4,10,5,-15,-13,-2
720575940631594604,right,L4,11,7,-14,-14,0
720575940643836468,right,L4,12,-7,9,11,-2
720575940632504168,right,L4,13,-1,-26,-12,-14
720575940623905304,right,L4,14,0,-27,-14,-13
720575940615123858,right,L4,15,2,-3,-4,1
720575940625241843,right,L4,16,-2,-16,-6,-10
720575940626944899,right,L4,17,1,-5,-4,-1
720575940618004637,right,L4,18,5,-16,-13,-3
720575940622776346,right,L4,19,-7,17,15,2
720575940614570961,right,L4,20,3,-11,-9,-2
720575940635582132,right,L4,21,-2,19,11,8
720575940627326553,right,L4,22,-1,3,2,1
720575940627313283,right,L4,23,-3,-16,-5,-11
720575940618200733,right,L4,24,-1,-10,-4,-6
720575940629770256,right,L4,25,-9,3,10,-7
720575940631156311,right,L4,26,1,-3,-3,0
720575940624852733,right,L4,27,0,-25,-13,-12
720575940639171389,right,L4,28,5,6,-2,8
720575940630752251,right,L4,29,-1,-3,-1,-2
720575940632872396,right,L4,30,6,16,2,14
720575940627666283,right,L4,31,0,16,8,8
720575940612708775,right,L4,32,0,12,6,6
720575940615992070,right,L4,33,3,18,6,12
720575940617631961,right,L4,35,1,-24,-13,-11
720575940616582466,right,L4,36,6,8,-2,10
720575940638508510,right,L4,37,1,5,1,4
720575940616034246,right,L4,38,0,-2,-1,-1
720575940617293529,right,L4,39,0,20,10,10
720575940655307169,right,L4,40,-2,-6,-1,-5
720575940621012133,right,L4,41,-3,28,17,11
720575940621571254,right,L4,42,-1,14,8,6
720575940630910070,right,L4,43,-5,18,14,4
720575940633377740,right,L4,45,-5,-1,4,-5
720575940637778094,right,L4,46,-5,15,12,3
720575940616834165,right,L4,47,-9,-1,8,-9
720575940632045586,right,L4,48,-4,-22,-7,-15
720575940612367473,right,L4,49,4,-4,-6,2
720575940642864781,right,L4,50,-2,21,12,9
720575940627732569,right,L4,51,0,-19,-10,-9
720575940646283886,right,L4,52,-1,-22,-10,-12
720575940620902059,right,L4,53,5,14,2,12
720575940637210542,right,L4,54,-4,3,5,-2
720575940606024294,right,L4,55,-4,-11,-2,-9
720575940631239747,right,L4,56,1,-13,-8,-5
720575940626798338,right,L4,57,6,-11,-12,1
720575940627098923,right,L4,58,3,12,3,9
720575940640701811,right,L4,59,-2,2,3,-1
720575940629928783,right,L4,60,-8,8,12,-4
720575940647341364,right,L4,61,-4,-4,2,-6
720575940636789902,right,L4,63,4,12,2,10
720575940635543391,right,L4,64,4,-23,-16,-7
720575940624003476,right,L4,65,-1,28,15,13
720575940635365216,right,L4,66,2,15,5,10
720575940627293470,right,L4,67,-2,-13,-5,-8
720575940605885286,right,L4,68,3,16,5,11
720575940611348178,right,L4,69,1,8,3,5
720575940606029746,right,L4,70,-4,21,14,7
720575940632090435,right,L4,71,-2,-3,0,-3
720575940638159582,right,L4,72,0,-28,-14,-14
720575940614284463,right,L4,73,2,2,-1,3
720575940621597110,right,L4,74,-1,-9,-4,-5
720575940641026267,right,L4,75,-6,14,13,1
720575940621346147,right,L4,76,-3,-4,1,-5
720575940614095400,right,L4,77,2,-5,-5,0
720575940634973591,right,L4,79,2,1,-2,3
720575940646311476,right,L4,80,4,13,2,11
720575940620560043,right,L4,81,6,-2,-7,5
720575940652954870,right,L4,82,-7,7,10,-3
720575940635065963,right,L4,83,2,-21,-13,-8
720575940611102020,right,L4,84,-2,12,8,4
720575940630556268,right,L4,85,4,-22,-15,-7
720575940625354782,right,L4,86,-5,-7,1,-8
720575940638504425,right,L4,87,1,11,4,7
720575940620523942,right,L4,88,7,4,-5,9
720575940625254733,right,L4,89,1,-19,-11,-8
720575940629172779,right,L4,90,-4,5,6,-1
720575940643778612,right,L4,91,-1,6,4,2
720575940633770029,right,L4,92,0,9,4,5
720575940618383060,right,L4,93,-6,3,7,-4
720575940630197701,right,L4,94,5,18,4,14
720575940628709628,right,L4,95,4,-21,-15,-6
720575940629494288,right,L4,96,1,-10,-6,-4
720575940627511960,right,L4,97,-5,2,6,-4
720575940628077762,right,L4,98,-1,-12,-5,-7
720575940634276833,right,L4,99,4,15,3,12
720575940612275685,right,L4,100,2,-10,-7,-3
720575940643439396,right,L4,101,-7,6,10,-4
720575940631046395,right,L4,102,3,13,3,10
720575940618651170,right,L4,104,-1,-27,-13,-14
720575940638494441,right,L4,105,3,22,8,14
720575940627877960,right,L4,106,-7,11,12,-1
720575940635228579,right,L4,108,-3,-12,-3,-9
720575940614365359,right,L4,109,4,-5,-7,2
720575940629191942,right,L4,110,-7,0,7,-7
720575940624670443,right,L4,111,2,-24,-14,-10
720575940636690551,right,L4,112,-6,1,6,-5
720575940607590322,right,L4,113,-2,4,4,0
720575940626236965,right,L4,114,2,-13,-9,-4
720575940618522397,right,L4,115,-4,2,5,-3
720575940635229859,right,L4,116,-1,-8,-3,-5
720575940636291179,right,L4,117,-8,-2,7,-9
720575940630172666,right,L4,118,3,1,-3,4
720575940643826996,right,L4,119,-2,6,5,1
720575940626321701,right,L4,120,-1,-1,0,-1
720575940626795364,right,L4,121,-8,4,10,-6
720575940635029399,right,L4,122,-5,9,9,0
720575940629865475,right,L4,123,-8,10,13,-3
720575940636786533,right,L4,124,1,-7,-5,-2
720575940629562668,right,L4,125,5,9,-1,10
720575940637996451,right,L4,126,3,11,2,9
720575940606013886,right,L4,127,0,15,7,8
720575940623159465,right,L4,128,3,-22,-14,-8
720575940617536827,right,L4,129,0,-13,-7,-6
720575940627150467,right,L4,130,2,12,4,8
720575940628589898,right,L4,131,-6,20,16,4
720575940633965026,right,L4,132,2,4,0,4
720575940620396480,right,L4,134,-5,-18,-4,-14
720575940627854973,right,L4,135,-3,-22,-8,-14
720575940618135872,right,L4,136,0,3,1,2
720575940630144962,right,L4,137,5,-7,-9,2
720575940620668498,right,L4,138,0,27,13,14
720575940634551452,right,L4,139,1,-14,-8,-6
720575940637038734,right,L4,140,3,8,1,7
720575940620651173,right,L4,142,-2,-18,-7,-11
720575940640670579,right,L4,144,7,-11,-13,2
720575940629160491,right,L4,146,1,-6,-4,-2
720575940630848460,right,L4,147,1,21,9,12
720575940621904618,right,L4,148,-7,-11,1,-12
720575940630410487,right,L4,149,6,-14,-13,-1
720575940661057409,right,L4,150,-8,5,10,-5
720575940634258913,right,L4,152,3,-15,-11,-4
720575940615710431,right,L4,154,-8,0,8,-8
720575940623334732,right,L4,155,-8,13,14,-1
720575940632227897,right,L4,156,-9,1,9,-8
720575940625670477,right,L4,157,-1,-7,-3,-4
720575940630507372,right,L4,158,3,-5,-6,1
720575940621757249,right,L4,159,7,7,-4,11
720575940627692626,right,L4,160,-2,20,12,8
720575940603718316,right,L4,161,4,-14,-11,-3
720575940617989094,right,L4,162,-4,-2,3,-5
720575940628621544,right,L4,163,-9,7,12,-5
720575940626322213,right,L4,164,-1,-2,0,-2
720575940622516182,right,L4,165,4,16,4,12
720575940628047944,right,L4,166,0,18,9,9
720575940609694659,right,L4,167,0,-17,-9,-8
720575940641846747,right,L4,168,-1,17,9,8
720575940618859421,right,L4,169,0,-18,-9,-9
720575940606200352,right,L4,170,-5,1,5,-4
720575940622323440,right,L4,171,6,-20,-16,-4
720575940619909592,right,L4,172,1,22,10,12
720575940609696963,right,L4,173,2,-25,-15,-10
720575940608806492,right,L4,174,4,-15,-12,-3
720575940634331503,right,L4,175,-6,-7,2,-9
720575940623918104,right,L4,176,-2,13,8,5
720575940611917977,right,L4,177,-2,-1,1,-2
720575940638521833,right,L4,178,2,11,3,8
720575940629071771,right,L4,179,-5,-16,-3,-13
720575940625883064,right,L4,180,2,-27,-16,-11
720575940615574239,right,L4,181,1,-4,-3,-1
720575940634701281,right,L4,182,7,-10,-12,2
720575940635156387,right,L4,183,-5,-15,-3,-12
720575940640538765,right,L4,184,-6,-5,3,-8
720575940628203336,right,L4,185,2,-11,-8,-3
720575940623237731,right,L4,186,-1,26,14,12
720575940627065899,right,L4,187,3,21,7,14
720575940623927832,right,L4,188,-5,17,13,4
720575940629140423,right,L4,189,6,13,0,13
720575940617815768,right,L4,190,-3,-5,0,-5
720575940621284006,right,L4,191,-1,-11,-5,-6
720575940621637033,right,L4,192,7,10,-2,12
720575940630359749,right,L4,193,-5,4,7,-3
720575940612138725,right,L4,194,0,-5,-3,-2
720575940627517180,right,L4,195,-3,-1,2,-3
720575940627061022,right,L4,196,-1,8,5,3
720575940610394436,right,L4,197,0,-20,-10,-10
720575940614283439,right,L4,199,0,-12,-6,-6
720575940627310697,right,L4,200,-5,12,11,1
720575940628849148,right,L4,201,-8,9,12,-3
720575940617142645,right,L4,202,-1,27,14,13
720575940613613795,right,L4,203,3,-1,-4,3
720575940609804612,right,L4,204,5,-2,-6,4
720575940618491220,right,L4,205,5,-6,-8,2
720575940635831647,right,L4,206,-3,5,5,0
720575940621260453,right,L4,208,5,-21,-16,-5
720575940650672374,right,L4,209,-3,-8,-1,-7
720575940627904529,right,L4,210,-6,8,10,-2
720575940622201076,right,L4,212,2,-16,-10,-6
720575940615818764,right,L4,213,3,-4,-5,1
720575940631748427,right,L4,214,-5,3,6,-3
720575940619842469,right,L4,215,6,7,-3,10
720575940614279599,right,L4,216,2,19,7,12
720575940630118594,right,L4,218,2,10,3,7
720575940624994708,right,L4,219,6,-4,-8,4
720575940627075912,right,L4,220,2,-6,-5,-1
720575940613112598,right,L4,221,-7,3,8,-5
720575940622534524,right,L4,222,-3,26,16,10
720575940629102974,right,L4,224,0,5,2,3
720575940645348388,right,L4,225,2,-26,-15,-11
720575940626640113,right,L4,226,5,19,4,15
720575940614578174,right,L4,228,-7,1,7,-6
720575940621989185,right,L4,229,5,2,-4,6
720575940618365981,right,L4,230,2,9,2,7
720575940607368201,right,L4,231,4,-12,-10,-2
720575940621762113,right,L4,232,-4,13,10,3
720575940646768675,right,L4,233,4,-13,-11,-2
720575940620126043,right,L4,234,1,3,0,3
720575940616371485,right,L4,235,4,11,1,10
720575940630640847,right,L4,236,-1,4,3,1
720575940645227300,right,L4,239,-6,6,9,-3
720575940626398922,right,L4,240,-4,-3,2,-5
720575940628151300,right,L4,241,2,-17,-11,-6
720575940638920164,right,L4,242,-4,6,7,-1
720575940640047669,right,L4,243,-1,-21,-10,-11
720575940628179968,right,L4,245,-5,-3,3,-6
720575940632702035,right,L4,246,-4,15,11,4
720575940613247346,right,L4,247,-4,-15,-4,-11
720575940634331759,right,L4,248,-6,0,6,-6
720575940636664183,right,L4,249,2,-12,-8,-4
720575940636668517,right,L4,250,-1,1,1,0
720575940611137723,right,L4,251,-1,-14,-6,-8
720575940618761243,right,L4,252,3,23,8,15
720575940615995398,right,L4,253,5,16,3,13
720575940626873530,right,L4,255,-6,-13,-1,-12
720575940614434479,right,L4,256,5,-20,-15,-5
720575940652862454,right,L4,257,2,21,8,13
720575940622355973,right,L4,258,-4,-17,-5,-12
720575940622738696,right,L4,259,-7,-5,4,-9
720575940621793518,right,L4,260,-3,19,12,7
720575940630288758,right,L4,261,-1,13,7,6
720575940624231935,right,L4,262,1,-11,-7,-4
720575940631497209,right,L4,263,-3,4,5,-1
720575940619885958,right,L4,264,-1,-6,-2,-4
720575940620314145,right,L4,265,-6,-1,5,-6
720575940622785705,right,L4,266,-1,-25,-12,-13
720575940618202013,right,L4,267,-6,2,7,-5
720575940613894381,right,L4,268,7,-6,-10,4
720575940631051515,right,L4,269,2,-19,-12,-7
720575940629825274,right,L4,270,1,-8,-5,-3
720575940609429717,right,L4,271,4,6,-1,7
720575940617760861,right,L4,272,3,-2,-4,2
720575940618044417,right,L4,273,-6,23,17,6
720575940637170350,right,L4,275,-8,-1,7,-8
720575940625665101,right,L4,276,2,3,-1,4
720575940607738825,right,L4,277,7,-3,-9,6
720575940625397581,right,L4,278,-5,10,10,0
720575940614276845,right,L4,279,-4,8,8,0
720575940610678392,right,L4,280,-6,-14,-1,-13
720575940606185602,right,L4,281,-9,2,10,-8
720575940604213937,right,L4,284,0,25,12,13
720575940627176478,right,L4,285,6,-18,-15,-3
720575940628898103,right,L4,286,0,-24,-12,-12
720575940625287497,right,L4,287,-5,13,11,2
720575940619299275,right,L4,289,-1,11,6,5
720575940612028110,right,L4,290,5,-24,-17,-7
720575940632396050,right,L4,291,7,2,-6,8
720575940618066461,right,L4,293,4,-17,-13,-4
720575940619342390,right,L4,294,1,-20,-11,-9
720575940625332199,right,L4,295,-2,29,16,13
720575940630937391,right,L4,296,1,-18,-10,-8
720575940638728420,right,L4,297,7,-9,-12,3
720575940635048811,right,L4,298,-5,5,7,-2
720575940623730314,right,L4,299,-4,12,10,2
720575940632342412,right,L4,300,4,-18,-13,-5
720575940640802904,right,L4,301,-5,16,13,3
720575940623581439,right,L4,302,2,17,6,11
720575940637838558,right,L4,303,-5,22,16,6
720575940630836956,right,L4,304,6,5,-4,9
720575940605254880,right,L4,305,-7,4,9,-5
720575940611510234,right,L4,306,3,7,0,7
720575940618481947,right,L4,308,-5,8,9,-1
720575940634313884,right,L4,309,-6,12,12,0
720575940630643650,right,L4,310,2,22,9,13
720575940633964770,right,L4,311,-7,15,14,1
720575940609347029,right,L4,312,4,-7,-8,1
720575940629365504,right,L4,313,7,3,-6,9
720575940625144905,right,L4,314,-9,5,11,-6
720575940637566030,right,L4,315,-3,-6,0,-6
720575940632839394,right,L4,316,5,-4,-7,3
720575940635184547,right,L4,317,-5,-4,3,-7
720575940625421500,right,L4,318,4,-19,-14,-5
720575940632696899,right,L4,319,-2,5,4,1
720575940634731631,right,L4,320,-2,-5,-1,-4
720575940623028250,right,L4,321,8,4,-6,10
720575940627580029,right,L4,322,2,26,11,15
720575940628356593,right,L4,323,-7,-13,0,-13
720575940632957727,right,L4,324,3,24,9,15
720575940620406699,right,L4,325,5,1,-5,6
720575940626213008,right,L4,326,2,16,6,10
720575940622185654,right,L4,327,5,3,-4,7
720575940636363188,right,L4,328,5,-9,-10,1
720575940646136686,right,L4,329,0,24,12,12
720575940639975485,right,L4,330,3,3,-2,5
720575940614428335,right,L4,331,1,-15,-9,-6
720575940631577595,right,L4,332,4,-26,-17,-9
720575940619218752,right,L4,333,0,-21,-11,-10
720575940635599211,right,L4,334,1,-26,-14,-12
720575940617540667,right,L4,335,2,8,2,6
720575940630421036,right,L4,336,0,23,11,12
720575940634729870,right,L4,337,-5,-6,2,-8
720575940643664948,right,L4,338,-1,0,1,-1
720575940614965650,right,L4,341,6,-17,-15,-2
720575940604960992,right,L4,342,2,-15,-10,-5
720575940621548370,right,L4,343,-3,27,16,11
720575940622058623,right,L4,344,-2,-15,-6,-9
720575940623407309,right,L4,345,3,-12,-9,-3
720575940631685903,right,L4,346,-7,-9,2,-11
720575940613683427,right,L4,347,-5,-13,-2,-11
720575940631343813,right,L4,348,3,14,4,10
720575940634391265,right,L4,349,-5,-14,-2,-12
720575940617146454,right,L4,350,1,15,6,9
720575940616914482,right,L4,351,-1,-17,-8,-9
720575940625432299,right,L4,352,-2,28,16,12
720575940630855735,right,L4,353,2,24,10,14
720575940630564090,right,L4,354,-2,-26,-11,-15
720575940615186315,right,L4,355,-7,-6,4,-10
720575940624331593,right,L4,356,0,22,11,11
720575940633446507,right,L4,357,4,17,4,13
720575940627181828,right,L4,358,-3,17,11,6
720575940621082049,right,L4,359,2,23,9,14
720575940645803630,right,L4,360,-5,19,14,5
720575940615007399,right,L4,361,0,-7,-4,-3
720575940618176315,right,L4,362,2,-20,-12,-8
720575940624024102,right,L4,363,7,-4,-9,5
720575940608595209,right,L4,364,4,4,-2,6
720575940620818358,right,L4,365,4,7,-1,8
720575940620277720,right,L4,367,-6,-15,-2,-13
720575940624556436,right,L4,369,5,-5,-8,3
720575940609034761,right,L4,370,-3,21,13,8
720575940641484496,right,L4,371,6,-5,-9,4
720575940618290649,right,L4,372,1,-2,-2,0
720575940618278996,right,L4,373,1,-21,-12,-9
720575940612826085,right,L4,374,2,13,4,9
720575940620786113,right,L4,375,-6,7,9,-2
720575940630980859,right,L4,376,-7,-10,2,-12
720575940620058539,right,L4,377,0,7,3,4
720575940623313677,right,L4,378,-3,18,12,6
720575940627612181,right,L4,379,3,-17,-12,-5
720575940647636020,right,L4,380,-1,29,15,14
720575940638062141,right,L4,381,-8,-9,3,-12
720575940628649237,right,L4,382,3,-6,-6,0
720575940642792589,right,L4,383,-6,11,11,0
720575940621297944,right,L4,384,-6,-2,5,-7
720575940642460635,right,L4,385,-3,-18,-6,-12
720575940617195147,right,L4,386,-6,19,15,4
720575940631117568,right,L4,387,-1,-15,-7,-8
720575940616676806,right,L4,389,-6,-16,-2,-14
720575940623640653,right,L4,390,-6,-9,1,-10
720575940629320236,right,L4,391,4,-3,-6,3
720575940620652564,right,L4,392,-4,7,7,0
720575940619321965,right,L4,394,-7,-8,3,-11
720575940628114344,right,L4,395,0,-22,-11,-11
720575940621062986,right,L4,396,-1,10,6,4
720575940619742561,right,L4,397,-3,-19,-7,-12
720575940625599420,right,L4,399,-4,-24,-8,-16
720575940629330537,right,L4,400,1,-29,-16,-13
720575940625098388,right,L4,401,-2,-19,-8,-11
720575940609015644,right,L4,402,3,26,10,16
720575940623793290,right,L4,403,-2,-12,-4,-8
720575940606469250,right,L4,404,-1,20,11,9
720575940617734612,right,L4,405,3,10,2,8
720575940615872927,right,L4,406,1,-25,-14,-11
720575940614083596,right,L4,407,-5,-10,0,-10
720575940640052699,right,L4,408,-6,-4,4,-8
720575940626752770,right,L4,409,0,-3,-2,-1
720575940622628476,right,L4,410,-2,-2,1,-3
720575940620174808,right,L4,412,-6,21,16,5
720575940642568864,right,L4,413,-2,-7,-2,-5
720575940639081030,right,L4,414,4,21,6,15
720575940638968016,right,L4,415,6,12,0,12
720575940632618067,right,L4,416,3,-8,-7,-1
720575940627146283,right,L4,417,-6,-10,1,-11
720575940605411244,right,L4,418,-2,15,9,6
720575940628561095,right,L4,419,-3,-11,-3,-8
720575940630638044,right,L4,420,6,-3,-8,5
720575940626575716,right,L4,422,-7,-4,5,-9
720575940607985330,right,L4,423,3,-18,-12,-6
720575940646668323,right,L4,424,-3,-2,2,-4
720575940609758403,right,L4,425,3,20,7,13
720575940621756276,right,L4,426,-3,0,3,-3
720575940618814277,right,L4,427,5,-18,-14,-4
720575940623839782,right,L4,428,-2,23,13,10
720575940608985867,right,L4,429,-2,14,9,5
720575940612298536,right,L4,430,-3,-7,-1,-6
720575940625039764,right,L4,431,-2,-10,-3,-7
720575940616206534,right,L4,432,-5,7,8,-1
720575940620125387,right,L4,433,0,-8,-4,-4
720575940636414831,right,L4,435,5,-17,-14,-3
720575940620585094,right,L4,436,0,-15,-8,-7
720575940630431532,right,L4,437,-3,12,9,3
720575940635232163,right,L4,439,-3,-9,-2,-7
720575940606082750,right,L4,440,1,23,10,13
720575940617986589,right,L4,441,3,-16,-11,-5
720575940630428716,right,L4,442,-5,25,17,8
720575940624038122,right,L4,443,-6,4,8,-4
720575940623675613,right,L4,444,4,-10,-9,-1
720575940643863092,right,L4,445,-2,8,6,2
720575940620965741,right,L4,446,2,-14,-9,-5
720575940621087514,right,L4,447,-1,2,2,0
720575940616636940,right,L4,448,0,30,15,15
720575940625301799,right,L4,449,6,-16,-14,-2
720575940633515603,right,L4,450,2,-9,-7,-2
720575940627760186,right,L4,452,1,-9,-6,-3
720575940614228530,right,L4,453,3,25,9,16
720575940637073582,right,L4,454,5,-12,-11,-1
720575940647081251,right,L4,455,7,-7,-11,4
720575940631861266,right,L4,456,0,21,10,11
720575940622869462,right,L4,457,-2,17,10,7
720575940621141851,right,L4,458,5,0,-5,5
720575940633767836,right,L4,459,5,-3,-7,4
720575940621278401,right,L4,460,-3,-20,-7,-13
720575940614590957,right,L4,461,7,-5,-10,5
720575940626403842,right,L4,462,-1,18,10,8
720575940629316099,right,L4,463,5,17,3,14
720575940627883025,right,L4,464,4,0,-4,4
720575940614031614,right,L4,465,3,0,-3,3
720575940621418155,right,L4,466,1,14,6,8
720575940645799022,right,L4,467,-2,-20,-8,-12
720575940629597169,right,L4,468,-3,11,8,3
720575940611502546,right,L4,469,-7,13,13,0
720575940613087510,right,L4,470,4,-9,-9,0
720575940617477009,right,L4,471,3,-26,-16,-10
720575940632585287,right,L4,472,1,25,11,14
720575940636965477,right,L4,473,-4,23,15,8
720575940641261008,right,L4,474,-3,-17,-6,-11
720575940612375002,right,L4,475,-4,-1,3,-4
720575940626851831,right,L4,476,-1,15,8,7
720575940612606899,right,L4,477,-3,2,4,-2
720575940618794141,right,L4,478,-7,16,15,1
720575940629311747,right,L4,479,-2,10,7,3
720575940631471890,right,L4,481,4,-8,-8,0
720575940619344438,right,L4,482,1,17,7,10
720575940623192105,right,L4,483,2,-7,-6,-1
720575940608677724,right,L4,484,3,-9,-8,-1
720575940607211977,right,L4,485,-3,-3,1,-4
720575940620768080,right,L4,486,0,1,0,1
720575940619753057,right,L4,487,1,-1,-2,1
720575940631539852,right,L4,488,7,5,-5,10
720575940611541939,right,L4,489,-3,10,8,2
720575940614436147,right,L4,492,-7,-2,6,-8
720575940621926753,right,L4,493,-3,23,14,9
720575940642375925,right,L4,494,0,29,14,15
720575940612423026,right,L4,495,4,5,-2,7
720575940605786656,right,L4,497,6,1,-6,7
720575940645157320,right,L4,498,6,10,-1,11
720575940620439209,right,L4,499,5,10,0,10
720575940610484036,right,L4,500,7,-8,-11,3
720575940611413858,right,L4,501,1,2,0,2
720575940626406087,right,L4,502,5,8,-1,9
720575940637678558,right,L4,503,3,17,5,12
720575940621204941,right,L4,504,-2,9,6,3
720575940632505903,right,L4,506,1,-12,-7,-5
720575940636233208,right,L4,507,-5,-12,-1,-11
720575940624318135,right,L4,508,-5,11,10,1
720575940609852427,right,L4,509,-4,10,9,1
720575940605116640,right,L4,510,-2,11,7,4
720575940645955694,right,L4,511,5,-11,-11,0
720575940607693442,right,L4,512,6,0,-6,6
720575940616514354,right,L4,513,-4,-13,-3,-10
720575940603987390,right,L4,514,-4,-10,-1,-9
720575940626857065,right,L4,515,-8,-7,4,-11
720575940635621783,right,L4,517,6,3,-5,8
720575940640194392,right,L4,518,-4,22,15,7
720575940610409946,right,L4,519,-5,-5,2,-7
720575940639783101,right,L4,520,-2,-22,-9,-13
720575940627388029,right,L4,521,6,-9,-11,2
720575940627264002,right,L4,522,-4,0,4,-4
720575940616763509,right,L4,523,2,14,5,9
720575940622816332,right,L4,524,4,-20,-14,-6
720575940617739357,right,L4,525,-1,-20,-9,-11
720575940626144574,right,L4,526,0,-10,-5,-5
720575940635224995,right,L4,527,-4,-8,0,-8
720575940612741338,right,L4,528,2,7,1,6
720575940629431034,right,L4,529,2,-2,-3,1
720575940645053732,right,L4,530,-3,-13,-4,-9
720575940645631524,right,L4,531,1,0,-1,1
720575940659648641,right,L4,532,-8,7,11,-4
720575940629192747,right,L4,533,0,-16,-8,-8
720575940647887236,right,L4,534,3,2,-2,4
720575940610289250,right,L4,536,3,4,-1,5
720575940619439936,right,L4,537,0,-23,-12,-11
720575940614732798,right,L4,538,-4,1,4,-3
720575940628011602,right,L4,539,-6,15,13,2
720575940633375405,right,L4,540,-2,-9,-3,-6
720575940610278724,right,L4,541,-4,14,11,3
720575940622298793,right,L4,542,6,-13,-13,0
720575940635238307,right,L4,543,-1,-4,-1,-3
720575940616978518,right,L4,544,3,-13,-10,-3
720575940655390113,right,L4,545,5,11,0,11
720575940625282236,right,L4,546,3,6,0,6
720575940627708779,right,L4,547,-1,21,11,10
720575940621475949,right,L4,548,1,-16,-9,-7
720575940622006192,right,L4,549,0,-9,-5,-4
720575940612608741,right,L4,550,-2,3,3,0
720575940628587324,right,L4,551,-4,-9,-1,-8
720575940613924589,right,L4,552,4,-1,-5,4
720575940640122421,right,L4,553,-3,16,11,5
720575940642163957,right,L4,555,-4,9,8,1
720575940622097012,right,L4,556,0,10,5,5
720575940635730527,right,L4,557,6,-10,-11,1
720575940631152847,right,L4,558,-4,-21,-7,-14
720575940620851392,right,L4,559,-6,22,17,5
720575940608805827,right,L4,560,-7,14,14,0
720575940629902096,right,L4,561,5,7,-2,9
720575940618927451,right,L4,562,-5,-2,4,-6
720575940620623307,right,L4,563,5,-13,-12,-1
720575940639962429,right,L4,564,3,-23,-15,-8
720575940626225229,right,L4,565,0,-26,-13,-13
720575940629642907,right,L4,567,-2,22,13,9
720575940624418110,right,L4,568,-6,-8,2,-10
720575940614742447,right,L4,570,2,25,10,15
720575940631689901,right,L4,571,0,-14,-7,-7
720575940626423580,right,L4,572,-8,3,9,-6
720575940627817800,right,L4,573,4,14,3,11
720575940629302910,right,L4,574,-6,5,8,-3
720575940651798262,right,L4,575,6,9,-2,11
720575940632216643,right,L4,576,0,28,14,14
720575940638344026,right,L4,577,5,-14,-12,-2
720575940618922309,right,L4,578,4,-11,-10,-1
720575940644179656,right,L4,579,-3,-10,-2,-8
720575940621284011,right,L4,580,-2,-23,-10,-13
720575940632713247,right,L4,581,3,9,1,8
720575940617689995,right,L4,582,-1,23,12,11
720575940640661923,right,L4,583,3,-25,-16,-9
720575940629930831,right,L4,584,4,23,7,16
720575940634309401,right,L4,585,-1,-23,-11,-12
720575940607265237,right,L4,586,2,18,7,11
720575940628072458,right,L4,588,1,4,1,3
720575940609638339,right,L4,589,-1,-5,-2,-3
720575940624294069,right,L4,590,1,9,3,6
720575940628370960,right,L4,591,3,-3,-5,2
720575940639611957,right,L4,593,3,-14,-10,-4
720575940622752332,right,L4,595,7,-12,-13,1
720575940632634252,right,L4,596,-4,-16,-4,-12
720575940633537505,right,L4,597,4,1,-4,5
720575940623560328,right,L4,598,2,-18,-11,-7
720575940623922952,right,L4,599,-1,9,5,4
720575940606009446,right,L4,600,3,-10,-8,-2
720575940612338289,right,L4,601,1,16,7,9
720575940617281373,right,L4,602,4,-2,-5,3
720575940620969637,right,L4,603,-3,-23,-9,-14
720575940623627229,right,L4,604,-6,-17,-3,-14
720575940637306677,right,L4,605,3,15,4,11
720575940626316730,right,L4,607,1,18,8,10
720575940609503189,right,L4,608,1,10,4,6
720575940622473991,right,L4,609,-2,0,2,-2
720575940634256354,right,L4,610,2,-23,-14,-9
720575940631319377,right,L4,611,-1,-18,-8,-10
720575940632894535,right,L4,612,-3,-26,-10,-16
720575940634330991,right,L4,613,-8,-4,6,-10
720575940635232931,right,L4,614,-2,-8,-2,-6
720575940626085519,right,L4,615,-7,-7,3,-10
720575940624763796,right,L4,616,-3,15,10,5
720575940627703897,right,L4,617,-2,-17,-7,-10
720575940627784266,right,L4,618,-1,24,13,11
720575940605544108,right,L4,619,-4,-19,-6,-13
720575940631226711,right,L4,620,7,1,-7,8
720575940623822474,right,L4,621,1,24,11,13
720575940633093459,right,L4,622,-5,20,15,5
720575940622409195,right,L4,623,1,13,5,8
720575940627535961,right,L4,624,1,-17,-10,-7
720575940613600227,right,L4,625,-2,24,14,10
720575940617211806,right,L4,626,-5,-8,1,-9
720575940611972302,right,L4,627,0,-1,-1,0
720575940655029921,right,L4,628,0,0,0,0
720575940630424108,right,L4,629,4,24,8,16
720575940627762053,right,L4,630,4,8,0,8
720575940615083154,right,L4,631,1,26,12,14
720575940632961932,right,L4,632,3,-20,-13,-7
720575940609099529,right,L4,633,-1,-24,-11,-13
720575940626107696,right,L4,635,6,-6,-9,3
720575940631454312,right,L4,636,0,6,3,3
720575940627999570,right,L4,637,3,-21,-14,-7
720575940626325029,right,L4,639,-4,19,13,6
720575940624126954,right,L4,640,-1,-16,-7,-9
720575940624939928,right,L4,642,-5,-11,-1,-10
720575940628638167,right,L4,643,6,14,1,13
720575940632394380,right,L4,644,-6,18,15,3
720575940639597877,right,L4,646,6,17,2,15
720575940635230627,right,L4,647,-4,-7,0,-7
720575940631283543,right,L4,648,1,7,2,5
720575940638733109,right,L4,649,-1,5,3,2
720575940624425107,right,L4,650,-3,-25,-10,-15
720575940635170211,right,L4,651,-4,-5,1,-6
720575940635141795,right,L4,652,-6,-11,0,-11
720575940627260426,right,L4,653,-6,-12,0,-12
720575940624297608,right,L4,654,-3,8,7,1
720575940606382257,right,L4,655,6,-1,-7,6
720575940632264531,right,L4,656,0,-11,-6,-5
720575940628637973,right,L4,657,-2,-25,-11,-14
720575940620320336,right,L4,658,1,20,9,11
720575940635172003,right,L4,659,-4,-6,1,-7
720575940636695919,right,L4,660,2,28,12,16
720575940633224237,right,L4,661,-3,14,10,4
720575940631644178,right,L4,662,2,-1,-3,2
720575940622078725,right,L4,663,0,8,4,4
720575940623292381,right,L4,664,1,-27,-15,-12
720575940632353351,right,L4,665,7,-2,-8,6
720575940605986336,right,L4,667,1,-28,-15,-13
720575940635073131,right,L4,668,1,19,8,11
720575940633938713,right,L4,669,4,-16,-12,-4
720575940631974687,right,L4,670,5,5,-3,8
720575940627430296,right,L4,671,-4,-23,-8,-15
720575940613115877,right,L4,672,-8,11,13,-2
720575940629101386,right,L4,673,2,5,0,5
720575940616122402,right,L4,674,-4,-14,-3,-11
720575940610975044,right,L4,675,-7,19,16,3
720575940637300621,right,L4,676,-3,-21,-8,-13
720575940628722438,right,L4,677,0,11,5,6
720575940646776611,right,L4,678,3,-7,-7,0
720575940628899323,right,L4,679,4,18,5,13
720575940627580541,right,L4,681,-2,-21,-9,-12
720575940609347541,right,L4,682,6,-8,-10,2
720575940619636871,right,L4,683,2,6,1,5
720575940617056724,right,L4,684,-6,17,14,3
720575940627005443,right,L4,685,-5,-9,0,-9
720575940624740075,right,L4,686,5,-22,-16,-6
720575940613009298,right,L4,687,-6,-3,4,-7
720575940637280430,right,L4,688,-7,10,12,-2
720575940615637983,right,L4,689,-2,18,11,7
720575940616984374,right,L4,690,-7,-3,5,-8
720575940618582785,right,L4,691,-9,4,11,-7
720575940605811046,right,L4,692,-4,24,16,8
720575940637665136,right,L4,693,-3,25,15,10
720575940622463220,right,L4,694,4,3,-3,6
720575940651951350,right,L4,695,-6,10,11,-1
720575940623732991,right,L4,696,-2,16,10,6
720575940635826539,right,L4,697,1,-22,-12,-10
720575940628568650,right,L4,698,6,-7,-10,3
720575940631364828,right,L4,699,-5,0,5,-5
720575940620042712,right,L4,700,5,15,2,13
720575940619590104,right,L4,701,0,-4,-2,-2
720575940640498651,right,L4,702,-5,23,16,7
720575940631549125,right,L4,703,-3,1,3,-2
720575940629281795,right,L4,704,-7,8,11,-3
720575940654890145,right,L4,705,1,1,-1,2
720575940624153880,right,L4,706,-7,-12,1,-13
720575940623597592,right,L4,709,-2,-24,-10,-14
720575940640158781,right,L4,710,4,-25,-17,-8
720575940635470443,right,L4,711,-1,19,10,9
720575940627154178,right,L4,712,-7,12,13,-1
720575940629899011,right,L4,713,-6,16,14,2
720575940615458060,right,L4,714,5,12,1,11
720575940627739978,right,L4,715,4,10,1,9
720575940628570442,right,L4,716,4,-6,-7,1
720575940614390782,right,L4,717,2,-22,-13,-9
720575940625066248,right,L4,719,1,27,12,15
720575940637660382,right,L4,722,6,-15,-14,-1
720575940638738035,right,L4,723,-2,-11,-4,-7
720575940632914719,right,L4,724,4,2,-3,5
720575940614313709,right,L4,725,-3,-24,-9,-15
720575940606067628,right,L4,726,2,-28,-16,-12
720575940616692274,right,L4,727,7,6,-4,10
720575940626983882,right,L4,728,7,12,-1,13
720575940621731009,right,L4,729,-3,29,17,12
720575940639384920,right,L4,731,-6,9,10,-1
720575940627713532,right,L4,732,-3,6,6,0
720575940653188854,right,L4,733,-5,-17,-4,-13
720575940611716570,right,L4,734,2,0,-2,2
720575940614391038,right,L4,735,1,-23,-13,-10
720575940626740068,right,L4,736,-8,1,8,-7
720575940655273889,right,L4,737,0,19,9,10
720575940627718738,right,L4,738,-3,13,9,4
720575940617861561,right,L4,740,2,-8,-6,-2
720575940617613017,right,L4,741,-2,-14,-5,-9
720575940623103843,right,L4,742,-4,11,9,2
720575940624709193,right,L4,743,6,-19,-16,-3
720575940624739819,right,L4,744,-4,25,16,9
720575940619290944,right,L4,745,0,13,6,7
720575940630927222,right,L4,746,-3,3,4,-1
720575940617041553,right,L4,747,0,2,1,1
720575940621866643,right,L4,749,-2,1,2,-1
720575940633829331,right,L4,750,4,-24,-16,-8
720575940618297428,right,L4,753,-3,24,15,9
720575940625682765,right,L4,754,-1,-13,-6,-7
720575940627407000,right,L4,755,4,19,5,14
720575940635287450,right,L4,756,5,20,5,15
720575940613286117,right,L4,757,0,-6,-3,-3
720575940624578540,right,L4,758,5,-1,-6,5
720575940614120671,right,L4,759,7,14,0,14
720575940621040244,right,L4,760,0,17,8,9
720575940625464807,right,L4,761,-4,-18,-5,-13
720575940612365937,right,L4,762,0,14,7,7
720575940615206055,right,L4,763,-5,14,12,2
720575940637841520,right,L4,765,-3,9,7,2
720575940631575916,right,L4,766,2,-4,-4,0
720575940614342381,right,L4,768,3,5,-1,6
720575940618439825,right,L4,769,4,-27,-18,-9
720575940635929695,right,L4,770,5,4,-3,7
720575940624349578,right,L4,771,3,-27,-17,-10
720575940616178335,right,L4,772,1,12,5,7
720575940630829879,right,L4,773,5,-19,-15,-4
720575940621961136,right,L4,774,-8,6,11,-5
720575940625718605,right,L4,775,5,22,6,16
720575940623524451,right,L4,777,6,20,4,16
720575940618243741,right,L4,778,4,25,8,17
720575940617535803,right,L4,779,5,24,7,17
720575940619662646,right,L4,780,-6,25,18,7
720575940630694082,right,L4,781,-5,26,18,8
720575940626964938,right,L4,783,-4,28,18,10
720575940645019428,right,L4,787,3,28,11,17
720575940625234068,right,L4,789,-3,-27,-11,-16
720575940632878929,right,L4,794,5,-26,-18,-8
720575940618311398,right,L4,796,4,26,9,17
720575940615462038,right,L5,1,-6,13,12,1
720575940622621729,right,L5,2,-8,2,9,-7
720575940610072388,right,L5,3,6,-12,-12,0
720575940605224416,right,L5,4,-5,-21,-6,-15
720575940622305553,right,L5,5,-1,16,9,7
720575940635239075,right,L5,6,-2,-4,0,-4
720575940628774677,right,L5,7,-6,-6,3,-9
720575940630647546,right,L5,8,-4,26,17,9
720575940628097864,right,L5,9,4,9,0,9
720575940623928525,right,L5,10,5,-15,-13,-2
720575940660249985,right,L5,11,7,-14,-14,0
720575940638344282,right,L5,12,-7,9,11,-2
720575940655324577,right,L5,13,-1,-26,-12,-14
720575940627492739,right,L5,14,0,-27,-14,-13
720575940614910882,right,L5,15,2,-3,-4,1
720575940626669842,right,L5,16,-2,-16,-6,-10
720575940635721151,right,L5,17,1,-5,-4,-1
720575940627999816,right,L5,18,5,-16,-13,-3
720575940630965548,right,L5,19,-7,17,15,2
720575940617431360,right,L5,20,3,-11,-9,-2
720575940626042812,right,L5,21,-2,19,11,8
720575940631982679,right,L5,22,-1,3,2,1
720575940639898019,right,L5,23,-3,-16,-5,-11
720575940635220131,right,L5,24,-1,-10,-4,-6
720575940618265373,right,L5,25,-9,3,10,-7
720575940630977852,right,L5,26,1,-3,-3,0
720575940614793214,right,L5,27,0,-25,-13,-12
720575940639904931,right,L5,28,5,6,-2,8
720575940629760419,right,L5,29,-1,-3,-1,-2
720575940620665665,right,L5,30,6,16,2,14
720575940630797305,right,L5,31,0,16,8,8
720575940628662528,right,L5,32,0,12,6,6
720575940630941016,right,L5,33,3,18,6,12
720575940605332070,right,L5,34,6,18,3,15
720575940618172902,right,L5,35,1,-24,-13,-11
720575940641708685,right,L5,36,6,8,-2,10
720575940616017269,right,L5,37,1,5,1,4
720575940622279629,right,L5,38,0,-2,-1,-1
720575940624953781,right,L5,39,0,20,10,10
720575940616289364,right,L5,40,-2,-6,-1,-5
720575940616313940,right,L5,41,-3,28,17,11
720575940620050961,right,L5,42,-1,14,8,6
720575940653461238,right,L5,43,-5,18,14,4
720575940624755092,right,L5,44,5,-10,-10,0
720575940635173027,right,L5,45,-5,-1,4,-5
720575940605970604,right,L5,46,-5,15,12,3
720575940638745971,right,L5,47,-9,-1,8,-9
720575940628560636,right,L5,48,-4,-22,-7,-15
720575940618797120,right,L5,49,4,-4,-6,2
720575940620691794,right,L5,50,-2,21,12,9
720575940618655286,right,L5,51,0,-19,-10,-9
720575940627130122,right,L5,52,-1,-22,-10,-12
720575940619463046,right,L5,53,5,14,2,12
720575940633227148,right,L5,54,-4,3,5,-2
720575940644943816,right,L5,55,-4,-11,-2,-9
720575940627427717,right,L5,56,1,-13,-8,-5
720575940627871253,right,L5,57,6,-11,-12,1
720575940614782119,right,L5,58,3,12,3,9
720575940627012881,right,L5,59,-2,2,3,-1
720575940624812780,right,L5,60,-8,8,12,-4
720575940635177891,right,L5,61,-4,-4,2,-6
720575940621577711,right,L5,62,0,-29,-15,-14
720575940635384159,right,L5,63,4,12,2,10
720575940628183548,right,L5,64,4,-23,-16,-7
720575940627717448,right,L5,65,-1,28,15,13
720575940631468303,right,L5,66,2,15,5,10
720575940628962759,right,L5,67,-2,-13,-5,-8
720575940612844806,right,L5,68,3,16,5,11
720575940652918774,right,L5,69,1,8,3,5
720575940615808406,right,L5,70,-4,21,14,7
720575940635239587,right,L5,71,-2,-3,0,-3
720575940619575872,right,L5,72,0,-28,-14,-14
720575940611157970,right,L5,73,2,2,-1,3
720575940625135804,right,L5,74,-1,-9,-4,-5
720575940626933706,right,L5,75,-6,14,13,1
720575940632737069,right,L5,76,-3,-4,1,-5
720575940603923116,right,L5,77,2,-5,-5,0
720575940613004690,right,L5,78,2,20,8,12
720575940630284844,right,L5,79,2,1,-2,3
720575940626654410,right,L5,80,4,13,2,11
720575940632065384,right,L5,81,6,-2,-7,5
720575940617719768,right,L5,82,-7,7,10,-3
720575940638623834,right,L5,83,2,-21,-13,-8
720575940639721806,right,L5,84,-2,12,8,4
720575940635758072,right,L5,85,4,-22,-15,-7
720575940647466884,right,L5,86,-5,-7,1,-8
720575940614210978,right,L5,87,1,11,4,7
720575940613576470,right,L5,89,1,-19,-11,-8
720575940621372436,right,L5,90,-4,5,6,-1
720575940643746612,right,L5,91,-1,6,4,2
720575940632208911,right,L5,92,0,9,4,5
720575940628535976,right,L5,94,5,18,4,14
720575940622248474,right,L5,95,4,-21,-15,-6
720575940607344306,right,L5,96,1,-10,-6,-4
720575940624192973,right,L5,97,-5,2,6,-4
720575940626613622,right,L5,98,-1,-12,-5,-7
720575940620362876,right,L5,99,4,15,3,12
720575940639028031,right,L5,100,2,-10,-7,-3
720575940639467829,right,L5,101,-7,6,10,-4
720575940632454703,right,L5,102,3,13,3,10
720575940627048741,right,L5,103,7,9,-3,12
720575940628108776,right,L5,104,-1,-27,-13,-14
720575940638315753,right,L5,105,3,22,8,14
720575940628807957,right,L5,106,-7,11,12,-1
720575940622593494,right,L5,107,8,-2,-9,7
720575940624391658,right,L5,108,-3,-12,-3,-9
720575940606760284,right,L5,109,4,-5,-7,2
720575940627815676,right,L5,110,-7,0,7,-7
720575940647121972,right,L5,111,2,-24,-14,-10
720575940613202794,right,L5,112,-6,1,6,-5
720575940641785589,right,L5,113,-2,4,4,0
720575940628912188,right,L5,114,2,-13,-9,-4
720575940630743972,right,L5,115,-4,2,5,-3
720575940611266658,right,L5,116,-1,-8,-3,-5
720575940623698372,right,L5,117,-8,-2,7,-9
720575940627915780,right,L5,118,3,1,-3,4
720575940630497231,right,L5,119,-2,6,5,1
720575940615207180,right,L5,120,-1,-1,0,-1
720575940636776037,right,L5,121,-8,4,10,-6
720575940618434449,right,L5,122,-5,9,9,0
720575940635873904,right,L5,123,-8,10,13,-3
720575940633149357,right,L5,124,1,-7,-5,-2
720575940613094642,right,L5,125,5,9,-1,10
720575940630875387,right,L5,126,3,11,2,9
720575940620727489,right,L5,127,0,15,7,8
720575940631102735,right,L5,128,3,-22,-14,-8
720575940631650066,right,L5,129,0,-13,-7,-6
720575940616790389,right,L5,130,2,12,4,8
720575940625400248,right,L5,131,-6,20,16,4
720575940615476166,right,L5,132,2,4,0,4
720575940613236147,right,L5,133,-3,20,13,7
720575940609611531,right,L5,134,-5,-18,-4,-14
720575940608910345,right,L5,135,-3,-22,-8,-14
720575940612053679,right,L5,136,0,3,1,2
720575940648661380,right,L5,137,5,-7,-9,2
720575940629359515,right,L5,138,0,27,13,14
720575940629928407,right,L5,139,1,-14,-8,-6
720575940629907578,right,L5,140,3,8,1,7
720575940637898842,right,L5,141,5,-23,-17,-6
720575940631165541,right,L5,142,-2,-18,-7,-11
720575940640211389,right,L5,143,-4,16,12,4
720575940621138414,right,L5,144,7,-11,-13,2
720575940624971353,right,L5,145,0,4,2,2
720575940633073052,right,L5,146,1,-6,-4,-2
720575940639355837,right,L5,147,1,21,9,12
720575940623559876,right,L5,148,-7,-11,1,-12
720575940614865570,right,L5,149,6,-14,-13,-1
720575940616332338,right,L5,150,-8,5,10,-5
720575940642275725,right,L5,151,-3,-14,-4,-10
720575940612173747,right,L5,152,3,-15,-11,-4
720575940618145565,right,L5,153,8,0,-8,8
720575940621278166,right,L5,154,-8,0,8,-8
720575940637677790,right,L5,155,-8,13,14,-1
720575940621138342,right,L5,156,-9,1,9,-8
720575940629091146,right,L5,157,-1,-7,-3,-4
720575940628630223,right,L5,158,3,-5,-6,1
720575940645725476,right,L5,159,7,7,-4,11
720575940640767859,right,L5,160,-2,20,12,8
720575940606336958,right,L5,161,4,-14,-11,-3
720575940614259251,right,L5,162,-4,-2,3,-5
720575940636614757,right,L5,163,-9,7,12,-5
720575940635212963,right,L5,164,-1,-2,0,-2
720575940612207473,right,L5,165,4,16,4,12
720575940618894917,right,L5,166,0,18,9,9
720575940617722507,right,L5,167,0,-17,-9,-8
720575940617265566,right,L5,168,-1,17,9,8
720575940635604671,right,L5,169,0,-18,-9,-9
720575940626746567,right,L5,170,-5,1,5,-4
720575940620655275,right,L5,171,6,-20,-16,-4
720575940628072188,right,L5,172,1,22,10,12
720575940641599440,right,L5,173,2,-25,-15,-10
720575940618046109,right,L5,174,4,-15,-12,-3
720575940604964576,right,L5,175,-6,-7,2,-9
720575940620382411,right,L5,176,-2,13,8,5
720575940624185784,right,L5,177,-2,-1,1,-2
720575940617838310,right,L5,178,2,11,3,8
720575940639807859,right,L5,179,-5,-16,-3,-13
720575940630675159,right,L5,180,2,-27,-16,-11
720575940610666030,right,L5,181,1,-4,-3,-1
720575940632791071,right,L5,182,7,-10,-12,2
720575940623549734,right,L5,183,-5,-15,-3,-12
720575940627494666,right,L5,184,-6,-5,3,-8
720575940612744618,right,L5,185,2,-11,-8,-3
720575940623023143,right,L5,186,-1,26,14,12
720575940620704588,right,L5,187,3,21,7,14
720575940616792181,right,L5,188,-5,17,13,4
720575940623361672,right,L5,189,6,13,0,13
720575940617729465,right,L5,190,-3,-5,0,-5
720575940627649359,right,L5,191,-1,-11,-5,-6
720575940660151425,right,L5,192,7,10,-2,12
720575940617656532,right,L5,193,-5,4,7,-3
720575940634733151,right,L5,194,0,-5,-3,-2
720575940643315104,right,L5,195,-3,-1,2,-3
720575940627882366,right,L5,196,-1,8,5,3
720575940622433050,right,L5,197,0,-20,-10,-10
720575940628063208,right,L5,198,6,2,-5,7
720575940630196930,right,L5,199,0,-12,-6,-6
720575940633501644,right,L5,200,-5,12,11,1
720575940607280514,right,L5,201,-8,9,12,-3
720575940627653419,right,L5,202,-1,27,14,13
720575940616321878,right,L5,203,3,-1,-4,3
720575940646667811,right,L5,204,5,-2,-6,4
720575940644255904,right,L5,205,5,-6,-8,2
720575940620305867,right,L5,206,-3,5,5,0
720575940630790010,right,L5,208,5,-21,-16,-5
720575940614380199,right,L5,209,-3,-8,-1,-7
720575940617542374,right,L5,210,-6,8,10,-2
720575940620688832,right,L5,211,-7,-1,6,-7
720575940640125629,right,L5,212,2,-16,-10,-6
720575940605002720,right,L5,213,3,-4,-5,1
720575940621841279,right,L5,215,6,7,-3,10
720575940627946517,right,L5,216,2,19,7,12
720575940625769293,right,L5,217,6,15,1,14
720575940632989011,right,L5,218,2,10,3,7
720575940646012695,right,L5,219,6,-4,-8,4
720575940628541190,right,L5,220,2,-6,-5,-1
720575940634599137,right,L5,221,-7,3,8,-5
720575940622624332,right,L5,222,-3,26,16,10
720575940621548882,right,L5,223,-2,26,15,11
720575940626412176,right,L5,224,0,5,2,3
720575940633147439,right,L5,225,2,-26,-15,-11
720575940648199812,right,L5,226,5,19,4,15
720575940631997381,right,L5,227,-7,5,9,-4
720575940625109833,right,L5,228,-7,1,7,-6
720575940624955322,right,L5,230,2,9,2,7
720575940624219575,right,L5,231,4,-12,-10,-2
720575940625699052,right,L5,232,-4,13,10,3
720575940605910886,right,L5,233,4,-13,-11,-2
720575940628663556,right,L5,234,1,3,0,3
720575940604086496,right,L5,235,4,11,1,10
720575940626986920,right,L5,236,-1,4,3,1
720575940637243237,right,L5,237,-2,27,15,12
720575940628192764,right,L5,238,-8,-3,6,-9
720575940626318878,right,L5,239,-6,6,9,-3
720575940621443137,right,L5,240,-4,-3,2,-5
720575940622175245,right,L5,241,2,-17,-11,-6
720575940618614853,right,L5,242,-4,6,7,-1
720575940636517239,right,L5,243,-1,-21,-10,-11
720575940616464434,right,L5,244,-4,-12,-2,-10
720575940627519763,right,L5,245,-5,-3,3,-6
720575940619944241,right,L5,246,-4,15,11,4
720575940635144867,right,L5,247,-4,-15,-4,-11
720575940630183927,right,L5,248,-6,0,6,-6
720575940632305036,right,L5,249,2,-12,-8,-4
720575940627478790,right,L5,250,-1,1,1,0
720575940610246513,right,L5,251,-1,-14,-6,-8
720575940607446658,right,L5,252,3,23,8,15
720575940623833066,right,L5,253,5,16,3,13
720575940621235846,right,L5,254,3,-24,-15,-9
720575940612846489,right,L5,255,-6,-13,-1,-12
720575940623521318,right,L5,256,5,-20,-15,-5
720575940632449583,right,L5,257,2,21,8,13
720575940635146659,right,L5,258,-4,-17,-5,-12
720575940624584712,right,L5,259,-7,-5,4,-9
720575940633486955,right,L5,261,-1,13,7,6
720575940653343734,right,L5,262,1,-11,-7,-4
720575940624302538,right,L5,263,-3,4,5,-1
720575940617730745,right,L5,264,-1,-6,-2,-4
720575940619354945,right,L5,265,-6,-1,5,-6
720575940637023095,right,L5,266,-1,-25,-12,-13
720575940625568748,right,L5,267,-6,2,7,-5
720575940624907337,right,L5,268,7,-6,-10,4
720575940613386989,right,L5,269,2,-19,-12,-7
720575940633207010,right,L5,270,1,-8,-5,-3
720575940622401549,right,L5,271,4,6,-1,7
720575940641489141,right,L5,272,3,-2,-4,2
720575940634910489,right,L5,273,-6,23,17,6
720575940632130361,right,L5,275,-8,-1,7,-8
720575940616131084,right,L5,276,2,3,-1,4
720575940612655845,right,L5,277,7,-3,-9,6
720575940630165659,right,L5,278,-5,10,10,0
720575940630984443,right,L5,279,-4,8,8,0
720575940628809515,right,L5,280,-6,-14,-1,-13
720575940638566878,right,L5,281,-9,2,10,-8
720575940620662866,right,L5,282,0,26,13,13
720575940633844962,right,L5,283,-4,4,6,-2
720575940616767349,right,L5,284,0,25,12,13
720575940623908871,right,L5,285,6,-18,-15,-3
720575940617886779,right,L5,286,0,-24,-12,-12
720575940621488225,right,L5,287,-5,13,11,2
720575940636351851,right,L5,288,-1,30,16,14
720575940643871540,right,L5,289,-1,11,6,5
720575940611010658,right,L5,290,5,-24,-17,-7
720575940627070360,right,L5,291,7,2,-6,8
720575940627659133,right,L5,292,-4,18,13,5
720575940630061824,right,L5,293,4,-17,-13,-4
720575940635599511,right,L5,294,1,-20,-11,-9
720575940620883403,right,L5,295,-2,29,16,13
720575940620580613,right,L5,296,1,-18,-10,-8
720575940626029852,right,L5,297,7,-9,-12,3
720575940635727199,right,L5,298,-5,5,7,-2
720575940628600232,right,L5,299,-4,12,10,2
720575940617331345,right,L5,300,4,-18,-13,-5
720575940622815493,right,L5,301,-5,16,13,3
720575940618569541,right,L5,302,2,17,6,11
720575940618371613,right,L5,303,-5,22,16,6
720575940617061051,right,L5,304,6,5,-4,9
720575940625449108,right,L5,305,-7,4,9,-5
720575940628236175,right,L5,306,3,7,0,7
720575940621116075,right,L5,307,5,-25,-18,-7
720575940621665670,right,L5,308,-5,8,9,-1
720575940615596427,right,L5,309,-6,12,12,0
720575940631641130,right,L5,310,2,22,9,13
720575940632887891,right,L5,311,-7,15,14,1
720575940612752101,right,L5,312,4,-7,-8,1
720575940605698494,right,L5,313,7,3,-6,9
720575940618590021,right,L5,314,-9,5,11,-6
720575940620971644,right,L5,315,-3,-6,0,-6
720575940631270573,right,L5,316,5,-4,-7,3
720575940610676906,right,L5,317,-5,-4,3,-7
720575940610724910,right,L5,318,4,-19,-14,-5
720575940626797712,right,L5,319,-2,5,4,1
720575940611178450,right,L5,320,-2,-5,-1,-4
720575940618956317,right,L5,321,8,4,-6,10
720575940612980082,right,L5,322,2,26,11,15
720575940614435070,right,L5,323,-7,-13,0,-13
720575940627088517,right,L5,324,3,24,9,15
720575940606712497,right,L5,325,5,1,-5,6
720575940622332540,right,L5,326,2,16,6,10
720575940639663669,right,L5,328,5,-9,-10,1
720575940620666450,right,L5,329,0,24,12,12
720575940617527297,right,L5,330,3,3,-2,5
720575940628212234,right,L5,331,1,-15,-9,-6
720575940630803255,right,L5,332,4,-26,-17,-9
720575940629878583,right,L5,333,0,-21,-11,-10
720575940630203136,right,L5,334,1,-26,-14,-12
720575940625494093,right,L5,335,2,8,2,6
720575940635737200,right,L5,336,0,23,11,12
720575940610261187,right,L5,337,-5,-6,2,-8
720575940609859192,right,L5,338,-1,0,1,-1
720575940620758187,right,L5,339,6,11,-1,12
720575940635942042,right,L5,340,-4,17,12,5
720575940629749114,right,L5,341,6,-17,-15,-2
720575940648070521,right,L5,342,2,-15,-10,-5
720575940619884784,right,L5,343,-3,27,16,11
720575940619157627,right,L5,344,-2,-15,-6,-9
720575940624184575,right,L5,345,3,-12,-9,-3
720575940617813222,right,L5,346,-7,-9,2,-11
720575940622326049,right,L5,347,-5,-13,-2,-11
720575940617830630,right,L5,348,3,14,4,10
720575940626252746,right,L5,349,-5,-14,-2,-12
720575940605389484,right,L5,350,1,15,6,9
720575940628493574,right,L5,351,-1,-17,-8,-9
720575940616196063,right,L5,352,-2,28,16,12
720575940629095171,right,L5,353,2,24,10,14
720575940621401782,right,L5,354,-2,-26,-11,-15
720575940619994571,right,L5,355,-7,-6,4,-10
720575940631932687,right,L5,356,0,22,11,11
720575940618572869,right,L5,357,4,17,4,13
720575940623307084,right,L5,358,-3,17,11,6
720575940620972626,right,L5,359,2,23,9,14
720575940621354734,right,L5,360,-5,19,14,5
720575940604584672,right,L5,361,0,-7,-4,-3
720575940618538565,right,L5,362,2,-20,-12,-8
720575940632465450,right,L5,363,7,-4,-9,5
720575940628285973,right,L5,364,4,4,-2,6
720575940612386257,right,L5,365,4,7,-1,8
720575940624286602,right,L5,366,-5,-20,-5,-15
720575940640386176,right,L5,367,-6,-15,-2,-13
720575940622448531,right,L5,368,-4,-20,-6,-14
720575940616116054,right,L5,369,5,-5,-8,3
720575940621601414,right,L5,370,-3,21,13,8
720575940626275786,right,L5,371,6,-5,-9,4
720575940611784618,right,L5,372,1,-2,-2,0
720575940612648561,right,L5,373,1,-21,-12,-9
720575940635543726,right,L5,374,2,13,4,9
720575940631825489,right,L5,375,-6,7,9,-2
720575940608565003,right,L5,376,-7,-10,2,-12
720575940624894135,right,L5,377,0,7,3,4
720575940621297317,right,L5,378,-3,18,12,6
720575940623166600,right,L5,379,3,-17,-12,-5
720575940624858375,right,L5,380,-1,29,15,14
720575940612112819,right,L5,381,-8,-9,3,-12
720575940633465369,right,L5,382,3,-6,-6,0
720575940630564346,right,L5,383,-6,11,11,0
720575940636381432,right,L5,384,-6,-2,5,-7
720575940620702746,right,L5,385,-3,-18,-6,-12
720575940626299082,right,L5,386,-6,19,15,4
720575940631263247,right,L5,387,-1,-15,-7,-8
720575940610744110,right,L5,388,3,19,6,13
720575940618932939,right,L5,389,-6,-16,-2,-14
720575940626299594,right,L5,390,-6,-9,1,-10
720575940628421831,right,L5,391,4,-3,-6,3
720575940637689006,right,L5,392,-4,7,7,0
720575940625088952,right,L5,393,-1,22,12,10
720575940623422088,right,L5,394,-7,-8,3,-11
720575940623784339,right,L5,395,0,-22,-11,-11
720575940622799178,right,L5,396,-1,10,6,4
720575940626477839,right,L5,397,-3,-19,-7,-12
720575940632346695,right,L5,398,-3,22,14,8
720575940646928419,right,L5,399,-4,-24,-8,-16
720575940615100979,right,L5,400,1,-29,-16,-13
720575940645526068,right,L5,401,-2,-19,-8,-11
720575940631931407,right,L5,402,3,26,10,16
720575940621538486,right,L5,403,-2,-12,-4,-8
720575940615669109,right,L5,404,-1,20,11,9
720575940630537850,right,L5,405,3,10,2,8
720575940630347831,right,L5,406,1,-25,-14,-11
720575940624513208,right,L5,407,-5,-10,0,-10
720575940629097259,right,L5,408,-6,-4,4,-8
720575940644453792,right,L5,409,0,-3,-2,-1
720575940617325090,right,L5,410,-2,-2,1,-3
720575940614696927,right,L5,411,-5,-19,-5,-14
720575940631368652,right,L5,412,-6,21,16,5
720575940630250540,right,L5,413,-2,-7,-2,-5
720575940638453214,right,L5,414,4,21,6,15
720575940631711628,right,L5,415,6,12,0,12
720575940624352138,right,L5,416,3,-8,-7,-1
720575940627629114,right,L5,417,-6,-10,1,-11
720575940643047460,right,L5,418,-2,15,9,6
720575940632590243,right,L5,419,-3,-11,-3,-8
720575940616333535,right,L5,420,6,-3,-8,5
720575940643779380,right,L5,421,-1,12,7,5
720575940605940000,right,L5,422,-7,-4,5,-9
720575940629064859,right,L5,423,3,-18,-12,-6
720575940620379015,right,L5,424,-3,-2,2,-4
720575940630910040,right,L5,425,3,20,7,13
720575940637723614,right,L5,426,-3,0,3,-3
720575940612818611,right,L5,427,5,-18,-14,-4
720575940623074791,right,L5,428,-2,23,13,10
720575940636992686,right,L5,429,-2,14,9,5
720575940635185315,right,L5,430,-3,-7,-1,-6
720575940639357117,right,L5,431,-2,-10,-3,-7
720575940607327106,right,L5,432,-5,7,8,-1
720575940629632759,right,L5,433,0,-8,-4,-4
720575940625862602,right,L5,434,-3,7,6,1
720575940617800422,right,L5,435,5,-17,-14,-3
720575940628890640,right,L5,436,0,-15,-8,-7
720575940609566328,right,L5,437,-3,12,9,3
720575940611342712,right,L5,438,2,27,11,16
720575940625016807,right,L5,439,-3,-9,-2,-7
720575940645104919,right,L5,440,1,23,10,13
720575940620119632,right,L5,441,3,-16,-11,-5
720575940637595790,right,L5,442,-5,25,17,8
720575940624600584,right,L5,443,-6,4,8,-4
720575940636110564,right,L5,444,4,-10,-9,-1
720575940614830376,right,L5,445,-2,8,6,2
720575940630410972,right,L5,446,2,-14,-9,-5
720575940621257596,right,L5,447,-1,2,2,0
720575940630505722,right,L5,448,0,30,15,15
720575940632368199,right,L5,449,6,-16,-14,-2
720575940628993296,right,L5,450,2,-9,-7,-2
720575940625069500,right,L5,451,4,20,6,14
720575940622211916,right,L5,452,1,-9,-6,-3
720575940623023399,right,L5,453,3,25,9,16
720575940620881134,right,L5,454,5,-12,-11,-1
720575940605640160,right,L5,455,7,-7,-11,4
720575940626248837,right,L5,456,0,21,10,11
720575940621616111,right,L5,457,-2,17,10,7
720575940636734053,right,L5,458,5,0,-5,5
720575940631235896,right,L5,459,5,-3,-7,4
720575940615953862,right,L5,460,-3,-20,-7,-13
720575940604599654,right,L5,461,7,-5,-10,5
720575940622995443,right,L5,462,-1,18,10,8
720575940643646664,right,L5,463,5,17,3,14
720575940631485711,right,L5,464,4,0,-4,4
720575940611165390,right,L5,465,3,0,-3,3
720575940621854540,right,L5,466,1,14,6,8
720575940616293087,right,L5,467,-2,-20,-8,-12
720575940610844678,right,L5,468,-3,11,8,3
720575940623451272,right,L5,469,-7,13,13,0
720575940623983504,right,L5,470,4,-9,-9,0
720575940627838280,right,L5,471,3,-26,-16,-10
720575940632234157,right,L5,472,1,25,11,14
720575940623249944,right,L5,473,-4,23,15,8
720575940623037820,right,L5,474,-3,-17,-6,-11
720575940626859568,right,L5,475,-4,-1,3,-4
720575940632698413,right,L5,476,-1,15,8,7
720575940630828759,right,L5,477,-3,2,4,-2
720575940618514846,right,L5,478,-7,16,15,1
720575940638259290,right,L5,479,-2,10,7,3
720575940617518548,right,L5,480,3,-19,-13,-6
720575940633221018,right,L5,481,4,-8,-8,0
720575940623723858,right,L5,482,1,17,7,10
720575940622705416,right,L5,483,2,-7,-6,-1
720575940630781175,right,L5,484,3,-9,-8,-1
720575940635174307,right,L5,485,-3,-3,1,-4
720575940638479081,right,L5,486,0,1,0,1
720575940637700068,right,L5,487,1,-1,-2,1
720575940613577642,right,L5,488,7,5,-5,10
720575940626014478,right,L5,489,-3,10,8,2
720575940630378327,right,L5,490,-5,6,8,-2
720575940640137048,right,L5,491,7,-1,-8,7
720575940632489064,right,L5,492,-7,-2,6,-8
720575940622392560,right,L5,493,-3,23,14,9
720575940625249831,right,L5,494,0,29,14,15
720575940627712275,right,L5,495,4,5,-2,7
720575940632587857,right,L5,496,7,8,-3,11
720575940630285051,right,L5,497,6,1,-6,7
720575940642416269,right,L5,498,6,10,-1,11
720575940617501755,right,L5,499,5,10,0,10
720575940613442978,right,L5,500,7,-8,-11,3
720575940634538175,right,L5,501,1,2,0,2
720575940630720450,right,L5,502,5,8,-1,9
720575940619699382,right,L5,503,3,17,5,12
720575940612548886,right,L5,504,-2,9,6,3
720575940608206770,right,L5,505,6,-22,-17,-5
720575940613872680,right,L5,506,1,-12,-7,-5
720575940626691258,right,L5,507,-5,-12,-1,-11
720575940618161620,right,L5,508,-5,11,10,1
720575940631068972,right,L5,509,-4,10,9,1
720575940625166504,right,L5,510,-2,11,7,4
720575940628843526,right,L5,511,5,-11,-11,0
720575940605142118,right,L5,512,6,0,-6,6
720575940623369084,right,L5,513,-4,-13,-3,-10
720575940625101244,right,L5,514,-4,-10,-1,-9
720575940612658602,right,L5,515,-8,-7,4,-11
720575940639453262,right,L5,516,7,-18,-16,-2
720575940630227303,right,L5,517,6,3,-5,8
720575940615958971,right,L5,518,-4,22,15,7
720575940635396238,right,L5,519,-5,-5,2,-7
720575940629691386,right,L5,520,-2,-22,-9,-13
720575940632756900,right,L5,521,6,-9,-11,2
720575940612883710,right,L5,522,-4,0,4,-4
720575940607080931,right,L5,523,2,14,5,9
720575940636492663,right,L5,524,4,-20,-14,-6
720575940608863241,right,L5,525,-1,-20,-9,-11
720575940615729932,right,L5,526,0,-10,-5,-5
720575940618808491,right,L5,527,-4,-8,0,-8
720575940610692142,right,L5,528,2,7,1,6
720575940611961523,right,L5,529,2,-2,-3,1
720575940620939696,right,L5,530,-3,-13,-4,-9
720575940629783555,right,L5,531,1,0,-1,1
720575940624578795,right,L5,532,-8,7,11,-4
720575940630735863,right,L5,533,0,-16,-8,-8
720575940615253354,right,L5,534,3,2,-2,4
720575940637845732,right,L5,535,8,-4,-10,6
720575940619986352,right,L5,536,3,4,-1,5
720575940637576158,right,L5,537,0,-23,-12,-11
720575940631109420,right,L5,538,-4,1,4,-3
720575940623206024,right,L5,539,-6,15,13,2
720575940638095326,right,L5,540,-2,-9,-3,-6
720575940622703600,right,L5,541,-4,14,11,3
720575940633180973,right,L5,542,6,-13,-13,0
720575940617015365,right,L5,543,-1,-4,-1,-3
720575940624072967,right,L5,544,3,-13,-10,-3
720575940626819091,right,L5,545,5,11,0,11
720575940618793664,right,L5,546,3,6,0,6
720575940629699322,right,L5,547,-1,21,11,10
720575940631552825,right,L5,548,1,-16,-9,-7
720575940627983336,right,L5,549,0,-9,-5,-4
720575940609714222,right,L5,550,-2,3,3,0
720575940614226915,right,L5,551,-4,-9,-1,-8
720575940633236141,right,L5,552,4,-1,-5,4
720575940629609065,right,L5,553,-3,16,11,5
720575940615964722,right,L5,554,-9,-3,7,-10
720575940630160027,right,L5,555,-4,9,8,1
720575940626907383,right,L5,556,0,10,5,5
720575940633583129,right,L5,557,6,-10,-11,1
720575940648651140,right,L5,558,-4,-21,-7,-14
720575940632987437,right,L5,559,-6,22,17,5
720575940620506827,right,L5,560,-7,14,14,0
720575940632000274,right,L5,561,5,7,-2,9
720575940610739173,right,L5,562,-5,-2,4,-6
720575940624976883,right,L5,563,5,-13,-12,-1
720575940623948983,right,L5,564,3,-23,-15,-8
720575940609638923,right,L5,565,0,-26,-13,-13
720575940619212198,right,L5,566,5,-8,-9,1
720575940644033646,right,L5,567,-2,22,13,9
720575940638265310,right,L5,568,-6,-8,2,-10
720575940631749061,right,L5,569,6,6,-3,9
720575940624750484,right,L5,570,2,25,10,15
720575940615427495,right,L5,571,0,-14,-7,-7
720575940621143405,right,L5,572,-8,3,9,-6
720575940628880578,right,L5,573,4,14,3,11
720575940616976443,right,L5,574,-6,5,8,-3
720575940613201381,right,L5,575,6,9,-2,11
720575940623090726,right,L5,576,0,28,14,14
720575940611214290,right,L5,577,5,-14,-12,-2
720575940623314445,right,L5,578,4,-11,-10,-1
720575940632782028,right,L5,579,-3,-10,-2,-8
720575940652738806,right,L5,580,-2,-23,-10,-13
720575940604958688,right,L5,581,3,9,1,8
720575940617724601,right,L5,582,-1,23,12,11
720575940620516544,right,L5,583,3,-25,-16,-9
720575940630847628,right,L5,584,4,23,7,16
720575940613591533,right,L5,585,-1,-23,-11,-12
720575940650009977,right,L5,586,2,18,7,11
720575940630909016,right,L5,587,4,22,7,15
720575940648653700,right,L5,588,1,4,1,3
720575940628789303,right,L5,589,-1,-5,-2,-3
720575940625053939,right,L5,590,1,9,3,6
720575940622241050,right,L5,591,3,-3,-5,2
720575940605857638,right,L5,593,3,-14,-10,-4
720575940630499833,right,L5,594,7,-16,-15,-1
720575940615619231,right,L5,595,7,-12,-13,1
720575940628475816,right,L5,596,-4,-16,-4,-12
720575940631194821,right,L5,597,4,1,-4,5
720575940638794037,right,L5,598,2,-18,-11,-7
720575940616665181,right,L5,599,-1,9,5,4
720575940630778103,right,L5,600,3,-10,-8,-2
720575940641438453,right,L5,601,1,16,7,9
720575940628570630,right,L5,602,4,-2,-5,3
720575940615262570,right,L5,603,-3,-23,-9,-14
720575940614125608,right,L5,604,-6,-17,-3,-14
720575940628030724,right,L5,605,3,15,4,11
720575940608337522,right,L5,606,-1,-19,-9,-10
720575940621022034,right,L5,607,1,18,8,10
720575940608632547,right,L5,608,1,10,4,6
720575940621744961,right,L5,609,-2,0,2,-2
720575940620608647,right,L5,610,2,-23,-14,-9
720575940607757257,right,L5,611,-1,-18,-8,-10
720575940623163817,right,L5,612,-3,-26,-10,-16
720575940638214975,right,L5,613,-8,-4,6,-10
720575940635171747,right,L5,614,-2,-8,-2,-6
720575940623422344,right,L5,615,-7,-7,3,-10
720575940638487774,right,L5,616,-3,15,10,5
720575940620127573,right,L5,617,-2,-17,-7,-10
720575940615684498,right,L5,618,-1,24,13,11
720575940620407943,right,L5,619,-4,-19,-6,-13
720575940639980195,right,L5,620,7,1,-7,8
720575940632731417,right,L5,621,1,24,11,13
720575940622494725,right,L5,622,-5,20,15,5
720575940632547409,right,L5,623,1,13,5,8
720575940626584506,right,L5,624,1,-17,-10,-7
720575940620827730,right,L5,625,-2,24,14,10
720575940623380616,right,L5,626,-5,-8,1,-9
720575940626399821,right,L5,627,0,-1,-1,0
720575940628325735,right,L5,628,0,0,0,0
720575940628656427,right,L5,629,4,24,8,16
720575940624475786,right,L5,630,4,8,0,8
720575940620666962,right,L5,631,1,26,12,14
720575940634032796,right,L5,632,3,-20,-13,-7
720575940629079811,right,L5,633,-1,-24,-11,-13
720575940622456700,right,L5,634,-3,-15,-5,-10
720575940630242048,right,L5,635,6,-6,-9,3
720575940614340502,right,L5,636,0,6,3,3
720575940613833586,right,L5,637,3,-21,-14,-7
720575940609685717,right,L5,638,-1,7,4,3
720575940623361238,right,L5,639,-4,19,13,6
720575940613516310,right,L5,640,-1,-16,-7,-9
720575940625196327,right,L5,641,-8,-5,5,-10
720575940624796233,right,L5,642,-5,-11,-1,-10
720575940616859963,right,L5,643,6,14,1,13
720575940632804665,right,L5,644,-6,18,15,3
720575940611225698,right,L5,645,-4,27,17,10
720575940631725655,right,L5,646,6,17,2,15
720575940624597995,right,L5,647,-4,-7,0,-7
720575940617468043,right,L5,648,1,7,2,5
720575940621790685,right,L5,649,-1,5,3,2
720575940627910419,right,L5,650,-3,-25,-10,-15
720575940633533132,right,L5,651,-4,-5,1,-6
720575940629884798,right,L5,652,-6,-11,0,-11
720575940636247732,right,L5,653,-6,-12,0,-12
720575940643860276,right,L5,654,-3,8,7,1
720575940621629044,right,L5,655,6,-1,-7,6
720575940645187351,right,L5,656,0,-11,-6,-5
720575940615395478,right,L5,657,-2,-25,-11,-14
720575940640966096,right,L5,658,1,20,9,11
720575940630905849,right,L5,659,-4,-6,1,-7
720575940632524074,right,L5,660,2,28,12,16
720575940619212613,right,L5,661,-3,14,10,4
720575940637727834,right,L5,662,2,-1,-3,2
720575940615695071,right,L5,663,0,8,4,4
720575940620095623,right,L5,664,1,-27,-15,-12
720575940613037590,right,L5,665,7,-2,-8,6
720575940624523243,right,L5,666,7,-13,-14,1
720575940605919712,right,L5,667,1,-28,-15,-13
720575940622673996,right,L5,668,1,19,8,11
720575940644122990,right,L5,669,4,-16,-12,-4
720575940629857579,right,L5,670,5,5,-3,8
720575940628675144,right,L5,671,-4,-23,-8,-15
720575940629519403,right,L5,672,-8,11,13,-2
720575940632731935,right,L5,673,2,5,0,5
720575940629097744,right,L5,674,-4,-14,-3,-11
720575940622267539,right,L5,675,-7,19,16,3
720575940621109613,right,L5,676,-3,-21,-8,-13
720575940621805238,right,L5,677,0,11,5,6
720575940624997619,right,L5,678,3,-7,-7,0
720575940640671805,right,L5,679,4,18,5,13
720575940604947680,right,L5,680,-1,25,13,12
720575940614952594,right,L5,681,-2,-21,-9,-12
720575940630406364,right,L5,682,6,-8,-10,2
720575940612243313,right,L5,683,2,6,1,5
720575940638537816,right,L5,685,-5,-9,0,-9
720575940631452923,right,L5,686,5,-22,-16,-6
720575940660348801,right,L5,687,-6,-3,4,-7
720575940618100308,right,L5,688,-7,10,12,-2
720575940615711391,right,L5,689,-2,18,11,7
720575940616817013,right,L5,690,-7,-3,5,-8
720575940630379735,right,L5,691,-9,4,11,-7
720575940623652301,right,L5,692,-4,24,16,8
720575940628640471,right,L5,693,-3,25,15,10
720575940628382607,right,L5,695,-6,10,11,-1
720575940631555090,right,L5,696,-2,16,10,6
720575940618250821,right,L5,697,1,-22,-12,-10
720575940616331586,right,L5,698,6,-7,-10,3
720575940633377484,right,L5,699,-5,0,5,-5
720575940630154041,right,L5,700,5,15,2,13
720575940607202178,right,L5,701,0,-4,-2,-2
720575940608913673,right,L5,702,-5,23,16,7
720575940630886135,right,L5,703,-3,1,3,-2
720575940624795831,right,L5,704,-7,8,11,-3
720575940626485129,right,L5,705,1,1,-1,2
720575940638594020,right,L5,706,-7,-12,1,-13
720575940619240862,right,L5,707,-2,25,14,11
720575940638154608,right,L5,708,-4,-25,-9,-16
720575940628265575,right,L5,709,-2,-24,-10,-14
720575940628791095,right,L5,710,4,-25,-17,-8
720575940628423623,right,L5,711,-1,19,10,9
720575940622549324,right,L5,712,-7,12,13,-1
720575940624103914,right,L5,713,-6,16,14,2
720575940625534285,right,L5,714,5,12,1,11
720575940606706366,right,L5,715,4,10,1,9
720575940619166518,right,L5,716,4,-6,-7,1
720575940632451944,right,L5,717,2,-22,-13,-9
720575940626142757,right,L5,718,-5,24,17,7
720575940623134744,right,L5,719,1,27,12,15
720575940624126157,right,L5,720,-5,21,15,6
720575940637773278,right,L5,721,5,13,1,12
720575940630893817,right,L5,722,6,-15,-14,-1
720575940618285392,right,L5,723,-2,-11,-4,-7
720575940641484021,right,L5,724,4,2,-3,5
720575940627376958,right,L5,725,-3,-24,-9,-15
720575940618458769,right,L5,726,2,-28,-16,-12
720575940616951669,right,L5,728,7,12,-1,13
720575940635180395,right,L5,729,-3,29,17,12
720575940625013255,right,L5,730,7,0,-7,7
720575940648102020,right,L5,731,-6,9,10,-1
720575940625056231,right,L5,732,-3,6,6,0
720575940612731541,right,L5,733,-5,-17,-4,-13
720575940614315315,right,L5,734,2,0,-2,2
720575940624376503,right,L5,735,1,-23,-13,-10
720575940627561554,right,L5,736,-8,1,8,-7
720575940612036245,right,L5,737,0,19,9,10
720575940625751102,right,L5,738,-3,13,9,4
720575940611700942,right,L5,739,-7,2,8,-6
720575940632796217,right,L5,740,2,-8,-6,-2
720575940635203747,right,L5,741,-2,-14,-5,-9
720575940611441966,right,L5,742,-4,11,9,2
720575940621873833,right,L5,743,6,-19,-16,-3
720575940637686414,right,L5,744,-4,25,16,9
720575940620909761,right,L5,745,0,13,6,7
720575940637465701,right,L5,746,-3,3,4,-1
720575940614016150,right,L5,747,0,2,1,1
720575940610137557,right,L5,748,-4,20,14,6
720575940624593738,right,L5,749,-2,1,2,-1
720575940632881491,right,L5,750,4,-24,-16,-8
720575940626952325,right,L5,751,1,6,2,4
720575940621695983,right,L5,752,-2,7,5,2
720575940616797813,right,L5,753,-3,24,15,9
720575940621775877,right,L5,754,-1,-13,-6,-7
720575940630926680,right,L5,755,4,19,5,14
720575940630807607,right,L5,756,5,20,5,15
720575940619993803,right,L5,757,0,-6,-3,-3
720575940641536245,right,L5,758,5,-1,-6,5
720575940618673472,right,L5,759,7,14,0,14
720575940626092080,right,L5,760,0,17,8,9
720575940640062296,right,L5,761,-4,-18,-5,-13
720575940627537930,right,L5,762,0,14,7,7
720575940637363342,right,L5,764,-8,-6,5,-11
720575940626849641,right,L5,765,-3,9,7,2
720575940646704419,right,L5,766,2,-4,-4,0
720575940613378531,right,L5,768,3,5,-1,6
720575940620648112,right,L5,770,5,4,-3,7
720575940621673862,right,L5,771,3,-27,-17,-10
720575940614606061,right,L5,772,1,12,5,7
720575940626690588,right,L5,773,5,-19,-15,-4
720575940611386842,right,L5,774,-8,6,11,-5
720575940628095048,right,L5,775,5,22,6,16
720575940624035268,right,L5,776,5,21,5,16
720575940629505835,right,L5,777,6,20,4,16
720575940627985162,right,L5,778,4,25,8,17
720575940642222811,right,L5,779,5,24,7,17
720575940631838807,right,L5,780,-6,25,18,7
720575940631989063,right,L5,781,-5,26,18,8
720575940635697087,right,L5,783,-4,28,18,10
720575940615141039,right,L5,784,-4,29,18,11
720575940622025382,right,L5,785,-3,30,18,12
720575940608267650,right,L5,786,-2,30,17,13
720575940636216568,right,L5,790,-2,-27,-12,-15
720575940623917411,right,L5,791,-1,-28,-13,-15
720575940620220581,right,L5,792,8,2,-7,9
720575940618584091,right,L5,793,8,-6,-11,5
720575940622242053,right,L5,794,5,-26,-18,-8
720575940618890910,right,L5,795,6,-21,-17,-4
720575940618840221,right,L5,796,4,26,9,17
720575940634524441,right,Mi4,1,-6,13,12,1
720575940636731247,right,Mi4,2,-8,2,9,-7
720575940610068270,right,Mi4,3,6,-12,-12,0
720575940623038135,right,Mi4,4,-5,-21,-6,-15
720575940623102307,right,Mi4,5,-1,16,9,7
720575940622223088,right,Mi4,6,-2,-4,0,-4
720575940632738385,right,Mi4,7,-6,-6,3,-9
720575940643981728,right,Mi4,8,-4,26,17,9
720575940612088725,right,Mi4,9,4,9,0,9
720575940620265432,right,Mi4,10,5,-15,-13,-2
720575940612862230,right,Mi4,11,7,-14,-14,0
720575940615700369,right,Mi4,12,-7,9,11,-2
720575940613553381,right,Mi4,13,-1,-26,-12,-14
720575940617871956,right,Mi4,14,0,-27,-14,-13
720575940625524794,right,Mi4,15,2,-3,-4,1
720575940626461801,right,Mi4,16,-2,-16,-6,-10
720575940638419363,right,Mi4,17,1,-5,-4,-1
720575940619022529,right,Mi4,18,5,-16,-13,-3
720575940629552215,right,Mi4,19,-7,17,15,2
720575940618519526,right,Mi4,20,3,-11,-9,-2
720575940613649125,right,Mi4,21,-2,19,11,8
720575940611535257,right,Mi4,22,-1,3,2,1
720575940619744728,right,Mi4,23,-3,-16,-5,-11
720575940618990689,right,Mi4,24,-1,-10,-4,-6
720575940612182312,right,Mi4,25,-9,3,10,-7
720575940630770550,right,Mi4,26,1,-3,-3,0
720575940624376573,right,Mi4,27,0,-25,-13,-12
720575940625097998,right,Mi4,28,5,6,-2,8
720575940617739933,right,Mi4,29,-1,-3,-1,-2
720575940628575765,right,Mi4,30,6,16,2,14
720575940644239560,right,Mi4,31,0,16,8,8
720575940618558804,right,Mi4,32,0,12,6,6
720575940630003834,right,Mi4,33,3,18,6,12
720575940617336294,right,Mi4,34,6,18,3,15
720575940630077946,right,Mi4,35,1,-24,-13,-11
720575940634893975,right,Mi4,36,6,8,-2,10
720575940624524071,right,Mi4,37,1,5,1,4
720575940614630722,right,Mi4,38,0,-2,-1,-1
720575940636202095,right,Mi4,39,0,20,10,10
720575940618036258,right,Mi4,40,-2,-6,-1,-5
720575940605349804,right,Mi4,41,-3,28,17,11
720575940614750530,right,Mi4,42,-1,14,8,6
720575940620016251,right,Mi4,43,-5,18,14,4
720575940627081474,right,Mi4,44,5,-10,-10,0
720575940627592018,right,Mi4,45,-5,-1,4,-5
720575940637908131,right,Mi4,46,-5,15,12,3
720575940623360492,right,Mi4,47,-9,-1,8,-9
720575940630622713,right,Mi4,48,-4,-22,-7,-15
720575940624711658,right,Mi4,49,4,-4,-6,2
720575940621937904,right,Mi4,50,-2,21,12,9
720575940623104280,right,Mi4,51,0,-19,-10,-9
720575940639075817,right,Mi4,52,-1,-22,-10,-12
720575940624200887,right,Mi4,53,5,14,2,12
720575940622061061,right,Mi4,54,-4,3,5,-2
720575940632897873,right,Mi4,55,-4,-11,-2,-9
720575940627783817,right,Mi4,56,1,-13,-8,-5
720575940617102348,right,Mi4,57,6,-11,-12,1
720575940605893408,right,Mi4,58,3,12,3,9
720575940627011076,right,Mi4,59,-2,2,3,-1
720575940621508649,right,Mi4,60,-8,8,12,-4
720575940632596511,right,Mi4,61,-4,-4,2,-6
720575940634685375,right,Mi4,62,0,-29,-15,-14
720575940624907924,right,Mi4,63,4,12,2,10
720575940660397441,right,Mi4,64,4,-23,-16,-7
720575940627356682,right,Mi4,65,-1,28,15,13
720575940618090141,right,Mi4,66,2,15,5,10
720575940615156107,right,Mi4,67,-2,-13,-5,-8
720575940623125859,right,Mi4,68,3,16,5,11
720575940620113969,right,Mi4,69,1,8,3,5
720575940635141530,right,Mi4,70,-4,21,14,7
720575940624141960,right,Mi4,71,-2,-3,0,-3
720575940635663467,right,Mi4,72,0,-28,-14,-14
720575940620822352,right,Mi4,73,2,2,-1,3
720575940624877838,right,Mi4,74,-1,-9,-4,-5
720575940624354348,right,Mi4,75,-6,14,13,1
720575940613027301,right,Mi4,76,-3,-4,1,-5
720575940615819388,right,Mi4,77,2,-5,-5,0
720575940622464636,right,Mi4,78,2,20,8,12
720575940628006056,right,Mi4,79,2,1,-2,3
720575940621104716,right,Mi4,80,4,13,2,11
720575940630442199,right,Mi4,81,6,-2,-7,5
720575940627054595,right,Mi4,82,-7,7,10,-3
720575940607179138,right,Mi4,83,2,-21,-13,-8
720575940624247479,right,Mi4,84,-2,12,8,4
720575940621509046,right,Mi4,85,4,-22,-15,-7
720575940627499530,right,Mi4,86,-5,-7,1,-8
720575940628295428,right,Mi4,87,1,11,4,7
720575940622310938,right,Mi4,89,1,-19,-11,-8
720575940628813800,right,Mi4,90,-4,5,6,-1
720575940624190759,right,Mi4,91,-1,6,4,2
720575940622311126,right,Mi4,93,-6,3,7,-4
720575940623039368,right,Mi4,94,5,18,4,14
720575940612160113,right,Mi4,95,4,-21,-15,-6
720575940622296692,right,Mi4,96,1,-10,-6,-4
720575940628510459,right,Mi4,97,-5,2,6,-4
720575940624846375,right,Mi4,98,-1,-12,-5,-7
720575940623184929,right,Mi4,99,4,15,3,12
720575940623787619,right,Mi4,100,2,-10,-7,-3
720575940618576704,right,Mi4,101,-7,6,10,-4
720575940632895059,right,Mi4,102,3,13,3,10
720575940609319772,right,Mi4,103,7,9,-3,12
720575940614882666,right,Mi4,104,-1,-27,-13,-14
720575940624593643,right,Mi4,105,3,22,8,14
720575940628056320,right,Mi4,106,-7,11,12,-1
720575940623602410,right,Mi4,107,8,-2,-9,7
720575940641859291,right,Mi4,108,-3,-12,-3,-9
720575940616568645,right,Mi4,109,4,-5,-7,2
720575940627167567,right,Mi4,110,-7,0,7,-7
720575940639854243,right,Mi4,111,2,-24,-14,-10
720575940619574192,right,Mi4,112,-6,1,6,-5
720575940620314352,right,Mi4,113,-2,4,4,0
720575940634356660,right,Mi4,114,2,-13,-9,-4
720575940624187831,right,Mi4,115,-4,2,5,-3
720575940605106110,right,Mi4,116,-1,-8,-3,-5
720575940619632566,right,Mi4,117,-8,-2,7,-9
720575940618086710,right,Mi4,118,3,1,-3,4
720575940626168348,right,Mi4,119,-2,6,5,1
720575940628016400,right,Mi4,120,-1,-1,0,-1
720575940625258136,right,Mi4,121,-8,4,10,-6
720575940619893887,right,Mi4,122,-5,9,9,0
720575940633272983,right,Mi4,123,-8,10,13,-3
720575940631149655,right,Mi4,124,1,-7,-5,-2
720575940610888198,right,Mi4,125,5,9,-1,10
720575940622332954,right,Mi4,126,3,11,2,9
720575940616845941,right,Mi4,127,0,15,7,8
720575940635190623,right,Mi4,128,3,-22,-14,-8
720575940630486265,right,Mi4,129,0,-13,-7,-6
720575940635140709,right,Mi4,131,-6,20,16,4
720575940642495373,right,Mi4,132,2,4,0,4
720575940635694772,right,Mi4,133,-3,20,13,7
720575940624729236,right,Mi4,134,-5,-18,-4,-14
720575940610711189,right,Mi4,135,-3,-22,-8,-14
720575940626623690,right,Mi4,136,0,3,1,2
720575940622218785,right,Mi4,137,5,-7,-9,2
720575940617722257,right,Mi4,138,0,27,13,14
720575940626661950,right,Mi4,139,1,-14,-8,-6
720575940636327598,right,Mi4,140,3,8,1,7
720575940617465273,right,Mi4,141,5,-23,-17,-6
720575940621800630,right,Mi4,142,-2,-18,-7,-11
720575940661041025,right,Mi4,143,-4,16,12,4
720575940636761518,right,Mi4,144,7,-11,-13,2
720575940616588486,right,Mi4,145,0,4,2,2
720575940623585463,right,Mi4,146,1,-6,-4,-2
720575940624252671,right,Mi4,147,1,21,9,12
720575940632075724,right,Mi4,148,-7,-11,1,-12
720575940617101106,right,Mi4,149,6,-14,-13,-1
720575940631056865,right,Mi4,150,-8,5,10,-5
720575940644090568,right,Mi4,151,-3,-14,-4,-10
720575940611275491,right,Mi4,152,3,-15,-11,-4
720575940626783228,right,Mi4,153,8,0,-8,8
720575940629822531,right,Mi4,154,-8,0,8,-8
720575940633557355,right,Mi4,156,-9,1,9,-8
720575940639798400,right,Mi4,157,-1,-7,-3,-4
720575940614912402,right,Mi4,158,3,-5,-6,1
720575940615111018,right,Mi4,159,7,7,-4,11
720575940635684276,right,Mi4,160,-2,20,12,8
720575940620378247,right,Mi4,161,4,-14,-11,-3
720575940620365505,right,Mi4,162,-4,-2,3,-5
720575940611410915,right,Mi4,163,-9,7,12,-5
720575940619263568,right,Mi4,164,-1,-2,0,-2
720575940621900502,right,Mi4,165,4,16,4,12
720575940622870781,right,Mi4,166,0,18,9,9
720575940627336548,right,Mi4,167,0,-17,-9,-8
720575940624544915,right,Mi4,168,-1,17,9,8
720575940622177379,right,Mi4,169,0,-18,-9,-9
720575940639987584,right,Mi4,170,-5,1,5,-4
720575940620532529,right,Mi4,171,6,-20,-16,-4
720575940638244068,right,Mi4,172,1,22,10,12
720575940617870420,right,Mi4,173,2,-25,-15,-10
720575940614779229,right,Mi4,174,4,-15,-12,-3
720575940631604055,right,Mi4,175,-6,-7,2,-9
720575940616130246,right,Mi4,176,-2,13,8,5
720575940633978007,right,Mi4,177,-2,-1,1,-2
720575940617127307,right,Mi4,178,2,11,3,8
720575940616913547,right,Mi4,179,-5,-16,-3,-13
720575940637635294,right,Mi4,180,2,-27,-16,-11
720575940618477497,right,Mi4,181,1,-4,-3,-1
720575940616202589,right,Mi4,182,7,-10,-12,2
720575940635661466,right,Mi4,183,-5,-15,-3,-12
720575940615783234,right,Mi4,184,-6,-5,3,-8
720575940607509170,right,Mi4,185,2,-11,-8,-3
720575940622737117,right,Mi4,186,-1,26,14,12
720575940626863512,right,Mi4,187,3,21,7,14
720575940627550280,right,Mi4,188,-5,17,13,4
720575940615749698,right,Mi4,189,6,13,0,13
720575940638136902,right,Mi4,190,-3,-5,0,-5
720575940605490790,right,Mi4,191,-1,-11,-5,-6
720575940617127398,right,Mi4,193,-5,4,7,-3
720575940645611031,right,Mi4,194,0,-5,-3,-2
720575940650177145,right,Mi4,195,-3,-1,2,-3
720575940644263959,right,Mi4,196,-1,8,5,3
720575940611097554,right,Mi4,197,0,-20,-10,-10
720575940625419412,right,Mi4,198,6,2,-5,7
720575940645153303,right,Mi4,199,0,-12,-6,-6
720575940631676115,right,Mi4,200,-5,12,11,1
720575940629839738,right,Mi4,201,-8,9,12,-3
720575940633030611,right,Mi4,202,-1,27,14,13
720575940614265651,right,Mi4,203,3,-1,-4,3
720575940614614183,right,Mi4,204,5,-2,-6,4
720575940602943968,right,Mi4,205,5,-6,-8,2
720575940614410449,right,Mi4,206,-3,5,5,0
720575940625647800,right,Mi4,207,1,29,13,16
720575940627936967,right,Mi4,208,5,-21,-16,-5
720575940616546278,right,Mi4,209,-3,-8,-1,-7
720575940638170019,right,Mi4,210,-6,8,10,-2
720575940619426507,right,Mi4,211,-7,-1,6,-7
720575940625378279,right,Mi4,212,2,-16,-10,-6
720575940613784223,right,Mi4,213,3,-4,-5,1
720575940620473876,right,Mi4,214,-5,3,6,-3
720575940628015379,right,Mi4,215,6,7,-3,10
720575940618640965,right,Mi4,216,2,19,7,12
720575940628889872,right,Mi4,217,6,15,1,14
720575940614345169,right,Mi4,218,2,10,3,7
720575940638155742,right,Mi4,219,6,-4,-8,4
720575940637498202,right,Mi4,220,2,-6,-5,-1
720575940619425739,right,Mi4,221,-7,3,8,-5
720575940621095361,right,Mi4,222,-3,26,16,10
720575940630888185,right,Mi4,223,-2,26,15,11
720575940647127348,right,Mi4,224,0,5,2,3
720575940631021372,right,Mi4,225,2,-26,-15,-11
720575940620862993,right,Mi4,226,5,19,4,15
720575940638517732,right,Mi4,227,-7,5,9,-4
720575940621752411,right,Mi4,228,-7,1,7,-6
720575940621195540,right,Mi4,229,5,2,-4,6
720575940615801798,right,Mi4,230,2,9,2,7
720575940629210076,right,Mi4,231,4,-12,-10,-2
720575940623697165,right,Mi4,232,-4,13,10,3
720575940623460339,right,Mi4,233,4,-13,-11,-2
720575940623635848,right,Mi4,235,4,11,1,10
720575940621252779,right,Mi4,236,-1,4,3,1
720575940606978761,right,Mi4,237,-2,27,15,12
720575940641252048,right,Mi4,238,-8,-3,6,-9
720575940613662530,right,Mi4,239,-6,6,9,-3
720575940621269998,right,Mi4,240,-4,-3,2,-5
720575940614058280,right,Mi4,241,2,-17,-11,-6
720575940615758709,right,Mi4,242,-4,6,7,-1
720575940630780155,right,Mi4,243,-1,-21,-10,-11
720575940623294925,right,Mi4,244,-4,-12,-2,-10
720575940628537862,right,Mi4,245,-5,-3,3,-6
720575940621511441,right,Mi4,246,-4,15,11,4
720575940624197045,right,Mi4,247,-4,-15,-4,-11
720575940635737336,right,Mi4,248,-6,0,6,-6
720575940623309261,right,Mi4,249,2,-12,-8,-4
720575940620435024,right,Mi4,250,-1,1,1,0
720575940629939756,right,Mi4,251,-1,-14,-6,-8
720575940617405755,right,Mi4,252,3,23,8,15
720575940635146431,right,Mi4,253,5,16,3,13
720575940611844787,right,Mi4,254,3,-24,-15,-9
720575940627501445,right,Mi4,255,-6,-13,-1,-12
720575940617620993,right,Mi4,256,5,-20,-15,-5
720575940623174803,right,Mi4,257,2,21,8,13
720575940613267367,right,Mi4,258,-4,-17,-5,-12
720575940616352578,right,Mi4,259,-7,-5,4,-9
720575940623112547,right,Mi4,260,-3,19,12,7
720575940616421307,right,Mi4,261,-1,13,7,6
720575940619173430,right,Mi4,262,1,-11,-7,-4
720575940613382678,right,Mi4,263,-3,4,5,-1
720575940628158184,right,Mi4,264,-1,-6,-2,-4
720575940615810909,right,Mi4,265,-6,-1,5,-6
720575940628977168,right,Mi4,266,-1,-25,-12,-13
720575940630369989,right,Mi4,267,-6,2,7,-5
720575940623330062,right,Mi4,268,7,-6,-10,4
720575940624074436,right,Mi4,269,2,-19,-12,-7
720575940623580307,right,Mi4,270,1,-8,-5,-3
720575940628103428,right,Mi4,272,3,-2,-4,2
720575940607270018,right,Mi4,273,-6,23,17,6
720575940626479562,right,Mi4,274,6,4,-4,8
720575940633695736,right,Mi4,275,-8,-1,7,-8
720575940630659840,right,Mi4,276,2,3,-1,4
720575940623437606,right,Mi4,277,7,-3,-9,6
720575940619772513,right,Mi4,278,-5,10,10,0
720575940618066978,right,Mi4,279,-4,8,8,0
720575940638834246,right,Mi4,280,-6,-14,-1,-13
720575940628090156,right,Mi4,281,-9,2,10,-8
720575940636964975,right,Mi4,282,0,26,13,13
720575940608910037,right,Mi4,283,-4,4,6,-2
720575940616952150,right,Mi4,284,0,25,12,13
720575940639866275,right,Mi4,285,6,-18,-15,-3
720575940638121188,right,Mi4,286,0,-24,-12,-12
720575940619133489,right,Mi4,287,-5,13,11,2
720575940620774383,right,Mi4,288,-1,30,16,14
720575940652750838,right,Mi4,289,-1,11,6,5
720575940625847271,right,Mi4,290,5,-24,-17,-7
720575940617706937,right,Mi4,291,7,2,-6,8
720575940642979876,right,Mi4,292,-4,18,13,5
720575940633215405,right,Mi4,293,4,-17,-13,-4
720575940622313249,right,Mi4,294,1,-20,-11,-9
720575940622201121,right,Mi4,295,-2,29,16,13
720575940645009444,right,Mi4,296,1,-18,-10,-8
720575940626846986,right,Mi4,297,7,-9,-12,3
720575940619767661,right,Mi4,298,-5,5,7,-2
720575940630247106,right,Mi4,299,-4,12,10,2
720575940627172248,right,Mi4,300,4,-18,-13,-5
720575940639800910,right,Mi4,301,-5,16,13,3
720575940620519333,right,Mi4,302,2,17,6,11
720575940626369086,right,Mi4,303,-5,22,16,6
720575940621797756,right,Mi4,304,6,5,-4,9
720575940610520014,right,Mi4,305,-7,4,9,-5
720575940636509326,right,Mi4,307,5,-25,-18,-7
720575940620074887,right,Mi4,308,-5,8,9,-1
720575940622337259,right,Mi4,309,-6,12,12,0
720575940623863531,right,Mi4,310,2,22,9,13
720575940628966359,right,Mi4,311,-7,15,14,1
720575940620413609,right,Mi4,312,4,-7,-8,1
720575940635583584,right,Mi4,313,7,3,-6,9
720575940640847704,right,Mi4,314,-9,5,11,-6
720575940643304352,right,Mi4,315,-3,-6,0,-6
720575940623215529,right,Mi4,316,5,-4,-7,3
720575940627945384,right,Mi4,317,-5,-4,3,-7
720575940618253083,right,Mi4,318,4,-19,-14,-5
720575940617101213,right,Mi4,319,-2,5,4,1
720575940629319579,right,Mi4,320,-2,-5,-1,-4
720575940623144481,right,Mi4,321,8,4,-6,10
720575940629471238,right,Mi4,322,2,26,11,15
720575940621458378,right,Mi4,323,-7,-13,0,-13
720575940630329088,right,Mi4,324,3,24,9,15
720575940623304141,right,Mi4,325,5,1,-5,6
720575940623421951,right,Mi4,326,2,16,6,10
720575940624168959,right,Mi4,327,5,3,-4,7
720575940623327495,right,Mi4,328,5,-9,-10,1
720575940641663952,right,Mi4,329,0,24,12,12
720575940615343510,right,Mi4,330,3,3,-2,5
720575940627966077,right,Mi4,331,1,-15,-9,-6
720575940630205054,right,Mi4,332,4,-26,-17,-9
720575940640347709,right,Mi4,333,0,-21,-11,-10
720575940626238666,right,Mi4,334,1,-26,-14,-12
720575940621314543,right,Mi4,335,2,8,2,6
720575940623829738,right,Mi4,336,0,23,11,12
720575940622305825,right,Mi4,337,-5,-6,2,-8
720575940639110051,right,Mi4,338,-1,0,1,-1
720575940622685398,right,Mi4,339,6,11,-1,12
720575940643986592,right,Mi4,340,-4,17,12,5
720575940611059922,right,Mi4,341,6,-17,-15,-2
720575940627225866,right,Mi4,342,2,-15,-10,-5
720575940627563653,right,Mi4,343,-3,27,16,11
720575940629731075,right,Mi4,344,-2,-15,-6,-9
720575940632393291,right,Mi4,345,3,-12,-9,-3
720575940619773606,right,Mi4,346,-7,-9,2,-11
720575940630877433,right,Mi4,347,-5,-13,-2,-11
720575940626779013,right,Mi4,348,3,14,4,10
720575940641388789,right,Mi4,349,-5,-14,-2,-12
720575940632442951,right,Mi4,350,1,15,6,9
720575940636747639,right,Mi4,351,-1,-17,-8,-9
720575940632045891,right,Mi4,352,-2,28,16,12
720575940631618809,right,Mi4,353,2,24,10,14
720575940638620905,right,Mi4,354,-2,-26,-11,-15
720575940620712838,right,Mi4,355,-7,-6,4,-10
720575940630220844,right,Mi4,356,0,22,11,11
720575940635148468,right,Mi4,357,4,17,4,13
720575940613979176,right,Mi4,358,-3,17,11,6
720575940631139435,right,Mi4,359,2,23,9,14
720575940629029392,right,Mi4,360,-5,19,14,5
720575940621786401,right,Mi4,361,0,-7,-4,-3
720575940643988128,right,Mi4,362,2,-20,-12,-8
720575940636442725,right,Mi4,363,7,-4,-9,5
720575940638888245,right,Mi4,364,4,4,-2,6
720575940615062191,right,Mi4,365,4,7,-1,8
720575940605842878,right,Mi4,366,-5,-20,-5,-15
720575940627773096,right,Mi4,367,-6,-15,-2,-13
720575940635040887,right,Mi4,368,-4,-20,-6,-14
720575940612333521,right,Mi4,369,5,-5,-8,3
720575940611114981,right,Mi4,370,-3,21,13,8
720575940606913154,right,Mi4,371,6,-5,-9,4
720575940628459281,right,Mi4,372,1,-2,-2,0
720575940627654202,right,Mi4,373,1,-21,-12,-9
720575940631541445,right,Mi4,374,2,13,4,9
720575940630595103,right,Mi4,375,-6,7,9,-2
720575940610108484,right,Mi4,376,-7,-10,2,-12
720575940623396607,right,Mi4,377,0,7,3,4
720575940626360828,right,Mi4,378,-3,18,12,6
720575940654872737,right,Mi4,379,3,-17,-12,-5
720575940619741505,right,Mi4,380,-1,29,15,14
720575940621740404,right,Mi4,381,-8,-9,3,-12
720575940612815346,right,Mi4,382,3,-6,-6,0
720575940625155884,right,Mi4,383,-6,11,11,0
720575940626375230,right,Mi4,384,-6,-2,5,-7
720575940629765758,right,Mi4,385,-3,-18,-6,-12
720575940645983511,right,Mi4,386,-6,19,15,4
720575940626347108,right,Mi4,387,-1,-15,-7,-8
720575940610072644,right,Mi4,388,3,19,6,13
720575940633542431,right,Mi4,389,-6,-16,-2,-14
720575940625099364,right,Mi4,390,-6,-9,1,-10
720575940610071108,right,Mi4,392,-4,7,7,0
720575940621837192,right,Mi4,393,-1,22,12,10
720575940638261311,right,Mi4,394,-7,-8,3,-11
720575940627358474,right,Mi4,395,0,-22,-11,-11
720575940636370021,right,Mi4,396,-1,10,6,4
720575940629028337,right,Mi4,397,-3,-19,-7,-12
720575940625079027,right,Mi4,398,-3,22,14,8
720575940641899483,right,Mi4,399,-4,-24,-8,-16
720575940627344996,right,Mi4,401,-2,-19,-8,-11
720575940632532428,right,Mi4,402,3,26,10,16
720575940631572536,right,Mi4,403,-2,-12,-4,-8
720575940616462523,right,Mi4,404,-1,20,11,9
720575940624249269,right,Mi4,405,3,10,2,8
720575940610551506,right,Mi4,407,-5,-10,0,-10
720575940639400893,right,Mi4,408,-6,-4,4,-8
720575940622777880,right,Mi4,409,0,-3,-2,-1
720575940615559766,right,Mi4,410,-2,-2,1,-3
720575940622684374,right,Mi4,411,-5,-19,-5,-14
720575940624075824,right,Mi4,412,-6,21,16,5
720575940649871737,right,Mi4,413,-2,-7,-2,-5
720575940606069937,right,Mi4,414,4,21,6,15
720575940622122710,right,Mi4,415,6,12,0,12
720575940637596649,right,Mi4,416,3,-8,-7,-1
720575940622837245,right,Mi4,417,-6,-10,1,-11
720575940625573197,right,Mi4,418,-2,15,9,6
720575940640394867,right,Mi4,419,-3,-11,-3,-8
720575940607476174,right,Mi4,420,6,-3,-8,5
720575940629241799,right,Mi4,422,-7,-4,5,-9
720575940632045741,right,Mi4,423,3,-18,-12,-6
720575940632348995,right,Mi4,424,-3,-2,2,-4
720575940605005280,right,Mi4,425,3,20,7,13
720575940628015620,right,Mi4,426,-3,0,3,-3
720575940613085554,right,Mi4,427,5,-18,-14,-4
720575940636594533,right,Mi4,428,-2,23,13,10
720575940614885010,right,Mi4,429,-2,14,9,5
720575940612191345,right,Mi4,430,-3,-7,-1,-6
720575940634626018,right,Mi4,431,-2,-10,-3,-7
720575940616395963,right,Mi4,432,-5,7,8,-1
720575940641162203,right,Mi4,433,0,-8,-4,-4
720575940634233881,right,Mi4,434,-3,7,6,1
720575940626873718,right,Mi4,435,5,-17,-14,-3
720575940631598031,right,Mi4,436,0,-15,-8,-7
720575940612984725,right,Mi4,437,-3,12,9,3
720575940614618274,right,Mi4,438,2,27,11,16
720575940628769385,right,Mi4,439,-3,-9,-2,-7
720575940614905506,right,Mi4,440,1,23,10,13
720575940629293628,right,Mi4,441,3,-16,-11,-5
720575940619988557,right,Mi4,442,-5,25,17,8
720575940618925739,right,Mi4,443,-6,4,8,-4
720575940620743706,right,Mi4,444,4,-10,-9,-1
720575940647233844,right,Mi4,445,-2,8,6,2
720575940626175162,right,Mi4,446,2,-14,-9,-5
720575940620492404,right,Mi4,447,-1,2,2,0
720575940622789409,right,Mi4,448,0,30,15,15
720575940624485264,right,Mi4,449,6,-16,-14,-2
720575940612489565,right,Mi4,450,2,-9,-7,-2
720575940627758869,right,Mi4,451,4,20,6,14
720575940616449074,right,Mi4,452,1,-9,-6,-3
720575940627219742,right,Mi4,453,3,25,9,16
720575940615949791,right,Mi4,454,5,-12,-11,-1
720575940620701574,right,Mi4,455,7,-7,-11,4
720575940605809794,right,Mi4,456,0,21,10,11
720575940620730817,right,Mi4,457,-2,17,10,7
720575940622805469,right,Mi4,458,5,0,-5,5
720575940634644961,right,Mi4,459,5,-3,-7,4
720575940646092910,right,Mi4,460,-3,-20,-7,-13
720575940641967349,right,Mi4,461,7,-5,-10,5
720575940618224667,right,Mi4,462,-1,18,10,8
720575940620347595,right,Mi4,463,5,17,3,14
720575940623629094,right,Mi4,464,4,0,-4,4
720575940630839656,right,Mi4,465,3,0,-3,3
720575940630218178,right,Mi4,466,1,14,6,8
720575940639604558,right,Mi4,467,-2,-20,-8,-12
720575940621356626,right,Mi4,468,-3,11,8,3
720575940632696542,right,Mi4,469,-7,13,13,0
720575940624700088,right,Mi4,470,4,-9,-9,0
720575940623892685,right,Mi4,471,3,-26,-16,-10
720575940635330411,right,Mi4,472,1,25,11,14
720575940624116407,right,Mi4,473,-4,23,15,8
720575940632534609,right,Mi4,474,-3,-17,-6,-11
720575940605328928,right,Mi4,475,-4,-1,3,-4
720575940616891148,right,Mi4,476,-1,15,8,7
720575940622166000,right,Mi4,477,-3,2,4,-2
720575940621111629,right,Mi4,478,-7,16,15,1
720575940623628582,right,Mi4,479,-2,10,7,3
720575940632084072,right,Mi4,480,3,-19,-13,-6
720575940608009750,right,Mi4,481,4,-8,-8,0
720575940628378311,right,Mi4,482,1,17,7,10
720575940622666504,right,Mi4,483,2,-7,-6,-1
720575940623277069,right,Mi4,484,3,-9,-8,-1
720575940626092071,right,Mi4,485,-3,-3,1,-4
720575940624170189,right,Mi4,486,0,1,0,1
720575940621292826,right,Mi4,487,1,-1,-2,1
720575940630109440,right,Mi4,488,7,5,-5,10
720575940636893582,right,Mi4,489,-3,10,8,2
720575940613952479,right,Mi4,490,-5,6,8,-2
720575940638771263,right,Mi4,491,7,-1,-8,7
720575940624254632,right,Mi4,492,-7,-2,6,-8
720575940633696851,right,Mi4,493,-3,23,14,9
720575940628067836,right,Mi4,494,0,29,14,15
720575940622048425,right,Mi4,497,6,1,-6,7
720575940613059862,right,Mi4,498,6,10,-1,11
720575940630625474,right,Mi4,499,5,10,0,10
720575940605912254,right,Mi4,500,7,-8,-11,3
720575940615613842,right,Mi4,501,1,2,0,2
720575940620896289,right,Mi4,503,3,17,5,12
720575940613663658,right,Mi4,504,-2,9,6,3
720575940619397189,right,Mi4,505,6,-22,-17,-5
720575940629389827,right,Mi4,506,1,-12,-7,-5
720575940626292773,right,Mi4,507,-5,-12,-1,-11
720575940627034457,right,Mi4,508,-5,11,10,1
720575940620708448,right,Mi4,509,-4,10,9,1
720575940627421468,right,Mi4,510,-2,11,7,4
720575940632922927,right,Mi4,511,5,-11,-11,0
720575940639649606,right,Mi4,512,6,0,-6,6
720575940652658166,right,Mi4,513,-4,-13,-3,-10
720575940648420473,right,Mi4,514,-4,-10,-1,-9
720575940620972141,right,Mi4,515,-8,-7,4,-11
720575940623602666,right,Mi4,516,7,-18,-16,-2
720575940619294526,right,Mi4,518,-4,22,15,7
720575940633830113,right,Mi4,519,-5,-5,2,-7
720575940640205656,right,Mi4,520,-2,-22,-9,-13
720575940637856996,right,Mi4,521,6,-9,-11,2
720575940620791430,right,Mi4,522,-4,0,4,-4
720575940655201953,right,Mi4,523,2,14,5,9
720575940608639602,right,Mi4,524,4,-20,-14,-6
720575940613880031,right,Mi4,525,-1,-20,-9,-11
720575940604941024,right,Mi4,526,0,-10,-5,-5
720575940615758041,right,Mi4,527,-4,-8,0,-8
720575940621673200,right,Mi4,528,2,7,1,6
720575940632805919,right,Mi4,529,2,-2,-3,1
720575940620237648,right,Mi4,530,-3,-13,-4,-9
720575940635628951,right,Mi4,531,1,0,-1,1
720575940622223487,right,Mi4,532,-8,7,11,-4
720575940633017927,right,Mi4,533,0,-16,-8,-8
720575940614780158,right,Mi4,534,3,2,-2,4
720575940630198016,right,Mi4,535,8,-4,-10,6
720575940618397723,right,Mi4,536,3,4,-1,5
720575940619040513,right,Mi4,537,0,-23,-12,-11
720575940618593510,right,Mi4,538,-4,1,4,-3
720575940610656153,right,Mi4,539,-6,15,13,2
720575940628815857,right,Mi4,540,-2,-9,-3,-6
720575940645608983,right,Mi4,541,-4,14,11,3
720575940620594014,right,Mi4,542,6,-13,-13,0
720575940627842280,right,Mi4,543,-1,-4,-1,-3
720575940618250779,right,Mi4,544,3,-13,-10,-3
720575940612858646,right,Mi4,545,5,11,0,11
720575940611475810,right,Mi4,546,3,6,0,6
720575940620258901,right,Mi4,547,-1,21,11,10
720575940635309675,right,Mi4,548,1,-16,-9,-7
720575940623654069,right,Mi4,549,0,-9,-5,-4
720575940604209580,right,Mi4,550,-2,3,3,0
720575940627131923,right,Mi4,551,-4,-9,-1,-8
720575940617927641,right,Mi4,552,4,-1,-5,4
720575940619218481,right,Mi4,553,-3,16,11,5
720575940625089661,right,Mi4,554,-9,-3,7,-10
720575940620736171,right,Mi4,555,-4,9,8,1
720575940621071342,right,Mi4,556,0,10,5,5
720575940627974174,right,Mi4,557,6,-10,-11,1
720575940618212057,right,Mi4,558,-4,-21,-7,-14
720575940614022290,right,Mi4,559,-6,22,17,5
720575940613865183,right,Mi4,560,-7,14,14,0
720575940623130718,right,Mi4,561,5,7,-2,9
720575940622334121,right,Mi4,562,-5,-2,4,-6
720575940624245652,right,Mi4,563,5,-13,-12,-1
720575940630703647,right,Mi4,564,3,-23,-15,-8
720575940616869318,right,Mi4,565,0,-26,-13,-13
720575940627281033,right,Mi4,566,5,-8,-9,1
720575940614407889,right,Mi4,567,-2,22,13,9
720575940607286146,right,Mi4,568,-6,-8,2,-10
720575940635468735,right,Mi4,569,6,6,-3,9
720575940638253790,right,Mi4,570,2,25,10,15
720575940627633738,right,Mi4,571,0,-14,-7,-7
720575940615215958,right,Mi4,572,-8,3,9,-6
720575940621341405,right,Mi4,573,4,14,3,11
720575940613140466,right,Mi4,574,-6,5,8,-3
720575940626185244,right,Mi4,576,0,28,14,14
720575940616128780,right,Mi4,577,5,-14,-12,-2
720575940612130491,right,Mi4,578,4,-11,-10,-1
720575940618576197,right,Mi4,579,-3,-10,-2,-8
720575940618129691,right,Mi4,580,-2,-23,-10,-13
720575940638597949,right,Mi4,581,3,9,1,8
720575940622691708,right,Mi4,582,-1,23,12,11
720575940630411564,right,Mi4,583,3,-25,-16,-9
720575940625284284,right,Mi4,584,4,23,7,16
720575940628612625,right,Mi4,585,-1,-23,-11,-12
720575940640876752,right,Mi4,586,2,18,7,11
720575940627128394,right,Mi4,587,4,22,7,15
720575940605251756,right,Mi4,588,1,4,1,3
720575940631026629,right,Mi4,589,-1,-5,-2,-3
720575940609977301,right,Mi4,590,1,9,3,6
720575940613839986,right,Mi4,591,3,-3,-5,2
720575940616450940,right,Mi4,593,3,-14,-10,-4
720575940607177494,right,Mi4,594,7,-16,-15,-1
720575940623438121,right,Mi4,595,7,-12,-13,1
720575940619349371,right,Mi4,596,-4,-16,-4,-12
720575940629005059,right,Mi4,597,4,1,-4,5
720575940607382146,right,Mi4,598,2,-18,-11,-7
720575940621412336,right,Mi4,599,-1,9,5,4
720575940612986390,right,Mi4,600,3,-10,-8,-2
720575940624486729,right,Mi4,601,1,16,7,9
720575940633864417,right,Mi4,602,4,-2,-5,3
720575940623078755,right,Mi4,603,-3,-23,-9,-14
720575940645390190,right,Mi4,604,-6,-17,-3,-14
720575940619694016,right,Mi4,605,3,15,4,11
720575940627388488,right,Mi4,606,-1,-19,-9,-10
720575940632691231,right,Mi4,607,1,18,8,10
720575940620947695,right,Mi4,608,1,10,4,6
720575940633929628,right,Mi4,609,-2,0,2,-2
720575940616505973,right,Mi4,610,2,-23,-14,-9
720575940619239582,right,Mi4,611,-1,-18,-8,-10
720575940642611419,right,Mi4,612,-3,-26,-10,-16
720575940633050285,right,Mi4,613,-8,-4,6,-10
720575940617253718,right,Mi4,614,-2,-8,-2,-6
720575940623133976,right,Mi4,615,-7,-7,3,-10
720575940631180973,right,Mi4,616,-3,15,10,5
720575940644374051,right,Mi4,617,-2,-17,-7,-10
720575940639831411,right,Mi4,618,-1,24,13,11
720575940624002707,right,Mi4,619,-4,-19,-6,-13
720575940640032163,right,Mi4,620,7,1,-7,8
720575940623091299,right,Mi4,621,1,24,11,13
720575940636299327,right,Mi4,622,-5,20,15,5
720575940623692179,right,Mi4,623,1,13,5,8
720575940609499349,right,Mi4,624,1,-17,-10,-7
720575940607781129,right,Mi4,625,-2,24,14,10
720575940610196804,right,Mi4,626,-5,-8,1,-9
720575940640557275,right,Mi4,627,0,-1,-1,0
720575940638454325,right,Mi4,628,0,0,0,0
720575940617729885,right,Mi4,629,4,24,8,16
720575940624891284,right,Mi4,631,1,26,12,14
720575940635302836,right,Mi4,632,3,-20,-13,-7
720575940620593835,right,Mi4,633,-1,-24,-11,-13
720575940640153405,right,Mi4,634,-3,-15,-5,-10
720575940631230275,right,Mi4,635,6,-6,-9,3
720575940617384678,right,Mi4,636,0,6,3,3
720575940639902579,right,Mi4,637,3,-21,-14,-7
720575940635673951,right,Mi4,639,-4,19,13,6
720575940624233218,right,Mi4,640,-1,-16,-7,-9
720575940631499595,right,Mi4,641,-8,-5,5,-10
720575940639536718,right,Mi4,642,-5,-11,-1,-10
720575940623056161,right,Mi4,643,6,14,1,13
720575940632388252,right,Mi4,644,-6,18,15,3
720575940637387376,right,Mi4,645,-4,27,17,10
720575940626349815,right,Mi4,646,6,17,2,15
720575940627936787,right,Mi4,647,-4,-7,0,-7
720575940613047794,right,Mi4,648,1,7,2,5
720575940635617391,right,Mi4,650,-3,-25,-10,-15
720575940613137389,right,Mi4,651,-4,-5,1,-6
720575940646624291,right,Mi4,652,-6,-11,0,-11
720575940614405757,right,Mi4,653,-6,-12,0,-12
720575940652675318,right,Mi4,654,-3,8,7,1
720575940620063902,right,Mi4,655,6,-1,-7,6
720575940611642517,right,Mi4,656,0,-11,-6,-5
720575940630406522,right,Mi4,657,-2,-25,-11,-14
720575940622116961,right,Mi4,658,1,20,9,11
720575940626926090,right,Mi4,659,-4,-6,1,-7
720575940619981214,right,Mi4,660,2,28,12,16
720575940631231033,right,Mi4,661,-3,14,10,4
720575940620439233,right,Mi4,662,2,-1,-3,2
720575940628338961,right,Mi4,663,0,8,4,4
720575940628966699,right,Mi4,664,1,-27,-15,-12
720575940631841361,right,Mi4,665,7,-2,-8,6
720575940615529084,right,Mi4,666,7,-13,-14,1
720575940626491138,right,Mi4,667,1,-28,-15,-13
720575940627254409,right,Mi4,668,1,19,8,11
720575940629936444,right,Mi4,669,4,-16,-12,-4
720575940616069682,right,Mi4,671,-4,-23,-8,-15
720575940624493100,right,Mi4,672,-8,11,13,-2
720575940625422538,right,Mi4,673,2,5,0,5
720575940634473628,right,Mi4,674,-4,-14,-3,-11
720575940643216407,right,Mi4,675,-7,19,16,3
720575940615244690,right,Mi4,676,-3,-21,-8,-13
720575940614716979,right,Mi4,677,0,11,5,6
720575940624213685,right,Mi4,678,3,-7,-7,0
720575940620373009,right,Mi4,679,4,18,5,13
720575940625690099,right,Mi4,680,-1,25,13,12
720575940634997911,right,Mi4,681,-2,-21,-9,-12
720575940632436072,right,Mi4,682,6,-8,-10,2
720575940614309416,right,Mi4,683,2,6,1,5
720575940619573876,right,Mi4,684,-6,17,14,3
720575940609912587,right,Mi4,685,-5,-9,0,-9
720575940617455931,right,Mi4,686,5,-22,-16,-6
720575940612686053,right,Mi4,687,-6,-3,4,-7
720575940615013974,right,Mi4,688,-7,10,12,-2
720575940608555868,right,Mi4,689,-2,18,11,7
720575940620595904,right,Mi4,690,-7,-3,5,-8
720575940624523824,right,Mi4,691,-9,4,11,-7
720575940636982446,right,Mi4,692,-4,24,16,8
720575940616078278,right,Mi4,693,-3,25,15,10
720575940609755342,right,Mi4,695,-6,10,11,-1
720575940632682009,right,Mi4,696,-2,16,10,6
720575940619103030,right,Mi4,697,1,-22,-12,-10
720575940623327751,right,Mi4,698,6,-7,-10,3
720575940615839389,right,Mi4,699,-5,0,5,-5
720575940615713586,right,Mi4,700,5,15,2,13
720575940624319752,right,Mi4,701,0,-4,-2,-2
720575940620597012,right,Mi4,702,-5,23,16,7
720575940624542541,right,Mi4,703,-3,1,3,-2
720575940632069657,right,Mi4,704,-7,8,11,-3
720575940637152820,right,Mi4,705,1,1,-1,2
720575940628377487,right,Mi4,707,-2,25,14,11
720575940615710406,right,Mi4,708,-4,-25,-9,-16
720575940622722525,right,Mi4,709,-2,-24,-10,-14
720575940605378476,right,Mi4,710,4,-25,-17,-8
720575940618091009,right,Mi4,711,-1,19,10,9
720575940631222585,right,Mi4,712,-7,12,13,-1
720575940611091173,right,Mi4,713,-6,16,14,2
720575940619794648,right,Mi4,714,5,12,1,11
720575940627510794,right,Mi4,715,4,10,1,9
720575940622644556,right,Mi4,716,4,-6,-7,1
720575940632347463,right,Mi4,717,2,-22,-13,-9
720575940624751630,right,Mi4,718,-5,24,17,7
720575940616093964,right,Mi4,719,1,27,12,15
720575940645131287,right,Mi4,720,-5,21,15,6
720575940634637247,right,Mi4,721,5,13,1,12
720575940614653182,right,Mi4,722,6,-15,-14,-1
720575940617224633,right,Mi4,723,-2,-11,-4,-7
720575940640662899,right,Mi4,724,4,2,-3,5
720575940620636225,right,Mi4,725,-3,-24,-9,-15
720575940633170503,right,Mi4,726,2,-28,-16,-12
720575940628047229,right,Mi4,727,7,6,-4,10
720575940644851479,right,Mi4,728,7,12,-1,13
720575940616327998,right,Mi4,729,-3,29,17,12
720575940614783138,right,Mi4,730,7,0,-7,7
720575940634629857,right,Mi4,731,-6,9,10,-1
720575940620384341,right,Mi4,732,-3,6,6,0
720575940618071124,right,Mi4,733,-5,-17,-4,-13
720575940613640258,right,Mi4,734,2,0,-2,2
720575940629098027,right,Mi4,735,1,-23,-13,-10
720575940610905202,right,Mi4,736,-8,1,8,-7
720575940633342303,right,Mi4,737,0,19,9,10
720575940626050826,right,Mi4,738,-3,13,9,4
720575940613522661,right,Mi4,739,-7,2,8,-6
720575940607606294,right,Mi4,740,2,-8,-6,-2
720575940617836006,right,Mi4,741,-2,-14,-5,-9
720575940641484277,right,Mi4,742,-4,11,9,2
720575940620856417,right,Mi4,743,6,-19,-16,-3
720575940628600326,right,Mi4,744,-4,25,16,9
720575940631690794,right,Mi4,745,0,13,6,7
720575940619854715,right,Mi4,746,-3,3,4,-1
720575940659418241,right,Mi4,747,0,2,1,1
720575940616382014,right,Mi4,748,-4,20,14,6
720575940621807062,right,Mi4,749,-2,1,2,-1
720575940638411497,right,Mi4,750,4,-24,-16,-8
720575940610107716,right,Mi4,751,1,6,2,4
720575940623048413,right,Mi4,752,-2,7,5,2
720575940607304066,right,Mi4,753,-3,24,15,9
720575940634726648,right,Mi4,754,-1,-13,-6,-7
720575940640365629,right,Mi4,755,4,19,5,14
720575940615392578,right,Mi4,756,5,20,5,15
720575940624976142,right,Mi4,757,0,-6,-3,-3
720575940611656891,right,Mi4,758,5,-1,-6,5
720575940647390596,right,Mi4,759,7,14,0,14
720575940632063289,right,Mi4,760,0,17,8,9
720575940620032971,right,Mi4,761,-4,-18,-5,-13
720575940620927983,right,Mi4,762,0,14,7,7
720575940614312379,right,Mi4,763,-5,14,12,2
720575940627174135,right,Mi4,765,-3,9,7,2
720575940632415458,right,Mi4,766,2,-4,-4,0
720575940618126107,right,Mi4,767,1,28,13,15
720575940621697729,right,Mi4,769,4,-27,-18,-9
720575940622132464,right,Mi4,771,3,-27,-17,-10
720575940621240302,right,Mi4,772,1,12,5,7
720575940612457139,right,Mi4,773,5,-19,-15,-4
720575940620225313,right,Mi4,774,-8,6,11,-5
720575940626836349,right,Mi4,775,5,22,6,16
720575940613425810,right,Mi4,776,5,21,5,16
720575940618663547,right,Mi4,777,6,20,4,16
720575940633537188,right,Mi4,778,4,25,8,17
720575940620076923,right,Mi4,779,5,24,7,17
720575940618683469,right,Mi4,780,-6,25,18,7
720575940607613653,right,Mi4,781,-5,26,18,8
720575940634090209,right,Mi4,783,-4,28,18,10
720575940622393257,right,Mi4,785,-3,30,18,12
720575940638157284,right,Mi4,786,-2,30,17,13
720575940638722394,right,Mi4,788,3,27,10,17
720575940621059169,right,Mi4,790,-2,-27,-12,-15
720575940608318850,right,Mi4,791,-1,-28,-13,-15
720575940625031431,right,Mi4,792,8,2,-7,9
720575940620516288,right,Mi4,793,8,-6,-11,5
720575940634719087,right,Mi4,794,5,-26,-18,-8
720575940638905414,right,Mi4,795,6,-21,-17,-4
720575940632738897,right,Mi9,1,-6,13,12,1
720575940624632578,right,Mi9,2,-8,2,9,-7
720575940629641978,right,Mi9,3,6,-12,-12,0
720575940627281513,right,Mi9,4,-5,-21,-6,-15
720575940608188338,right,Mi9,5,-1,16,9,7
720575940622800788,right,Mi9,6,-2,-4,0,-4
720575940621700080,right,Mi9,7,-6,-6,3,-9
720575940626565890,right,Mi9,8,-4,26,17,9
720575940624161719,right,Mi9,9,4,9,0,9
720575940626798966,right,Mi9,10,5,-15,-13,-2
720575940620775407,right,Mi9,11,7,-14,-14,0
720575940627146554,right,Mi9,12,-7,9,11,-2
720575940628615529,right,Mi9,13,-1,-26,-12,-14
720575940639894947,right,Mi9,14,0,-27,-14,-13
720575940627177334,right,Mi9,15,2,-3,-4,1
720575940628881145,right,Mi9,16,-2,-16,-6,-10
720575940612443926,right,Mi9,17,1,-5,-4,-1
720575940619699316,right,Mi9,18,5,-16,-13,-3
720575940603295200,right,Mi9,19,-7,17,15,2
720575940630421303,right,Mi9,20,3,-11,-9,-2
720575940635112729,right,Mi9,21,-2,19,11,8
720575940627482374,right,Mi9,22,-1,3,2,1
720575940637375600,right,Mi9,23,-3,-16,-5,-11
720575940609270027,right,Mi9,24,-1,-10,-4,-6
720575940622067494,right,Mi9,25,-9,3,10,-7
720575940631185401,right,Mi9,26,1,-3,-3,0
720575940627585929,right,Mi9,27,0,-25,-13,-12
720575940630420162,right,Mi9,28,5,6,-2,8
720575940613986479,right,Mi9,29,-1,-3,-1,-2
720575940624933905,right,Mi9,30,6,16,2,14
720575940628930407,right,Mi9,32,0,12,6,6
720575940633869794,right,Mi9,33,3,18,6,12
720575940638981198,right,Mi9,34,6,18,3,15
720575940634828569,right,Mi9,35,1,-24,-13,-11
720575940628545643,right,Mi9,36,6,8,-2,10
720575940633584076,right,Mi9,37,1,5,1,4
720575940630901835,right,Mi9,38,0,-2,-1,-1
720575940620652882,right,Mi9,39,0,20,10,10
720575940620759322,right,Mi9,40,-2,-6,-1,-5
720575940619299311,right,Mi9,41,-3,28,17,11
720575940624287211,right,Mi9,42,-1,14,8,6
720575940633235551,right,Mi9,43,-5,18,14,4
720575940625637868,right,Mi9,44,5,-10,-10,0
720575940623316749,right,Mi9,45,-5,-1,4,-5
720575940610807650,right,Mi9,46,-5,15,12,3
720575940644269728,right,Mi9,47,-9,-1,8,-9
720575940630026199,right,Mi9,48,-4,-22,-7,-15
720575940627913237,right,Mi9,49,4,-4,-6,2
720575940629694970,right,Mi9,50,-2,21,12,9
720575940609608201,right,Mi9,51,0,-19,-10,-9
720575940617505510,right,Mi9,52,-1,-22,-10,-12
720575940633903661,right,Mi9,53,5,14,2,12
720575940611741390,right,Mi9,54,-4,3,5,-2
720575940618204573,right,Mi9,55,-4,-11,-2,-9
720575940626199994,right,Mi9,56,1,-13,-8,-5
720575940629726039,right,Mi9,57,6,-11,-12,1
720575940644211912,right,Mi9,58,3,12,3,9
720575940625418426,right,Mi9,59,-2,2,3,-1
720575940630010425,right,Mi9,60,-8,8,12,-4
720575940622089310,right,Mi9,61,-4,-4,2,-6
720575940625471223,right,Mi9,63,4,12,2,10
720575940618273600,right,Mi9,64,4,-23,-16,-7
720575940615740940,right,Mi9,65,-1,28,15,13
720575940635082091,right,Mi9,66,2,15,5,10
720575940629080731,right,Mi9,67,-2,-13,-5,-8
720575940627289993,right,Mi9,68,3,16,5,11
720575940637618862,right,Mi9,69,1,8,3,5
720575940615775647,right,Mi9,70,-4,21,14,7
720575940627536259,right,Mi9,71,-2,-3,0,-3
720575940622791885,right,Mi9,72,0,-28,-14,-14
720575940620326896,right,Mi9,73,2,2,-1,3
720575940612403626,right,Mi9,74,-1,-9,-4,-5
720575940623644942,right,Mi9,75,-6,14,13,1
720575940632131921,right,Mi9,76,-3,-4,1,-5
720575940654545825,right,Mi9,77,2,-5,-5,0
720575940633724863,right,Mi9,78,2,20,8,12
720575940634331128,right,Mi9,79,2,1,-2,3
720575940619149366,right,Mi9,80,4,13,2,11
720575940612188017,right,Mi9,81,6,-2,-7,5
720575940616511686,right,Mi9,82,-7,7,10,-3
720575940608951509,right,Mi9,83,2,-21,-13,-8
720575940630144812,right,Mi9,84,-2,12,8,4
720575940607621980,right,Mi9,85,4,-22,-15,-7
720575940638158989,right,Mi9,86,-5,-7,1,-8
720575940623464524,right,Mi9,87,1,11,4,7
720575940629061847,right,Mi9,89,1,-19,-11,-8
720575940626765412,right,Mi9,90,-4,5,6,-1
720575940635171263,right,Mi9,91,-1,6,4,2
720575940626678060,right,Mi9,93,-6,3,7,-4
720575940628230396,right,Mi9,94,5,18,4,14
720575940628372167,right,Mi9,95,4,-21,-15,-6
720575940621335899,right,Mi9,96,1,-10,-6,-4
720575940614784117,right,Mi9,97,-5,2,6,-4
720575940608731403,right,Mi9,98,-1,-12,-5,-7
720575940613036822,right,Mi9,99,4,15,3,12
720575940617733817,right,Mi9,100,2,-10,-7,-3
720575940627246380,right,Mi9,101,-7,6,10,-4
720575940608827913,right,Mi9,102,3,13,3,10
720575940629171185,right,Mi9,103,7,9,-3,12
720575940634781536,right,Mi9,104,-1,-27,-13,-14
720575940625552280,right,Mi9,105,3,22,8,14
720575940623400684,right,Mi9,106,-7,11,12,-1
720575940617378388,right,Mi9,107,8,-2,-9,7
720575940622017008,right,Mi9,108,-3,-12,-3,-9
720575940633084717,right,Mi9,109,4,-5,-7,2
720575940622720169,right,Mi9,110,-7,0,7,-7
720575940632245807,right,Mi9,111,2,-24,-14,-10
720575940629423415,right,Mi9,112,-6,1,6,-5
720575940631800120,right,Mi9,113,-2,4,4,0
720575940632421663,right,Mi9,114,2,-13,-9,-4
720575940604692070,right,Mi9,115,-4,2,5,-3
720575940621712152,right,Mi9,116,-1,-8,-3,-5
720575940620049064,right,Mi9,117,-8,-2,7,-9
720575940624215221,right,Mi9,118,3,1,-3,4
720575940639047487,right,Mi9,119,-2,6,5,1
720575940645997620,right,Mi9,120,-1,-1,0,-1
720575940619152811,right,Mi9,121,-8,4,10,-6
720575940608039090,right,Mi9,122,-5,9,9,0
720575940626089260,right,Mi9,123,-8,10,13,-3
720575940621127700,right,Mi9,124,1,-7,-5,-2
720575940618150813,right,Mi9,125,5,9,-1,10
720575940622718166,right,Mi9,126,3,11,2,9
720575940620017937,right,Mi9,127,0,15,7,8
720575940636436472,right,Mi9,128,3,-22,-14,-8
720575940638331364,right,Mi9,129,0,-13,-7,-6
720575940614177320,right,Mi9,130,2,12,4,8
720575940655097505,right,Mi9,131,-6,20,16,4
720575940616930902,right,Mi9,133,-3,20,13,7
720575940632092300,right,Mi9,134,-5,-18,-4,-14
720575940644817006,right,Mi9,135,-3,-22,-8,-14
720575940633052836,right,Mi9,136,0,3,1,2
720575940614607558,right,Mi9,137,5,-7,-9,2
720575940616926779,right,Mi9,138,0,27,13,14
720575940638349534,right,Mi9,139,1,-14,-8,-6
720575940616436509,right,Mi9,140,3,8,1,7
720575940622488090,right,Mi9,141,5,-23,-17,-6
720575940627190035,right,Mi9,142,-2,-18,-7,-11
720575940620833106,right,Mi9,143,-4,16,12,4
720575940612483826,right,Mi9,144,7,-11,-13,2
720575940621760422,right,Mi9,145,0,4,2,2
720575940610904878,right,Mi9,146,1,-6,-4,-2
720575940614907538,right,Mi9,147,1,21,9,12
720575940614682258,right,Mi9,148,-7,-11,1,-12
720575940615291772,right,Mi9,149,6,-14,-13,-1
720575940611659377,right,Mi9,150,-8,5,10,-5
720575940609235298,right,Mi9,151,-3,-14,-4,-10
720575940640353920,right,Mi9,152,3,-15,-11,-4
720575940638975054,right,Mi9,153,8,0,-8,8
720575940645097251,right,Mi9,154,-8,0,8,-8
720575940632987347,right,Mi9,155,-8,13,14,-1
720575940619576998,right,Mi9,156,-9,1,9,-8
720575940612675225,right,Mi9,157,-1,-7,-3,-4
720575940624401034,right,Mi9,158,3,-5,-6,1
720575940617399769,right,Mi9,159,7,7,-4,11
720575940639423541,right,Mi9,160,-2,20,12,8
720575940623105767,right,Mi9,161,4,-14,-11,-3
720575940621988961,right,Mi9,162,-4,-2,3,-5
720575940624811139,right,Mi9,163,-9,7,12,-5
720575940618999350,right,Mi9,164,-1,-2,0,-2
720575940610680746,right,Mi9,165,4,16,4,12
720575940646325614,right,Mi9,166,0,18,9,9
720575940635946095,right,Mi9,167,0,-17,-9,-8
720575940627429397,right,Mi9,168,-1,17,9,8
720575940630298471,right,Mi9,169,0,-18,-9,-9
720575940612951154,right,Mi9,170,-5,1,5,-4
720575940628235249,right,Mi9,171,6,-20,-16,-4
720575940623606724,right,Mi9,172,1,22,10,12
720575940632410642,right,Mi9,173,2,-25,-15,-10
720575940620105301,right,Mi9,174,4,-15,-12,-3
720575940614983611,right,Mi9,175,-6,-7,2,-9
720575940613225750,right,Mi9,176,-2,13,8,5
720575940607218780,right,Mi9,177,-2,-1,1,-2
720575940628021576,right,Mi9,178,2,11,3,8
720575940629841274,right,Mi9,179,-5,-16,-3,-13
720575940628865028,right,Mi9,180,2,-27,-16,-11
720575940632344618,right,Mi9,181,1,-4,-3,-1
720575940615457660,right,Mi9,182,7,-10,-12,2
720575940614932626,right,Mi9,183,-5,-15,-3,-12
720575940620368775,right,Mi9,184,-6,-5,3,-8
720575940614008360,right,Mi9,185,2,-11,-8,-3
720575940615981886,right,Mi9,186,-1,26,14,12
720575940621337153,right,Mi9,187,3,21,7,14
720575940617422646,right,Mi9,188,-5,17,13,4
720575940614675454,right,Mi9,189,6,13,0,13
720575940621622908,right,Mi9,190,-3,-5,0,-5
720575940625826960,right,Mi9,191,-1,-11,-5,-6
720575940627243308,right,Mi9,193,-5,4,7,-3
720575940631381263,right,Mi9,194,0,-5,-3,-2
720575940631392825,right,Mi9,195,-3,-1,2,-3
720575940625394320,right,Mi9,196,-1,8,5,3
720575940646693428,right,Mi9,197,0,-20,-10,-10
720575940636347790,right,Mi9,198,6,2,-5,7
720575940612437234,right,Mi9,199,0,-12,-6,-6
720575940630797911,right,Mi9,200,-5,12,11,1
720575940620613103,right,Mi9,201,-8,9,12,-3
720575940630258806,right,Mi9,202,-1,27,14,13
720575940634878350,right,Mi9,203,3,-1,-4,3
720575940614609831,right,Mi9,204,5,-2,-6,4
720575940620851695,right,Mi9,205,5,-6,-8,2
720575940644583204,right,Mi9,206,-3,5,5,0
720575940633251665,right,Mi9,207,1,29,13,16
720575940622379990,right,Mi9,208,5,-21,-16,-5
720575940632254545,right,Mi9,209,-3,-8,-1,-7
720575940626998316,right,Mi9,210,-6,8,10,-2
720575940635980890,right,Mi9,211,-7,-1,6,-7
720575940622644300,right,Mi9,212,2,-16,-10,-6
720575940620063947,right,Mi9,213,3,-4,-5,1
720575940634243609,right,Mi9,214,-5,3,6,-3
720575940611627474,right,Mi9,215,6,7,-3,10
720575940627065930,right,Mi9,216,2,19,7,12
720575940609390805,right,Mi9,217,6,15,1,14
720575940605959358,right,Mi9,218,2,10,3,7
720575940627175286,right,Mi9,219,6,-4,-8,4
720575940607523350,right,Mi9,220,2,-6,-5,-1
720575940609042012,right,Mi9,221,-7,3,8,-5
720575940620115029,right,Mi9,222,-3,26,16,10
720575940617998804,right,Mi9,223,-2,26,15,11
720575940630894700,right,Mi9,224,0,5,2,3
720575940622110332,right,Mi9,225,2,-26,-15,-11
720575940624706452,right,Mi9,226,5,19,4,15
720575940631620318,right,Mi9,227,-7,5,9,-4
720575940620569582,right,Mi9,228,-7,1,7,-6
720575940634013779,right,Mi9,229,5,2,-4,6
720575940628671488,right,Mi9,231,4,-12,-10,-2
720575940659972737,right,Mi9,232,-4,13,10,3
720575940614717438,right,Mi9,233,4,-13,-11,-2
720575940616124895,right,Mi9,234,1,3,0,3
720575940637789662,right,Mi9,235,4,11,1,10
720575940606363778,right,Mi9,236,-1,4,3,1
720575940614829986,right,Mi9,237,-2,27,15,12
720575940619895679,right,Mi9,238,-8,-3,6,-9
720575940618697967,right,Mi9,239,-6,6,9,-3
720575940615223146,right,Mi9,240,-4,-3,2,-5
720575940630142991,right,Mi9,241,2,-17,-11,-6
720575940628730128,right,Mi9,242,-4,6,7,-1
720575940630932475,right,Mi9,243,-1,-21,-10,-11
720575940632103480,right,Mi9,244,-4,-12,-2,-10
720575940633131162,right,Mi9,245,-5,-3,3,-6
720575940607294473,right,Mi9,246,-4,15,11,4
720575940627731801,right,Mi9,247,-4,-15,-4,-11
720575940637342534,right,Mi9,248,-6,0,6,-6
720575940626710300,right,Mi9,249,2,-12,-8,-4
720575940626484026,right,Mi9,250,-1,1,1,0
720575940605952945,right,Mi9,251,-1,-14,-6,-8
720575940644087496,right,Mi9,252,3,23,8,15
720575940620728256,right,Mi9,253,5,16,3,13
720575940632729647,right,Mi9,254,3,-24,-15,-9
720575940605806624,right,Mi9,255,-6,-13,-1,-12
720575940631112663,right,Mi9,256,5,-20,-15,-5
720575940618894494,right,Mi9,257,2,21,8,13
720575940624914155,right,Mi9,258,-4,-17,-5,-12
720575940629057040,right,Mi9,259,-7,-5,4,-9
720575940632771385,right,Mi9,260,-3,19,12,7
720575940607908700,right,Mi9,261,-1,13,7,6
720575940640121216,right,Mi9,262,1,-11,-7,-4
720575940616131340,right,Mi9,263,-3,4,5,-1
720575940622457164,right,Mi9,264,-1,-6,-2,-4
720575940639549312,right,Mi9,265,-6,-1,5,-6
720575940633706660,right,Mi9,266,-1,-25,-12,-13
720575940613923379,right,Mi9,267,-6,2,7,-5
720575940619302127,right,Mi9,268,7,-6,-10,4
720575940623102600,right,Mi9,269,2,-19,-12,-7
720575940641164507,right,Mi9,270,1,-8,-5,-3
720575940624159415,right,Mi9,272,3,-2,-4,2
720575940612695525,right,Mi9,273,-6,23,17,6
720575940626075580,right,Mi9,274,6,4,-4,8
720575940610725934,right,Mi9,275,-8,-1,7,-8
720575940612740069,right,Mi9,277,7,-3,-9,6
720575940632700364,right,Mi9,278,-5,10,10,0
720575940640367925,right,Mi9,279,-4,8,8,0
720575940634607968,right,Mi9,280,-6,-14,-1,-13
720575940627179675,right,Mi9,281,-9,2,10,-8
720575940630795148,right,Mi9,282,0,26,13,13
720575940622228318,right,Mi9,283,-4,4,6,-2
720575940623157016,right,Mi9,284,0,25,12,13
720575940616958806,right,Mi9,285,6,-18,-15,-3
720575940624930485,right,Mi9,286,0,-24,-12,-12
720575940642889613,right,Mi9,287,-5,13,11,2
720575940631083471,right,Mi9,288,-1,30,16,14
720575940614138543,right,Mi9,290,5,-24,-17,-7
720575940620151489,right,Mi9,291,7,2,-6,8
720575940645110039,right,Mi9,292,-4,18,13,5
720575940626511132,right,Mi9,293,4,-17,-13,-4
720575940640430720,right,Mi9,294,1,-20,-11,-9
720575940606578208,right,Mi9,295,-2,29,16,13
720575940625267092,right,Mi9,296,1,-18,-10,-8
720575940632236956,right,Mi9,297,7,-9,-12,3
720575940607858889,right,Mi9,298,-5,5,7,-2
720575940616255500,right,Mi9,299,-4,12,10,2
720575940624782316,right,Mi9,300,4,-18,-13,-5
720575940612917362,right,Mi9,301,-5,16,13,3
720575940610881912,right,Mi9,302,2,17,6,11
720575940639901501,right,Mi9,303,-5,22,16,6
720575940623750986,right,Mi9,304,6,5,-4,9
720575940626606522,right,Mi9,305,-7,4,9,-5
720575940630060119,right,Mi9,306,3,7,0,7
720575940624139288,right,Mi9,307,5,-25,-18,-7
720575940614052136,right,Mi9,308,-5,8,9,-1
720575940631023980,right,Mi9,309,-6,12,12,0
720575940628432583,right,Mi9,310,2,22,9,13
720575940630877689,right,Mi9,311,-7,15,14,1
720575940610085582,right,Mi9,312,4,-7,-8,1
720575940628180298,right,Mi9,313,7,3,-6,9
720575940626384134,right,Mi9,314,-9,5,11,-6
720575940631796537,right,Mi9,315,-3,-6,0,-6
720575940623898760,right,Mi9,316,5,-4,-7,3
720575940626993426,right,Mi9,317,-5,-4,3,-7
720575940613838317,right,Mi9,318,4,-19,-14,-5
720575940616864571,right,Mi9,319,-2,5,4,1
720575940628301830,right,Mi9,320,-2,-5,-1,-4
720575940628790544,right,Mi9,321,8,4,-6,10
720575940623261976,right,Mi9,322,2,26,11,15
720575940628814083,right,Mi9,323,-7,-13,0,-13
720575940612894613,right,Mi9,324,3,24,9,15
720575940630920332,right,Mi9,325,5,1,-5,6
720575940617732537,right,Mi9,326,2,16,6,10
720575940618889029,right,Mi9,327,5,3,-4,7
720575940628363228,right,Mi9,328,5,-9,-10,1
720575940630813890,right,Mi9,329,0,24,12,12
720575940606430310,right,Mi9,331,1,-15,-9,-6
720575940638154473,right,Mi9,332,4,-26,-17,-9
720575940636051563,right,Mi9,333,0,-21,-11,-10
720575940624547051,right,Mi9,334,1,-26,-14,-12
720575940604891680,right,Mi9,336,0,23,11,12
720575940637483661,right,Mi9,337,-5,-6,2,-8
720575940603472608,right,Mi9,338,-1,0,1,-1
720575940642464397,right,Mi9,340,-4,17,12,5
720575940627247930,right,Mi9,341,6,-17,-15,-2
720575940600782252,right,Mi9,342,2,-15,-10,-5
720575940631257964,right,Mi9,343,-3,27,16,11
720575940610049433,right,Mi9,344,-2,-15,-6,-9
720575940632661388,right,Mi9,345,3,-12,-9,-3
720575940622713814,right,Mi9,346,-7,-9,2,-11
720575940629301442,right,Mi9,347,-5,-13,-2,-11
720575940625739085,right,Mi9,348,3,14,4,10
720575940637569933,right,Mi9,349,-5,-14,-2,-12
720575940608337842,right,Mi9,350,1,15,6,9
720575940640120142,right,Mi9,351,-1,-17,-8,-9
720575940631440441,right,Mi9,352,-2,28,16,12
720575940618071953,right,Mi9,353,2,24,10,14
720575940617251723,right,Mi9,354,-2,-26,-11,-15
720575940616824859,right,Mi9,355,-7,-6,4,-10
720575940629036331,right,Mi9,356,0,22,11,11
720575940610968838,right,Mi9,357,4,17,4,13
720575940631250639,right,Mi9,358,-3,17,11,6
720575940620636177,right,Mi9,359,2,23,9,14
720575940613981480,right,Mi9,360,-5,19,14,5
720575940619569880,right,Mi9,361,0,-7,-4,-3
720575940610713134,right,Mi9,362,2,-20,-12,-8
720575940629811582,right,Mi9,363,7,-4,-9,5
720575940634578201,right,Mi9,364,4,4,-2,6
720575940633409107,right,Mi9,366,-5,-20,-5,-15
720575940627131005,right,Mi9,367,-6,-15,-2,-13
720575940627174277,right,Mi9,368,-4,-20,-6,-14
720575940615758809,right,Mi9,369,5,-5,-8,3
720575940620673670,right,Mi9,370,-3,21,13,8
720575940631840587,right,Mi9,371,6,-5,-9,4
720575940629271056,right,Mi9,372,1,-2,-2,0
720575940619153462,right,Mi9,373,1,-21,-12,-9
720575940609900612,right,Mi9,374,2,13,4,9
720575940617258452,right,Mi9,375,-6,7,9,-2
720575940639929944,right,Mi9,376,-7,-10,2,-12
720575940628582385,right,Mi9,377,0,7,3,4
720575940629819547,right,Mi9,378,-3,18,12,6
720575940655819937,right,Mi9,379,3,-17,-12,-5
720575940625215420,right,Mi9,380,-1,29,15,14
720575940621451466,right,Mi9,381,-8,-9,3,-12
720575940617209980,right,Mi9,382,3,-6,-6,0
720575940638574936,right,Mi9,383,-6,11,11,0
720575940633443103,right,Mi9,384,-6,-2,5,-7
720575940611478734,right,Mi9,385,-3,-18,-6,-12
720575940635001566,right,Mi9,386,-6,19,15,4
720575940625636903,right,Mi9,387,-1,-15,-7,-8
720575940614743080,right,Mi9,388,3,19,6,13
720575940617186777,right,Mi9,389,-6,-16,-2,-14
720575940630542295,right,Mi9,390,-6,-9,1,-10
720575940639879229,right,Mi9,391,4,-3,-6,3
720575940627804945,right,Mi9,392,-4,7,7,0
720575940630828150,right,Mi9,393,-1,22,12,10
720575940626402125,right,Mi9,394,-7,-8,3,-11
720575940614906774,right,Mi9,395,0,-22,-11,-11
720575940613876787,right,Mi9,396,-1,10,6,4
720575940631159660,right,Mi9,397,-3,-19,-7,-12
720575940610291268,right,Mi9,398,-3,22,14,8
720575940620570027,right,Mi9,399,-4,-24,-8,-16
720575940630681026,right,Mi9,400,1,-29,-16,-13
720575940608302172,right,Mi9,401,-2,-19,-8,-11
720575940606663014,right,Mi9,402,3,26,10,16
720575940631569464,right,Mi9,403,-2,-12,-4,-8
720575940632159289,right,Mi9,404,-1,20,11,9
720575940607354754,right,Mi9,405,3,10,2,8
720575940630874107,right,Mi9,406,1,-25,-14,-11
720575940629331817,right,Mi9,407,-5,-10,0,-10
720575940622977123,right,Mi9,408,-6,-4,4,-8
720575940629427260,right,Mi9,409,0,-3,-2,-1
720575940633262817,right,Mi9,410,-2,-2,1,-3
720575940605851838,right,Mi9,411,-5,-19,-5,-14
720575940620090957,right,Mi9,412,-6,21,16,5
720575940623653256,right,Mi9,413,-2,-7,-2,-5
720575940620555781,right,Mi9,414,4,21,6,15
720575940628276674,right,Mi9,415,6,12,0,12
720575940608026390,right,Mi9,416,3,-8,-7,-1
720575940636468855,right,Mi9,417,-6,-10,1,-11
720575940614505937,right,Mi9,418,-2,15,9,6
720575940621290923,right,Mi9,419,-3,-11,-3,-8
720575940627176310,right,Mi9,420,6,-3,-8,5
720575940624671363,right,Mi9,421,-1,12,7,5
720575940621247329,right,Mi9,422,-7,-4,5,-9
720575940626901348,right,Mi9,423,3,-18,-12,-6
720575940627406867,right,Mi9,424,-3,-2,2,-4
720575940629868226,right,Mi9,425,3,20,7,13
720575940619363544,right,Mi9,426,-3,0,3,-3
720575940611725006,right,Mi9,427,5,-18,-14,-4
720575940614116575,right,Mi9,428,-2,23,13,10
720575940618128129,right,Mi9,429,-2,14,9,5
720575940619565214,right,Mi9,430,-3,-7,-1,-6
720575940610662264,right,Mi9,431,-2,-10,-3,-7
720575940629101840,right,Mi9,432,-5,7,8,-1
720575940619765414,right,Mi9,433,0,-8,-4,-4
720575940624623911,right,Mi9,434,-3,7,6,1
720575940616906508,right,Mi9,435,5,-17,-14,-3
720575940626453762,right,Mi9,436,0,-15,-8,-7
720575940629183311,right,Mi9,437,-3,12,9,3
720575940619567774,right,Mi9,438,2,27,11,16
720575940626140730,right,Mi9,439,-3,-9,-2,-7
720575940630941691,right,Mi9,440,1,23,10,13
720575940601598892,right,Mi9,441,3,-16,-11,-5
720575940633726862,right,Mi9,442,-5,25,17,8
720575940618862400,right,Mi9,443,-6,4,8,-4
720575940612078267,right,Mi9,444,4,-10,-9,-1
720575940650618870,right,Mi9,445,-2,8,6,2
720575940622780853,right,Mi9,446,2,-14,-9,-5
720575940632823009,right,Mi9,447,-1,2,2,0
720575940629683279,right,Mi9,448,0,30,15,15
720575940621149805,right,Mi9,449,6,-16,-14,-2
720575940620703659,right,Mi9,450,2,-9,-7,-2
720575940623618598,right,Mi9,451,4,20,6,14
720575940613117554,right,Mi9,452,1,-9,-6,-3
720575940624417771,right,Mi9,453,3,25,9,16
720575940648575364,right,Mi9,454,5,-12,-11,-1
720575940615688258,right,Mi9,455,7,-7,-11,4
720575940622329491,right,Mi9,456,0,21,10,11
720575940637351598,right,Mi9,457,-2,17,10,7
720575940629587791,right,Mi9,458,5,0,-5,5
720575940627174262,right,Mi9,459,5,-3,-7,4
720575940624443319,right,Mi9,460,-3,-20,-7,-13
720575940642082523,right,Mi9,461,7,-5,-10,5
720575940624171528,right,Mi9,462,-1,18,10,8
720575940638959167,right,Mi9,463,5,17,3,14
720575940637292901,right,Mi9,464,4,0,-4,4
720575940623522857,right,Mi9,465,3,0,-3,3
720575940615145366,right,Mi9,466,1,14,6,8
720575940623058712,right,Mi9,467,-2,-20,-8,-12
720575940633255379,right,Mi9,468,-3,11,8,3
720575940616475393,right,Mi9,469,-7,13,13,0
720575940618398155,right,Mi9,470,4,-9,-9,0
720575940624754156,right,Mi9,471,3,-26,-16,-10
720575940617731377,right,Mi9,473,-4,23,15,8
720575940635423386,right,Mi9,474,-3,-17,-6,-11
720575940614930107,right,Mi9,475,-4,-1,3,-4
720575940619766033,right,Mi9,476,-1,15,8,7
720575940626543747,right,Mi9,477,-3,2,4,-2
720575940633704287,right,Mi9,478,-7,16,15,1
720575940641730189,right,Mi9,479,-2,10,7,3
720575940626184067,right,Mi9,480,3,-19,-13,-6
720575940608002326,right,Mi9,481,4,-8,-8,0
720575940625010407,right,Mi9,482,1,17,7,10
720575940634636895,right,Mi9,483,2,-7,-6,-1
720575940623461000,right,Mi9,484,3,-9,-8,-1
720575940619293819,right,Mi9,485,-3,-3,1,-4
720575940614310627,right,Mi9,486,0,1,0,1
720575940652015862,right,Mi9,487,1,-1,-2,1
720575940643823924,right,Mi9,488,7,5,-5,10
720575940621526710,right,Mi9,489,-3,10,8,2
720575940610203460,right,Mi9,490,-5,6,8,-2
720575940635202711,right,Mi9,491,7,-1,-8,7
720575940627903994,right,Mi9,492,-7,-2,6,-8
720575940640307827,right,Mi9,493,-3,23,14,9
720575940617821657,right,Mi9,494,0,29,14,15
720575940608344789,right,Mi9,496,7,8,-3,11
720575940628557211,right,Mi9,497,6,1,-6,7
720575940612761842,right,Mi9,498,6,10,-1,11
720575940630180711,right,Mi9,499,5,10,0,10
720575940611706830,right,Mi9,500,7,-8,-11,3
720575940604698633,right,Mi9,501,1,2,0,2
720575940619481408,right,Mi9,502,5,8,-1,9
720575940625635074,right,Mi9,503,3,17,5,12
720575940624775159,right,Mi9,504,-2,9,6,3
720575940655474593,right,Mi9,505,6,-22,-17,-5
720575940615158959,right,Mi9,506,1,-12,-7,-5
720575940611966613,right,Mi9,507,-5,-12,-1,-11
720575940624615659,right,Mi9,508,-5,11,10,1
720575940620704608,right,Mi9,509,-4,10,9,1
720575940637024367,right,Mi9,510,-2,11,7,4
720575940633216047,right,Mi9,511,5,-11,-11,0
720575940620704171,right,Mi9,512,6,0,-6,6
720575940631896376,right,Mi9,513,-4,-13,-3,-10
720575940621708129,right,Mi9,514,-4,-10,-1,-9
720575940624578567,right,Mi9,515,-8,-7,4,-11
720575940615195615,right,Mi9,516,7,-18,-16,-2
720575940632934030,right,Mi9,518,-4,22,15,7
720575940623986951,right,Mi9,519,-5,-5,2,-7
720575940622922701,right,Mi9,520,-2,-22,-9,-13
720575940618625349,right,Mi9,521,6,-9,-11,2
720575940610273348,right,Mi9,522,-4,0,4,-4
720575940610956550,right,Mi9,523,2,14,5,9
720575940610163918,right,Mi9,524,4,-20,-14,-6
720575940614181538,right,Mi9,525,-1,-20,-9,-11
720575940629937399,right,Mi9,526,0,-10,-5,-5
720575940620092660,right,Mi9,527,-4,-8,0,-8
720575940618080285,right,Mi9,529,2,-2,-3,1
720575940628256103,right,Mi9,530,-3,-13,-4,-9
720575940630848579,right,Mi9,531,1,0,-1,1
720575940611701312,right,Mi9,532,-8,7,11,-4
720575940628962639,right,Mi9,533,0,-16,-8,-8
720575940634332953,right,Mi9,534,3,2,-2,4
720575940647424900,right,Mi9,535,8,-4,-10,6
720575940641943771,right,Mi9,536,3,4,-1,5
720575940629387014,right,Mi9,537,0,-23,-12,-11
720575940634221025,right,Mi9,538,-4,1,4,-3
720575940631764561,right,Mi9,539,-6,15,13,2
720575940615226274,right,Mi9,540,-2,-9,-3,-6
720575940627179389,right,Mi9,541,-4,14,11,3
720575940607279452,right,Mi9,542,6,-13,-13,0
720575940659970177,right,Mi9,543,-1,-4,-1,-3
720575940622032628,right,Mi9,544,3,-13,-10,-3
720575940619760433,right,Mi9,545,5,11,0,11
720575940623938659,right,Mi9,546,3,6,0,6
720575940622305449,right,Mi9,547,-1,21,11,10
720575940618066406,right,Mi9,548,1,-16,-9,-7
720575940621573473,right,Mi9,549,0,-9,-5,-4
720575940614824098,right,Mi9,550,-2,3,3,0
720575940632554925,right,Mi9,551,-4,-9,-1,-8
720575940623547628,right,Mi9,552,4,-1,-5,4
720575940610006738,right,Mi9,553,-3,16,11,5
720575940626207761,right,Mi9,554,-9,-3,7,-10
720575940629420618,right,Mi9,555,-4,9,8,1
720575940612798899,right,Mi9,556,0,10,5,5
720575940628019906,right,Mi9,557,6,-10,-11,1
720575940615739298,right,Mi9,558,-4,-21,-7,-14
720575940627921018,right,Mi9,559,-6,22,17,5
720575940620179476,right,Mi9,560,-7,14,14,0
720575940630769090,right,Mi9,561,5,7,-2,9
720575940635824503,right,Mi9,562,-5,-2,4,-6
720575940626898038,right,Mi9,563,5,-13,-12,-1
720575940629396554,right,Mi9,564,3,-23,-15,-8
720575940623455612,right,Mi9,565,0,-26,-13,-13
720575940619231341,right,Mi9,566,5,-8,-9,1
720575940630364727,right,Mi9,567,-2,22,13,9
720575940637578893,right,Mi9,568,-6,-8,2,-10
720575940621865569,right,Mi9,569,6,6,-3,9
720575940623679684,right,Mi9,570,2,25,10,15
720575940612031090,right,Mi9,571,0,-14,-7,-7
720575940626863050,right,Mi9,572,-8,3,9,-6
720575940607317634,right,Mi9,573,4,14,3,11
720575940614394577,right,Mi9,574,-6,5,8,-3
720575940621669997,right,Mi9,575,6,9,-2,11
720575940614051635,right,Mi9,576,0,28,14,14
720575940646255726,right,Mi9,577,5,-14,-12,-2
720575940612129211,right,Mi9,578,4,-11,-10,-1
720575940614650791,right,Mi9,579,-3,-10,-2,-8
720575940606652960,right,Mi9,580,-2,-23,-10,-13
720575940614115247,right,Mi9,582,-1,23,12,11
720575940616278028,right,Mi9,583,3,-25,-16,-9
720575940620913243,right,Mi9,584,4,23,7,16
720575940614390481,right,Mi9,585,-1,-23,-11,-12
720575940612730920,right,Mi9,586,2,18,7,11
720575940624162229,right,Mi9,587,4,22,7,15
720575940645704983,right,Mi9,588,1,4,1,3
720575940634832028,right,Mi9,589,-1,-5,-2,-3
720575940632342063,right,Mi9,591,3,-3,-5,2
720575940623222808,right,Mi9,593,3,-14,-10,-4
720575940618189371,right,Mi9,594,7,-16,-15,-1
720575940632689433,right,Mi9,595,7,-12,-13,1
720575940623140607,right,Mi9,596,-4,-16,-4,-12
720575940639753917,right,Mi9,597,4,1,-4,5
720575940613559471,right,Mi9,598,2,-18,-11,-7
720575940625674428,right,Mi9,599,-1,9,5,4
720575940628868603,right,Mi9,600,3,-10,-8,-2
720575940621971327,right,Mi9,601,1,16,7,9
720575940615946171,right,Mi9,602,4,-2,-5,3
720575940627064595,right,Mi9,603,-3,-23,-9,-14
720575940616265659,right,Mi9,604,-6,-17,-3,-14
720575940638323940,right,Mi9,605,3,15,4,11
720575940610277188,right,Mi9,606,-1,-19,-9,-10
720575940629175375,right,Mi9,607,1,18,8,10
720575940635704215,right,Mi9,608,1,10,4,6
720575940616756948,right,Mi9,609,-2,0,2,-2
720575940634661274,right,Mi9,610,2,-23,-14,-9
720575940617223124,right,Mi9,611,-1,-18,-8,-10
720575940639992398,right,Mi9,612,-3,-26,-10,-16
720575940609354179,right,Mi9,613,-8,-4,6,-10
720575940628158407,right,Mi9,614,-2,-8,-2,-6
720575940637620621,right,Mi9,615,-7,-7,3,-10
720575940630582492,right,Mi9,616,-3,15,10,5
720575940622096154,right,Mi9,617,-2,-17,-7,-10
720575940641643483,right,Mi9,618,-1,24,13,11
720575940623712973,right,Mi9,619,-4,-19,-6,-13
720575940630549114,right,Mi9,620,7,1,-7,8
720575940614721534,right,Mi9,621,1,24,11,13
720575940625994756,right,Mi9,622,-5,20,15,5
720575940633365535,right,Mi9,624,1,-17,-10,-7
720575940627806986,right,Mi9,625,-2,24,14,10
720575940618143060,right,Mi9,626,-5,-8,1,-9
720575940635834975,right,Mi9,627,0,-1,-1,0
720575940622690954,right,Mi9,628,0,0,0,0
720575940615434562,right,Mi9,629,4,24,8,16
720575940624458791,right,Mi9,630,4,8,0,8
720575940630758764,right,Mi9,631,1,26,12,14
720575940636749167,right,Mi9,632,3,-20,-13,-7
720575940645393006,right,Mi9,633,-1,-24,-11,-13
720575940619122036,right,Mi9,634,-3,-15,-5,-10
720575940627101302,right,Mi9,635,6,-6,-9,3
720575940610161365,right,Mi9,636,0,6,3,3
720575940631503887,right,Mi9,637,3,-21,-14,-7
720575940626762183,right,Mi9,638,-1,7,4,3
720575940616497214,right,Mi9,639,-4,19,13,6
720575940623330318,right,Mi9,640,-1,-16,-7,-9
720575940622616649,right,Mi9,641,-8,-5,5,-10
720575940615720095,right,Mi9,642,-5,-11,-1,-10
720575940633884205,right,Mi9,643,6,14,1,13
720575940631958339,right,Mi9,644,-6,18,15,3
720575940612464370,right,Mi9,645,-4,27,17,10
720575940608908483,right,Mi9,646,6,17,2,15
720575940621997172,right,Mi9,647,-4,-7,0,-7
720575940626802224,right,Mi9,648,1,7,2,5
720575940616437021,right,Mi9,649,-1,5,3,2
720575940622527871,right,Mi9,650,-3,-25,-10,-15
720575940654680993,right,Mi9,651,-4,-5,1,-6
720575940620172885,right,Mi9,652,-6,-11,0,-11
720575940637373254,right,Mi9,653,-6,-12,0,-12
720575940619339537,right,Mi9,654,-3,8,7,1
720575940611734734,right,Mi9,655,6,-1,-7,6
720575940627212561,right,Mi9,656,0,-11,-6,-5
720575940630640128,right,Mi9,657,-2,-25,-11,-14
720575940627213437,right,Mi9,658,1,20,9,11
720575940616380347,right,Mi9,659,-4,-6,1,-7
720575940613599914,right,Mi9,660,2,28,12,16
720575940632999469,right,Mi9,661,-3,14,10,4
720575940627159926,right,Mi9,662,2,-1,-3,2
720575940618545638,right,Mi9,663,0,8,4,4
720575940633340627,right,Mi9,664,1,-27,-15,-12
720575940608334770,right,Mi9,665,7,-2,-8,6
720575940623789712,right,Mi9,666,7,-13,-14,1
720575940634649826,right,Mi9,667,1,-28,-15,-13
720575940631587090,right,Mi9,668,1,19,8,11
720575940629762554,right,Mi9,669,4,-16,-12,-4
720575940628664571,right,Mi9,672,-8,11,13,-2
720575940608247426,right,Mi9,673,2,5,0,5
720575940618395229,right,Mi9,674,-4,-14,-3,-11
720575940637929816,right,Mi9,675,-7,19,16,3
720575940630943319,right,Mi9,676,-3,-21,-8,-13
720575940613906802,right,Mi9,677,0,11,5,6
720575940623704061,right,Mi9,678,3,-7,-7,0
720575940620619358,right,Mi9,679,4,18,5,13
720575940638796102,right,Mi9,680,-1,25,13,12
720575940629261553,right,Mi9,681,-2,-21,-9,-12
720575940624918932,right,Mi9,682,6,-8,-10,2
720575940622321953,right,Mi9,684,-6,17,14,3
720575940612705253,right,Mi9,685,-5,-9,0,-9
720575940615357649,right,Mi9,686,5,-22,-16,-6
720575940631833171,right,Mi9,687,-6,-3,4,-7
720575940617666264,right,Mi9,688,-7,10,12,-2
720575940620861778,right,Mi9,689,-2,18,11,7
720575940630547420,right,Mi9,690,-7,-3,5,-8
720575940625052348,right,Mi9,691,-9,4,11,-7
720575940631247831,right,Mi9,692,-4,24,16,8
720575940619069758,right,Mi9,693,-3,25,15,10
720575940610184049,right,Mi9,695,-6,10,11,-1
720575940638560740,right,Mi9,696,-2,16,10,6
720575940622353065,right,Mi9,697,1,-22,-12,-10
720575940620263640,right,Mi9,698,6,-7,-10,3
720575940618875805,right,Mi9,699,-5,0,5,-5
720575940635329016,right,Mi9,700,5,15,2,13
720575940637651312,right,Mi9,701,0,-4,-2,-2
720575940610198596,right,Mi9,702,-5,23,16,7
720575940629986295,right,Mi9,703,-3,1,3,-2
720575940629312855,right,Mi9,704,-7,8,11,-3
720575940630382188,right,Mi9,705,1,1,-1,2
720575940628799985,right,Mi9,706,-7,-12,1,-13
720575940639755829,right,Mi9,707,-2,25,14,11
720575940614431890,right,Mi9,708,-4,-25,-9,-16
720575940620955526,right,Mi9,709,-2,-24,-10,-14
720575940614051821,right,Mi9,710,4,-25,-17,-8
720575940625237321,right,Mi9,711,-1,19,10,9
720575940632908883,right,Mi9,712,-7,12,13,-1
720575940638253028,right,Mi9,713,-6,16,14,2
720575940623264611,right,Mi9,715,4,10,1,9
720575940625972016,right,Mi9,716,4,-6,-7,1
720575940635114687,right,Mi9,717,2,-22,-13,-9
720575940636556358,right,Mi9,718,-5,24,17,7
720575940632395233,right,Mi9,719,1,27,12,15
720575940627941704,right,Mi9,720,-5,21,15,6
720575940626032119,right,Mi9,721,5,13,1,12
720575940627246937,right,Mi9,722,6,-15,-14,-1
720575940625809040,right,Mi9,723,-2,-11,-4,-7
720575940646098979,right,Mi9,725,-3,-24,-9,-15
720575940627809960,right,Mi9,727,7,6,-4,10
720575940617617849,right,Mi9,728,7,12,-1,13
720575940629013547,right,Mi9,729,-3,29,17,12
720575940622487322,right,Mi9,730,7,0,-7,7
720575940612257551,right,Mi9,731,-6,9,10,-1
720575940622981193,right,Mi9,732,-3,6,6,0
720575940642495885,right,Mi9,733,-5,-17,-4,-13
720575940631945908,right,Mi9,734,2,0,-2,2
720575940632819148,right,Mi9,735,1,-23,-13,-10
720575940629276613,right,Mi9,736,-8,1,8,-7
720575940624783653,right,Mi9,737,0,19,9,10
720575940632824780,right,Mi9,738,-3,13,9,4
720575940635760632,right,Mi9,739,-7,2,8,-6
720575940638068096,right,Mi9,740,2,-8,-6,-2
720575940620674287,right,Mi9,741,-2,-14,-5,-9
720575940608906249,right,Mi9,742,-4,11,9,2
720575940630263746,right,Mi9,743,6,-19,-16,-3
720575940638230244,right,Mi9,744,-4,25,16,9
720575940633357649,right,Mi9,745,0,13,6,7
720575940626951178,right,Mi9,746,-3,3,4,-1
720575940605186225,right,Mi9,747,0,2,1,1
720575940610582084,right,Mi9,748,-4,20,14,6
720575940625544732,right,Mi9,749,-2,1,2,-1
720575940631925349,right,Mi9,750,4,-24,-16,-8
720575940646537582,right,Mi9,751,1,6,2,4
720575940635411374,right,Mi9,752,-2,7,5,2
720575940614693374,right,Mi9,753,-3,24,15,9
720575940628808235,right,Mi9,754,-1,-13,-6,-7
720575940635029785,right,Mi9,755,4,19,5,14
720575940627556126,right,Mi9,756,5,20,5,15
720575940626830723,right,Mi9,757,0,-6,-3,-3
720575940624684316,right,Mi9,758,5,-1,-6,5
720575940630373623,right,Mi9,759,7,14,0,14
720575940641633499,right,Mi9,760,0,17,8,9
720575940626308113,right,Mi9,761,-4,-18,-5,-13
720575940611424462,right,Mi9,762,0,14,7,7
720575940623773576,right,Mi9,763,-5,14,12,2
720575940644950052,right,Mi9,764,-8,-6,5,-11
720575940614593489,right,Mi9,765,-3,9,7,2
720575940638726116,right,Mi9,766,2,-4,-4,0
720575940608636169,right,Mi9,767,1,28,13,15
720575940615974294,right,Mi9,768,3,5,-1,6
720575940621615498,right,Mi9,769,4,-27,-18,-9
720575940620669400,right,Mi9,770,5,4,-3,7
720575940642607067,right,Mi9,771,3,-27,-17,-10
720575940610702946,right,Mi9,772,1,12,5,7
720575940617814326,right,Mi9,773,5,-19,-15,-4
720575940624644277,right,Mi9,774,-8,6,11,-5
720575940610721604,right,Mi9,775,5,22,6,16
720575940622807066,right,Mi9,776,5,21,5,16
720575940615611148,right,Mi9,777,6,20,4,16
720575940631613637,right,Mi9,778,4,25,8,17
720575940618730269,right,Mi9,779,5,24,7,17
720575940618686285,right,Mi9,780,-6,25,18,7
720575940632559582,right,Mi9,781,-5,26,18,8
720575940610375748,right,Mi9,782,-5,27,18,9
720575940634994527,right,Mi9,783,-4,28,18,10
720575940617171542,right,Mi9,785,-3,30,18,12
720575940642215643,right,Mi9,786,-2,30,17,13
720575940623338313,right,Mi9,788,3,27,10,17
720575940611840206,right,Mi9,789,-3,-27,-11,-16
720575940612924074,right,Mi9,790,-2,-27,-12,-15
720575940615118442,right,Mi9,791,-1,-28,-13,-15
720575940620265607,right,Mi9,792,8,2,-7,9
720575940625409831,right,Mi9,793,8,-6,-11,5
720575940608343730,right,Mi9,794,5,-26,-18,-8
720575940616052842,right,Mi9,795,6,-21,-17,-4
720575940626094862,right,Mi9,796,4,26,9,17
720575940610510275,right,R7,1,-6,13,12,1
720575940640795043,right,R7,3,6,-12,-12,0
720575940614528749,right,R7,5,-1,16,9,7
720575940628593320,right,R7,6,-2,-4,0,-4
720575940616833211,right,R7,7,-6,-6,3,-9
720575940619028737,right,R7,8,-4,26,17,9
720575940627312729,right,R7,9,4,9,0,9
720575940621441006,right,R7,10,5,-15,-13,-2
720575940621555309,right,R7,13,-1,-26,-12,-14
720575940616030358,right,R7,14,0,-27,-14,-13
720575940614251747,right,R7,16,-2,-16,-6,-10
720575940621668742,right,R7,18,5,-16,-13,-3
720575940640063805,right,R7,20,3,-11,-9,-2
720575940605179360,right,R7,21,-2,19,11,8
720575940624483475,right,R7,22,-1,3,2,1
720575940624191379,right,R7,25,-9,3,10,-7
720575940632113682,right,R7,26,1,-3,-3,0
720575940632558184,right,R7,28,5,6,-2,8
720575940609781769,right,R7,30,6,16,2,14
720575940628388264,right,R7,31,0,16,8,8
720575940606827697,right,R7,32,0,12,6,6
720575940630851383,right,R7,33,3,18,6,12
720575940609289227,right,R7,35,1,-24,-13,-11
720575940623894057,right,R7,36,6,8,-2,10
720575940623743768,right,R7,37,1,5,1,4
720575940638630889,right,R7,39,0,20,10,10
720575940621545819,right,R7,40,-2,-6,-1,-5
720575940624267667,right,R7,41,-3,28,17,11
720575940625817102,right,R7,42,-1,14,8,6
720575940625091837,right,R7,47,-9,-1,8,-9
720575940618508774,right,R7,49,4,-4,-6,2
720575940621179329,right,R7,51,0,-19,-10,-9
720575940628299834,right,R7,53,5,14,2,12
720575940614281955,right,R7,55,-4,-11,-2,-9
720575940638525662,right,R7,57,6,-11,-12,1
720575940630738652,right,R7,58,3,12,3,9
720575940611044164,right,R7,60,-8,8,12,-4
720575940610005955,right,R7,61,-4,-4,2,-6
720575940613514098,right,R7,63,4,12,2,10
720575940622261168,right,R7,64,4,-23,-16,-7
720575940622662494,right,R7,66,2,15,5,10
720575940613278194,right,R7,68,3,16,5,11
720575940625555943,right,R7,71,-2,-3,0,-3
720575940633228940,right,R7,72,0,-28,-14,-14
720575940641445840,right,R7,73,2,2,-1,3
720575940625075464,right,R7,77,2,-5,-5,0
720575940618570909,right,R7,78,2,20,8,12
720575940606095532,right,R7,79,2,1,-2,3
720575940626688144,right,R7,80,4,13,2,11
720575940617911611,right,R7,81,6,-2,-7,5
720575940617457547,right,R7,86,-5,-7,1,-8
720575940638026974,right,R7,87,1,11,4,7
720575940628128275,right,R7,88,7,4,-5,9
720575940630826231,right,R7,89,1,-19,-11,-8
720575940617625883,right,R7,92,0,9,4,5
720575940629083377,right,R7,94,5,18,4,14
720575940629102922,right,R7,95,4,-21,-15,-6
720575940620708299,right,R7,97,-5,2,6,-4
720575940622673392,right,R7,98,-1,-12,-5,-7
720575940621557743,right,R7,99,4,15,3,12
720575940634090195,right,R7,100,2,-10,-7,-3
720575940624322244,right,R7,101,-7,6,10,-4
720575940628426257,right,R7,102,3,13,3,10
720575940626212496,right,R7,105,3,22,8,14
720575940614640815,right,R7,106,-7,11,12,-1
720575940626854842,right,R7,110,-7,0,7,-7
720575940609276681,right,R7,111,2,-24,-14,-10
720575940624756989,right,R7,114,2,-13,-9,-4
720575940634355682,right,R7,115,-4,2,5,-3
720575940606534502,right,R7,116,-1,-8,-3,-5
720575940606689713,right,R7,118,3,1,-3,4
720575940632419395,right,R7,119,-2,6,5,1
720575940614762035,right,R7,120,-1,-1,0,-1
720575940622829812,right,R7,121,-8,4,10,-6
720575940621566630,right,R7,122,-5,9,9,0
720575940633478829,right,R7,124,1,-7,-5,-2
720575940640675699,right,R7,125,5,9,-1,10
720575940618604884,right,R7,126,3,11,2,9
720575940631197496,right,R7,127,0,15,7,8
720575940632508687,right,R7,128,3,-22,-14,-8
720575940631904719,right,R7,129,0,-13,-7,-6
720575940623725773,right,R7,130,2,12,4,8
720575940629542928,right,R7,132,2,4,0,4
720575940614692271,right,R7,135,-3,-22,-8,-14
720575940619596598,right,R7,136,0,3,1,2
720575940626666021,right,R7,137,5,-7,-9,2
720575940606040492,right,R7,138,0,27,13,14
720575940632007186,right,R7,140,3,8,1,7
720575940630202050,right,R7,142,-2,-18,-7,-11
720575940626344781,right,R7,146,1,-6,-4,-2
720575940616137282,right,R7,147,1,21,9,12
720575940638565342,right,R7,148,-7,-11,1,-12
720575940612367310,right,R7,149,6,-14,-13,-1
720575940632880441,right,R7,151,-3,-14,-4,-10
720575940611660152,right,R7,152,3,-15,-11,-4
720575940625137405,right,R7,156,-9,1,9,-8
720575940618713634,right,R7,158,3,-5,-6,1
720575940639102015,right,R7,161,4,-14,-11,-3
720575940614307811,right,R7,163,-9,7,12,-5
720575940616291551,right,R7,164,-1,-2,0,-2
720575940634509794,right,R7,165,4,16,4,12
720575940619203909,right,R7,166,0,18,9,9
720575940630995200,right,R7,168,-1,17,9,8
720575940621306644,right,R7,169,0,-18,-9,-9
720575940637081455,right,R7,170,-5,1,5,-4
720575940646047511,right,R7,171,6,-20,-16,-4
720575940631436229,right,R7,172,1,22,10,12
720575940608943708,right,R7,177,-2,-1,1,-2
720575940629622607,right,R7,178,2,11,3,8
720575940635075740,right,R7,181,1,-4,-3,-1
720575940622575877,right,R7,185,2,-11,-8,-3
720575940616533826,right,R7,186,-1,26,14,12
720575940623883561,right,R7,187,3,21,7,14
720575940621662145,right,R7,188,-5,17,13,4
720575940645689892,right,R7,189,6,13,0,13
720575940626802238,right,R7,190,-3,-5,0,-5
720575940618528347,right,R7,191,-1,-11,-5,-6
720575940616946630,right,R7,192,7,10,-2,12
720575940612644058,right,R7,194,0,-5,-3,-2
720575940618351060,right,R7,195,-3,-1,2,-3
720575940621295599,right,R7,196,-1,8,5,3
720575940622255937,right,R7,198,6,2,-5,7
720575940624592391,right,R7,200,-5,12,11,1
720575940641982427,right,R7,202,-1,27,14,13
720575940633306276,right,R7,203,3,-1,-4,3
720575940644218784,right,R7,204,5,-2,-6,4
720575940621931958,right,R7,208,5,-21,-16,-5
720575940622873182,right,R7,209,-3,-8,-1,-7
720575940630630782,right,R7,212,2,-16,-10,-6
720575940616093855,right,R7,215,6,7,-3,10
720575940606447793,right,R7,216,2,19,7,12
720575940630936832,right,R7,218,2,10,3,7
720575940622176628,right,R7,219,6,-4,-8,4
720575940625602023,right,R7,220,2,-6,-5,-1
720575940632467498,right,R7,221,-7,3,8,-5
720575940613045234,right,R7,223,-2,26,15,11
720575940613636266,right,R7,226,5,19,4,15
720575940609209180,right,R7,229,5,2,-4,6
720575940630486263,right,R7,230,2,9,2,7
720575940644455840,right,R7,231,4,-12,-10,-2
720575940612948210,right,R7,233,4,-13,-11,-2
720575940616860859,right,R7,234,1,3,0,3
720575940629837819,right,R7,235,4,11,1,10
720575940620105265,right,R7,238,-8,-3,6,-9
720575940622361215,right,R7,239,-6,6,9,-3
720575940630958454,right,R7,241,2,-17,-11,-6
720575940618122845,right,R7,244,-4,-12,-2,-10
720575940612083150,right,R7,245,-5,-3,3,-6
720575940621581421,right,R7,249,2,-12,-8,-4
720575940624117896,right,R7,251,-1,-14,-6,-8
720575940634173153,right,R7,252,3,23,8,15
720575940615115059,right,R7,253,5,16,3,13
720575940636094815,right,R7,258,-4,-17,-5,-12
720575940634328290,right,R7,259,-7,-5,4,-9
720575940627548930,right,R7,260,-3,19,12,7
720575940629011196,right,R7,264,-1,-6,-2,-4
720575940628784040,right,R7,268,7,-6,-10,4
720575940625968935,right,R7,269,2,-19,-12,-7
720575940615385706,right,R7,271,4,6,-1,7
720575940627718296,right,R7,272,3,-2,-4,2
720575940638106736,right,R7,273,-6,23,17,6
720575940633160332,right,R7,274,6,4,-4,8
720575940635374231,right,R7,276,2,3,-1,4
720575940635357024,right,R7,277,7,-3,-9,6
720575940618600738,right,R7,278,-5,10,10,0
720575940615386530,right,R7,282,0,26,13,13
720575940628143162,right,R7,284,0,25,12,13
720575940628816917,right,R7,285,6,-18,-15,-3
720575940627009086,right,R7,286,0,-24,-12,-12
720575940621079431,right,R7,289,-1,11,6,5
720575940620451800,right,R7,290,5,-24,-17,-7
720575940639279686,right,R7,291,7,2,-6,8
720575940636063339,right,R7,298,-5,5,7,-2
720575940633101260,right,R7,299,-4,12,10,2
720575940622780165,right,R7,301,-5,16,13,3
720575940617035788,right,R7,302,2,17,6,11
720575940625007112,right,R7,305,-7,4,9,-5
720575940639439174,right,R7,306,3,7,0,7
720575940606814897,right,R7,310,2,22,9,13
720575940627760280,right,R7,311,-7,15,14,1
720575940625429652,right,R7,312,4,-7,-8,1
720575940635080985,right,R7,313,7,3,-6,9
720575940635568026,right,R7,315,-3,-6,0,-6
720575940616135530,right,R7,316,5,-4,-7,3
720575940628331688,right,R7,317,-5,-4,3,-7
720575940632619576,right,R7,318,4,-19,-14,-5
720575940612251746,right,R7,319,-2,5,4,1
720575940655814049,right,R7,320,-2,-5,-1,-4
720575940620979282,right,R7,324,3,24,9,15
720575940621668120,right,R7,325,5,1,-5,6
720575940620940927,right,R7,326,2,16,6,10
720575940626849226,right,R7,327,5,3,-4,7
720575940619837598,right,R7,328,5,-9,-10,1
720575940619741494,right,R7,329,0,24,12,12
720575940628898792,right,R7,331,1,-15,-9,-6
720575940616616390,right,R7,333,0,-21,-11,-10
720575940624248870,right,R7,334,1,-26,-14,-12
720575940614500392,right,R7,335,2,8,2,6
720575940617762875,right,R7,336,0,23,11,12
720575940627072514,right,R7,337,-5,-6,2,-8
720575940625261547,right,R7,338,-1,0,1,-1
720575940627307097,right,R7,339,6,11,-1,12
720575940618653697,right,R7,345,3,-12,-9,-3
720575940625274603,right,R7,347,-5,-13,-2,-11
720575940633762003,right,R7,348,3,14,4,10
720575940634377698,right,R7,349,-5,-14,-2,-12
720575940620921734,right,R7,350,1,15,6,9
720575940614902568,right,R7,355,-7,-6,4,-10
720575940628184914,right,R7,359,2,23,9,14
720575940621826470,right,R7,360,-5,19,14,5
720575940609720515,right,R7,362,2,-20,-12,-8
720575940621459905,right,R7,363,7,-4,-9,5
720575940626717114,right,R7,364,4,4,-2,6
720575940628823281,right,R7,365,4,7,-1,8
720575940627805833,right,R7,367,-6,-15,-2,-13
720575940646164334,right,R7,369,5,-5,-8,3
720575940619901598,right,R7,370,-3,21,13,8
720575940626644068,right,R7,372,1,-2,-2,0
720575940622366704,right,R7,374,2,13,4,9
720575940613782294,right,R7,375,-6,7,9,-2
720575940631732687,right,R7,377,0,7,3,4
720575940636971895,right,R7,385,-3,-18,-6,-12
720575940624761597,right,R7,386,-6,19,15,4
720575940638942015,right,R7,387,-1,-15,-7,-8
720575940632773703,right,R7,388,3,19,6,13
720575940632426088,right,R7,390,-6,-9,1,-10
720575940606421257,right,R7,391,4,-3,-6,3
720575940623880328,right,R7,392,-4,7,7,0
720575940623949923,right,R7,393,-1,22,12,10
720575940618551041,right,R7,394,-7,-8,3,-11
720575940613020658,right,R7,395,0,-22,-11,-11
720575940622943207,right,R7,396,-1,10,6,4
720575940623039446,right,R7,397,-3,-19,-7,-12
720575940627799677,right,R7,401,-2,-19,-8,-11
720575940617281622,right,R7,402,3,26,10,16
720575940621072065,right,R7,403,-2,-12,-4,-8
720575940628439812,right,R7,405,3,10,2,8
720575940627284324,right,R7,406,1,-25,-14,-11
720575940629159153,right,R7,407,-5,-10,0,-10
720575940653274870,right,R7,408,-6,-4,4,-8
720575940619909359,right,R7,409,0,-3,-2,-1
720575940632869423,right,R7,410,-2,-2,1,-3
720575940628730344,right,R7,411,-5,-19,-5,-14
720575940627281922,right,R7,413,-2,-7,-2,-5
720575940632021867,right,R7,414,4,21,6,15
720575940625272980,right,R7,415,6,12,0,12
720575940625954744,right,R7,416,3,-8,-7,-1
720575940628193161,right,R7,417,-6,-10,1,-11
720575940621610678,right,R7,419,-3,-11,-3,-8
720575940632266794,right,R7,420,6,-3,-8,5
720575940627148234,right,R7,422,-7,-4,5,-9
720575940647411491,right,R7,423,3,-18,-12,-6
720575940632396875,right,R7,424,-3,-2,2,-4
720575940632108586,right,R7,425,3,20,7,13
720575940618089428,right,R7,427,5,-18,-14,-4
720575940628253690,right,R7,429,-2,14,9,5
720575940625534612,right,R7,430,-3,-7,-1,-6
720575940620840327,right,R7,431,-2,-10,-3,-7
720575940625290900,right,R7,432,-5,7,8,-1
720575940621436911,right,R7,435,5,-17,-14,-3
720575940622239664,right,R7,436,0,-15,-8,-7
720575940611892946,right,R7,438,2,27,11,16
720575940625983219,right,R7,440,1,23,10,13
720575940632832583,right,R7,442,-5,25,17,8
720575940631936197,right,R7,446,2,-14,-9,-5
720575940625158206,right,R7,447,-1,2,2,0
720575940637259895,right,R7,449,6,-16,-14,-2
720575940631242700,right,R7,450,2,-9,-7,-2
720575940628767899,right,R7,451,4,20,6,14
720575940636414712,right,R7,452,1,-9,-6,-3
720575940623930665,right,R7,453,3,25,9,16
720575940626826682,right,R7,454,5,-12,-11,-1
720575940616882738,right,R7,455,7,-7,-11,4
720575940628293892,right,R7,456,0,21,10,11
720575940625709582,right,R7,458,5,0,-5,5
720575940622614260,right,R7,459,5,-3,-7,4
720575940628008264,right,R7,460,-3,-20,-7,-13
720575940616430146,right,R7,461,7,-5,-10,5
720575940622500592,right,R7,462,-1,18,10,8
720575940625906190,right,R7,463,5,17,3,14
720575940631207276,right,R7,465,3,0,-3,3
720575940625872973,right,R7,466,1,14,6,8
720575940613244389,right,R7,467,-2,-20,-8,-12
720575940612419790,right,R7,471,3,-26,-16,-10
720575940614063853,right,R7,472,1,25,11,14
720575940635631767,right,R7,473,-4,23,15,8
720575940631286487,right,R7,476,-1,15,8,7
720575940613467158,right,R7,481,4,-8,-8,0
720575940636905071,right,R7,482,1,17,7,10
720575940627497609,right,R7,483,2,-7,-6,-1
720575940632951633,right,R7,484,3,-9,-8,-1
720575940637806766,right,R7,485,-3,-3,1,-4
720575940619880758,right,R7,488,7,5,-5,10
720575940628073298,right,R7,491,7,-1,-8,7
720575940613514649,right,R7,492,-7,-2,6,-8
720575940609758985,right,R7,493,-3,23,14,9
720575940615613855,right,R7,496,7,8,-3,11
720575940616946886,right,R7,497,6,1,-6,7
720575940634801844,right,R7,498,6,10,-1,11
720575940634306274,right,R7,499,5,10,0,10
720575940628712964,right,R7,500,7,-8,-11,3
720575940629012732,right,R7,501,1,2,0,2
720575940660931713,right,R7,502,5,8,-1,9
720575940634132634,right,R7,503,3,17,5,12
720575940621067712,right,R7,504,-2,9,6,3
720575940643100813,right,R7,507,-5,-12,-1,-11
720575940625750164,right,R7,508,-5,11,10,1
720575940606450110,right,R7,511,5,-11,-11,0
720575940628063613,right,R7,512,6,0,-6,6
720575940644542755,right,R7,514,-4,-10,-1,-9
720575940627945810,right,R7,519,-5,-5,2,-7
720575940626634698,right,R7,521,6,-9,-11,2
720575940628986954,right,R7,523,2,14,5,9
720575940632484419,right,R7,525,-1,-20,-9,-11
720575940630898944,right,R7,526,0,-10,-5,-5
720575940630526967,right,R7,527,-4,-8,0,-8
720575940625114877,right,R7,528,2,7,1,6
720575940618186555,right,R7,529,2,-2,-3,1
720575940621956161,right,R7,531,1,0,-1,1
720575940625675412,right,R7,532,-8,7,11,-4
720575940622990597,right,R7,533,0,-16,-8,-8
720575940631638981,right,R7,534,3,2,-2,4
720575940629372521,right,R7,536,3,4,-1,5
720575940618392610,right,R7,537,0,-23,-12,-11
720575940614506536,right,R7,538,-4,1,4,-3
720575940645816343,right,R7,539,-6,15,13,2
720575940626342733,right,R7,540,-2,-9,-3,-6
720575940619045957,right,R7,542,6,-13,-13,0
720575940626800944,right,R7,543,-1,-4,-1,-3
720575940620259377,right,R7,546,3,6,0,6
720575940640156494,right,R7,547,-1,21,11,10
720575940617289403,right,R7,548,1,-16,-9,-7
720575940634206690,right,R7,549,0,-9,-5,-4
720575940627970898,right,R7,551,-4,-9,-1,-8
720575940621508262,right,R7,552,4,-1,-5,4
720575940631278444,right,R7,556,0,10,5,5
720575940622320048,right,R7,561,5,7,-2,9
720575940614299107,right,R7,562,-5,-2,4,-6
720575940624488595,right,R7,563,5,-13,-12,-1
720575940627455234,right,R7,567,-2,22,13,9
720575940632103466,right,R7,568,-6,-8,2,-10
720575940612238946,right,R7,570,2,25,10,15
720575940647406115,right,R7,571,0,-14,-7,-7
720575940639314291,right,R7,573,4,14,3,11
720575940631317292,right,R7,575,6,9,-2,11
720575940625930995,right,R7,576,0,28,14,14
720575940625308391,right,R7,579,-3,-10,-2,-8
720575940631870671,right,R7,580,-2,-23,-10,-13
720575940621461441,right,R7,581,3,9,1,8
720575940627155331,right,R7,583,3,-25,-16,-9
720575940617262197,right,R7,585,-1,-23,-11,-12
720575940622828276,right,R7,586,2,18,7,11
720575940633839021,right,R7,587,4,22,7,15
720575940622972705,right,R7,589,-1,-5,-2,-3
720575940626594853,right,R7,590,1,9,3,6
720575940621117121,right,R7,591,3,-3,-5,2
720575940615790230,right,R7,595,7,-12,-13,1
720575940636660855,right,R7,596,-4,-16,-4,-12
720575940626774064,right,R7,597,4,1,-4,5
720575940640581235,right,R7,598,2,-18,-11,-7
720575940618657281,right,R7,600,3,-10,-8,-2
720575940624180628,right,R7,601,1,16,7,9
720575940619326262,right,R7,602,4,-2,-5,3
720575940633464109,right,R7,603,-3,-23,-9,-14
720575940618566557,right,R7,604,-6,-17,-3,-14
720575940619344453,right,R7,605,3,15,4,11
720575940621783137,right,R7,606,-1,-19,-9,-10
720575940620935188,right,R7,607,1,18,8,10
720575940625880846,right,R7,609,-2,0,2,-2
720575940629783811,right,R7,610,2,-23,-14,-9
720575940643065997,right,R7,611,-1,-18,-8,-10
720575940622306486,right,R7,615,-7,-7,3,-10
720575940613128345,right,R7,616,-3,15,10,5
720575940635079324,right,R7,617,-2,-17,-7,-10
720575940612468942,right,R7,620,7,1,-7,8
720575940650787193,right,R7,621,1,24,11,13
720575940624086825,right,R7,622,-5,20,15,5
720575940613666326,right,R7,623,1,13,5,8
720575940624623879,right,R7,625,-2,24,14,10
720575940628218511,right,R7,626,-5,-8,1,-9
720575940629787651,right,R7,628,0,0,0,0
720575940635654039,right,R7,629,4,24,8,16
720575940612839859,right,R7,630,4,8,0,8
720575940653311478,right,R7,631,1,26,12,14
720575940623737549,right,R7,633,-1,-24,-11,-13
720575940625449620,right,R7,634,-3,-15,-5,-10
720575940644754592,right,R7,635,6,-6,-9,3
720575940616369474,right,R7,637,3,-21,-14,-7
720575940633341604,right,R7,640,-1,-16,-7,-9
720575940634459361,right,R7,642,-5,-11,-1,-10
720575940624989960,right,R7,643,6,14,1,13
720575940621661377,right,R7,647,-4,-7,0,-7
720575940624151432,right,R7,649,-1,5,3,2
720575940622616670,right,R7,650,-3,-25,-10,-15
720575940627974808,right,R7,652,-6,-11,0,-11
720575940638404580,right,R7,655,6,-1,-7,6
720575940647181091,right,R7,656,0,-11,-6,-5
720575940624544806,right,R7,657,-2,-25,-11,-14
720575940620961729,right,R7,658,1,20,9,11
720575940628243002,right,R7,659,-4,-6,1,-7
720575940647182627,right,R7,662,2,-1,-3,2
720575940620878539,right,R7,663,0,8,4,4
720575940639258431,right,R7,664,1,-27,-15,-12
720575940626364976,right,R7,665,7,-2,-8,6
720575940621087570,right,R7,668,1,19,8,11
720575940626914110,right,R7,669,4,-16,-12,-4
720575940613201075,right,R7,672,-8,11,13,-2
720575940629067004,right,R7,674,-4,-14,-3,-11
720575940618628436,right,R7,676,-3,-21,-8,-13
720575940626279205,right,R7,678,3,-7,-7,0
720575940622193432,right,R7,679,4,18,5,13
720575940606495422,right,R7,681,-2,-21,-9,-12
720575940627280130,right,R7,682,6,-8,-10,2
720575940623914851,right,R7,684,-6,17,14,3
720575940630314110,right,R7,685,-5,-9,0,-9
720575940635996826,right,R7,686,5,-22,-16,-6
720575940615318178,right,R7,687,-6,-3,4,-7
720575940629970279,right,R7,689,-2,18,11,7
720575940633849901,right,R7,692,-4,24,16,8
720575940624028003,right,R7,693,-3,25,15,10
720575940624106948,right,R7,694,4,3,-3,6
720575940628447119,right,R7,695,-6,10,11,-1
720575940644770504,right,R7,697,1,-22,-12,-10
720575940624195987,right,R7,698,6,-7,-10,3
720575940627824912,right,R7,700,5,15,2,13
720575940635494810,right,R7,701,0,-4,-2,-2
720575940619807542,right,R7,702,-5,23,16,7
720575940636454392,right,R7,704,-7,8,11,-3
720575940609505545,right,R7,705,1,1,-1,2
720575940617065403,right,R7,707,-2,25,14,11
720575940631913047,right,R7,710,4,-25,-17,-8
720575940627937157,right,R7,711,-1,19,10,9
720575940626462864,right,R7,714,5,12,1,11
720575940627108636,right,R7,715,4,10,1,9
720575940641063632,right,R7,716,4,-6,-7,1
720575940611818594,right,R7,719,1,27,12,15
720575940624349674,right,R7,721,5,13,1,12
720575940655749793,right,R7,722,6,-15,-14,-1
720575940621474330,right,R7,724,4,2,-3,5
720575940630464503,right,R7,725,-3,-24,-9,-15
720575940645059784,right,R7,727,7,6,-4,10
720575940619144000,right,R7,728,7,12,-1,13
720575940631374843,right,R7,730,7,0,-7,7
720575940627925842,right,R7,731,-6,9,10,-1
720575940635609751,right,R7,734,2,0,-2,2
720575940628194577,right,R7,735,1,-23,-13,-10
720575940636832375,right,R7,736,-8,1,8,-7
720575940645656612,right,R7,737,0,19,9,10
720575940631228665,right,R7,739,-7,2,8,-6
720575940622464383,right,R7,741,-2,-14,-5,-9
720575940625812408,right,R7,742,-4,11,9,2
720575940632936248,right,R7,744,-4,25,16,9
720575940616016287,right,R7,745,0,13,6,7
720575940623123881,right,R7,747,0,2,1,1
720575940637659534,right,R7,748,-4,20,14,6
720575940618650625,right,R7,749,-2,1,2,-1
720575940633223308,right,R7,751,1,6,2,4
720575940613668210,right,R7,752,-2,7,5,2
720575940644535200,right,R7,753,-3,24,15,9
720575940606367166,right,R7,754,-1,-13,-6,-7
720575940647041315,right,R7,755,4,19,5,14
720575940621555565,right,R7,756,5,20,5,15
720575940624033535,right,R7,758,5,-1,-6,5
720575940624609461,right,R7,760,0,17,8,9
720575940628416017,right,R7,761,-4,-18,-5,-13
720575940618594333,right,R7,762,0,14,7,7
720575940623073809,right,R7,763,-5,14,12,2
720575940612598165,right,R7,766,2,-4,-4,0
720575940615436178,right,R7,768,3,5,-1,6
720575940624971337,right,R7,770,5,4,-3,7
720575940631606981,right,R7,773,5,-19,-15,-4
720575940628640252,right,R7,775,5,22,6,16
720575940612990869,right,R8,1,-6,13,12,1
720575940618237533,right,R8,2,-8,2,9,-7
720575940642841636,right,R8,5,-1,16,9,7
720575940626681744,right,R8,6,-2,-4,0,-4
720575940633631661,right,R8,7,-6,-6,3,-9
720575940624504516,right,R8,8,-4,26,17,9
720575940629043708,right,R8,9,4,9,0,9
720575940637804144,right,R8,10,5,-15,-13,-2
720575940629127153,right,R8,12,-7,9,11,-2
720575940636287851,right,R8,13,-1,-26,-12,-14
720575940626400304,right,R8,15,2,-3,-4,1
720575940645192228,right,R8,16,-2,-16,-6,-10
720575940624028515,right,R8,17,1,-5,-4,-1
720575940627225274,right,R8,18,5,-16,-13,-3
720575940635530848,right,R8,20,3,-11,-9,-2
720575940627104284,right,R8,21,-2,19,11,8
720575940637513390,right,R8,22,-1,3,2,1
720575940620592587,right,R8,23,-3,-16,-5,-11
720575940630984247,right,R8,24,-1,-10,-4,-6
720575940611473272,right,R8,25,-9,3,10,-7
720575940613271781,right,R8,26,1,-3,-3,0
720575940644949960,right,R8,27,0,-25,-13,-12
720575940629126662,right,R8,28,5,6,-2,8
720575940616283714,right,R8,29,-1,-3,-1,-2
720575940628946152,right,R8,30,6,16,2,14
720575940642217717,right,R8,31,0,16,8,8
720575940609479179,right,R8,32,0,12,6,6
720575940630851639,right,R8,33,3,18,6,12
720575940635244700,right,R8,35,1,-24,-13,-11
720575940617300054,right,R8,36,6,8,-2,10
720575940659591297,right,R8,37,1,5,1,4
720575940625383572,right,R8,38,0,-2,-1,-1
720575940611742818,right,R8,39,0,20,10,10
720575940632737327,right,R8,40,-2,-6,-1,-5
720575940628230223,right,R8,41,-3,28,17,11
720575940636066155,right,R8,42,-1,14,8,6
720575940623506909,right,R8,44,5,-10,-10,0
720575940633588900,right,R8,45,-5,-1,4,-5
720575940628302858,right,R8,47,-9,-1,8,-9
720575940645617175,right,R8,49,4,-4,-6,2
720575940633497631,right,R8,50,-2,21,12,9
720575940628473928,right,R8,51,0,-19,-10,-9
720575940620630987,right,R8,52,-1,-22,-10,-12
720575940606401507,right,R8,53,5,14,2,12
720575940622258870,right,R8,55,-4,-11,-2,-9
720575940621958310,right,R8,57,6,-11,-12,1
720575940631710671,right,R8,58,3,12,3,9
720575940639837373,right,R8,59,-2,2,3,-1
720575940633161799,right,R8,60,-8,8,12,-4
720575940628333992,right,R8,61,-4,-4,2,-6
720575940624152344,right,R8,63,4,12,2,10
720575940630609346,right,R8,65,-1,28,15,13
720575940613491941,right,R8,66,2,15,5,10
720575940640214325,right,R8,68,3,16,5,11
720575940633122607,right,R8,69,1,8,3,5
720575940622900257,right,R8,71,-2,-3,0,-3
720575940619779126,right,R8,72,0,-28,-14,-14
720575940619775355,right,R8,73,2,2,-1,3
720575940642976141,right,R8,74,-1,-9,-4,-5
720575940625333228,right,R8,76,-3,-4,1,-5
720575940640214643,right,R8,77,2,-5,-5,0
720575940629835419,right,R8,78,2,20,8,12
720575940621543083,right,R8,79,2,1,-2,3
720575940624699901,right,R8,80,4,13,2,11
720575940620777095,right,R8,81,6,-2,-7,5
720575940621891238,right,R8,82,-7,7,10,-3
720575940630803578,right,R8,83,2,-21,-13,-8
720575940625494164,right,R8,84,-2,12,8,4
720575940618769665,right,R8,85,4,-22,-15,-7
720575940606182246,right,R8,86,-5,-7,1,-8
720575940636028664,right,R8,87,1,11,4,7
720575940638072432,right,R8,89,1,-19,-11,-8
720575940620940629,right,R8,90,-4,5,6,-1
720575940611758034,right,R8,91,-1,6,4,2
720575940616486598,right,R8,92,0,9,4,5
720575940621324564,right,R8,93,-6,3,7,-4
720575940610840782,right,R8,94,5,18,4,14
720575940640279093,right,R8,95,4,-21,-15,-6
720575940616331487,right,R8,97,-5,2,6,-4
720575940615592354,right,R8,98,-1,-12,-5,-7
720575940617918393,right,R8,99,4,15,3,12
720575940614850479,right,R8,100,2,-10,-7,-3
720575940639989181,right,R8,101,-7,6,10,-4
720575940631208443,right,R8,102,3,13,3,10
720575940628148111,right,R8,105,3,22,8,14
720575940648147844,right,R8,106,-7,11,12,-1
720575940631880399,right,R8,108,-3,-12,-3,-9
720575940650571385,right,R8,109,4,-5,-7,2
720575940640285272,right,R8,110,-7,0,7,-7
720575940630415810,right,R8,111,2,-24,-14,-10
720575940609330012,right,R8,114,2,-13,-9,-4
720575940628813316,right,R8,115,-4,2,5,-3
720575940616158943,right,R8,116,-1,-8,-3,-5
720575940627144323,right,R8,117,-8,-2,7,-9
720575940629915139,right,R8,118,3,1,-3,4
720575940612968666,right,R8,119,-2,6,5,1
720575940622294221,right,R8,120,-1,-1,0,-1
720575940625986087,right,R8,121,-8,4,10,-6
720575940648618628,right,R8,122,-5,9,9,0
720575940612920433,right,R8,124,1,-7,-5,-2
720575940613374691,right,R8,125,5,9,-1,10
720575940629544195,right,R8,126,3,11,2,9
720575940627265892,right,R8,127,0,15,7,8
720575940621678957,right,R8,129,0,-13,-7,-6
720575940637156197,right,R8,130,2,12,4,8
720575940623576029,right,R8,132,2,4,0,4
720575940615644818,right,R8,134,-5,-18,-4,-14
720575940630804791,right,R8,135,-3,-22,-8,-14
720575940615021352,right,R8,136,0,3,1,2
720575940628288143,right,R8,137,5,-7,-9,2
720575940627519613,right,R8,138,0,27,13,14
720575940616363935,right,R8,140,3,8,1,7
720575940609190921,right,R8,142,-2,-18,-7,-11
720575940612830577,right,R8,145,0,4,2,2
720575940636539896,right,R8,146,1,-6,-4,-2
720575940637277070,right,R8,147,1,21,9,12
720575940633523916,right,R8,148,-7,-11,1,-12
720575940609928459,right,R8,149,6,-14,-13,-1
720575940625634830,right,R8,150,-8,5,10,-5
720575940614352867,right,R8,151,-3,-14,-4,-10
720575940618228441,right,R8,152,3,-15,-11,-4
720575940639003455,right,R8,156,-9,1,9,-8
720575940613292202,right,R8,157,-1,-7,-3,-4
720575940611588050,right,R8,158,3,-5,-6,1
720575940624639978,right,R8,162,-4,-2,3,-5
720575940634855449,right,R8,165,4,16,4,12
720575940626859152,right,R8,166,0,18,9,9
720575940636160504,right,R8,168,-1,17,9,8
720575940637804206,right,R8,169,0,-18,-9,-9
720575940621748929,right,R8,170,-5,1,5,-4
720575940636781167,right,R8,171,6,-20,-16,-4
720575940616077983,right,R8,172,1,22,10,12
720575940620585265,right,R8,174,4,-15,-12,-3
720575940628632337,right,R8,175,-6,-7,2,-9
720575940623049804,right,R8,176,-2,13,8,5
720575940606524337,right,R8,177,-2,-1,1,-2
720575940626630288,right,R8,178,2,11,3,8
720575940653496822,right,R8,181,1,-4,-3,-1
720575940626375501,right,R8,182,7,-10,-12,2
720575940627563550,right,R8,183,-5,-15,-3,-12
720575940631952715,right,R8,184,-6,-5,3,-8
720575940633507359,right,R8,185,2,-11,-8,-3
720575940632515897,right,R8,186,-1,26,14,12
720575940630223771,right,R8,187,3,21,7,14
720575940645369111,right,R8,188,-5,17,13,4
720575940626044348,right,R8,189,6,13,0,13
720575940620972308,right,R8,190,-3,-5,0,-5
720575940616547270,right,R8,191,-1,-11,-5,-6
720575940628826116,right,R8,192,7,10,-2,12
720575940624063526,right,R8,193,-5,4,7,-3
720575940628873192,right,R8,194,0,-5,-3,-2
720575940626956837,right,R8,195,-3,-1,2,-3
720575940619575163,right,R8,196,-1,8,5,3
720575940647644724,right,R8,197,0,-20,-10,-10
720575940615146547,right,R8,198,6,2,-5,7
720575940628140421,right,R8,199,0,-12,-6,-6
720575940640363683,right,R8,200,-5,12,11,1
720575940633457197,right,R8,202,-1,27,14,13
720575940632445852,right,R8,203,3,-1,-4,3
720575940630474434,right,R8,204,5,-2,-6,4
720575940629079302,right,R8,205,5,-6,-8,2
720575940629425994,right,R8,206,-3,5,5,0
720575940612702577,right,R8,208,5,-21,-16,-5
720575940622572159,right,R8,209,-3,-8,-1,-7
720575940621727983,right,R8,210,-6,8,10,-2
720575940626030925,right,R8,211,-7,-1,6,-7
720575940614717736,right,R8,212,2,-16,-10,-6
720575940617533323,right,R8,213,3,-4,-5,1
720575940617734203,right,R8,215,6,7,-3,10
720575940618679069,right,R8,216,2,19,7,12
720575940627290457,right,R8,218,2,10,3,7
720575940624153226,right,R8,219,6,-4,-8,4
720575940613614250,right,R8,220,2,-6,-5,-1
720575940626408525,right,R8,221,-7,3,8,-5
720575940621803361,right,R8,223,-2,26,15,11
720575940613537046,right,R8,225,2,-26,-15,-11
720575940627603230,right,R8,226,5,19,4,15
720575940612696282,right,R8,227,-7,5,9,-4
720575940622454817,right,R8,229,5,2,-4,6
720575940613141913,right,R8,230,2,9,2,7
720575940623836440,right,R8,231,4,-12,-10,-2
720575940633626285,right,R8,232,-4,13,10,3
720575940644726728,right,R8,233,4,-13,-11,-2
720575940623871437,right,R8,234,1,3,0,3
720575940628543748,right,R8,235,4,11,1,10
720575940632832824,right,R8,238,-8,-3,6,-9
720575940627958149,right,R8,239,-6,6,9,-3
720575940631557228,right,R8,240,-4,-3,2,-5
720575940640426611,right,R8,241,2,-17,-11,-6
720575940610880324,right,R8,242,-4,6,7,-1
720575940640724864,right,R8,243,-1,-21,-10,-11
720575940618347220,right,R8,244,-4,-12,-2,-10
720575940632482105,right,R8,245,-5,-3,3,-6
720575940627185436,right,R8,248,-6,0,6,-6
720575940609288457,right,R8,249,2,-12,-8,-4
720575940624977481,right,R8,250,-1,1,1,0
720575940619086149,right,R8,251,-1,-14,-6,-8
720575940627861125,right,R8,252,3,23,8,15
720575940633840685,right,R8,253,5,16,3,13
720575940632800396,right,R8,254,3,-24,-15,-9
720575940626782270,right,R8,255,-6,-13,-1,-12
720575940618433826,right,R8,256,5,-20,-15,-5
720575940624309798,right,R8,258,-4,-17,-5,-12
720575940618574493,right,R8,259,-7,-5,4,-9
720575940641763981,right,R8,261,-1,13,7,6
720575940640536179,right,R8,262,1,-11,-7,-4
720575940613637861,right,R8,263,-3,4,5,-1
720575940623572445,right,R8,264,-1,-6,-2,-4
720575940625165897,right,R8,267,-6,2,7,-5
720575940613192677,right,R8,268,7,-6,-10,4
720575940636153451,right,R8,269,2,-19,-12,-7
720575940624834741,right,R8,270,1,-8,-5,-3
720575940620986459,right,R8,271,4,6,-1,7
720575940650505081,right,R8,272,3,-2,-4,2
720575940625588460,right,R8,273,-6,23,17,6
720575940631221564,right,R8,274,6,4,-4,8
720575940634901017,right,R8,275,-8,-1,7,-8
720575940629612075,right,R8,276,2,3,-1,4
720575940631406329,right,R8,277,7,-3,-9,6
720575940628642044,right,R8,278,-5,10,10,0
720575940624073510,right,R8,279,-4,8,8,0
720575940656086177,right,R8,280,-6,-14,-1,-13
720575940609013769,right,R8,282,0,26,13,13
720575940607898034,right,R8,283,-4,4,6,-2
720575940613867235,right,R8,284,0,25,12,13
720575940631526518,right,R8,285,6,-18,-15,-3
720575940618313105,right,R8,286,0,-24,-12,-12
720575940613710194,right,R8,290,5,-24,-17,-7
720575940633292461,right,R8,291,7,2,-6,8
720575940625755123,right,R8,292,-4,18,13,5
720575940627081828,right,R8,296,1,-18,-10,-8
720575940618871197,right,R8,298,-5,5,7,-2
720575940623086369,right,R8,300,4,-18,-13,-5
720575940622574580,right,R8,301,-5,16,13,3
720575940624480915,right,R8,302,2,17,6,11
720575940633323807,right,R8,303,-5,22,16,6
720575940627919902,right,R8,304,6,5,-4,9
720575940628473092,right,R8,305,-7,4,9,-5
720575940628201786,right,R8,306,3,7,0,7
720575940613579178,right,R8,308,-5,8,9,-1
720575940615659682,right,R8,310,2,22,9,13
720575940614832435,right,R8,311,-7,15,14,1
720575940624020521,right,R8,312,4,-7,-8,1
720575940606723430,right,R8,313,7,3,-6,9
720575940621680481,right,R8,315,-3,-6,0,-6
720575940615280551,right,R8,316,5,-4,-7,3
720575940628746312,right,R8,317,-5,-4,3,-7
720575940618467985,right,R8,318,4,-19,-14,-5
720575940612445107,right,R8,319,-2,5,4,1
720575940628688616,right,R8,320,-2,-5,-1,-4
720575940626264880,right,R8,322,2,26,11,15
720575940615130274,right,R8,324,3,24,9,15
720575940629951504,right,R8,325,5,1,-5,6
720575940632792899,right,R8,326,2,16,6,10
720575940618518246,right,R8,328,5,-9,-10,1
720575940625686349,right,R8,329,0,24,12,12
720575940624437130,right,R8,330,3,3,-2,5
720575940620910160,right,R8,331,1,-15,-9,-6
720575940616317599,right,R8,334,1,-26,-14,-12
720575940639674200,right,R8,335,2,8,2,6
720575940613428502,right,R8,336,0,23,11,12
720575940631563769,right,R8,337,-5,-6,2,-8
720575940612768369,right,R8,338,-1,0,1,-1
720575940632451897,right,R8,339,6,11,-1,12
720575940608239026,right,R8,340,-4,17,12,5
720575940630168314,right,R8,341,6,-17,-15,-2
720575940639955509,right,R8,342,2,-15,-10,-5
720575940640218702,right,R8,343,-3,27,16,11
720575940624684727,right,R8,345,3,-12,-9,-3
720575940618697757,right,R8,346,-7,-9,2,-11
720575940625978044,right,R8,347,-5,-13,-2,-11
720575940618485945,right,R8,348,3,14,4,10
720575940626614053,right,R8,349,-5,-14,-2,-12
720575940611534449,right,R8,350,1,15,6,9
720575940626341424,right,R8,353,2,24,10,14
720575940614929361,right,R8,354,-2,-26,-11,-15
720575940653535990,right,R8,355,-7,-6,4,-10
720575940614387181,right,R8,356,0,22,11,11
720575940630611712,right,R8,359,2,23,9,14
720575940622897178,right,R8,360,-5,19,14,5
720575940616290527,right,R8,361,0,-7,-4,-3
720575940606399678,right,R8,362,2,-20,-12,-8
720575940628441105,right,R8,363,7,-4,-9,5
720575940615468987,right,R8,364,4,4,-2,6
720575940626094413,right,R8,365,4,7,-1,8
720575940635028761,right,R8,367,-6,-15,-2,-13
720575940634046419,right,R8,369,5,-5,-8,3
720575940611671416,right,R8,370,-3,21,13,8
720575940624260646,right,R8,371,6,-5,-9,4
720575940628467985,right,R8,372,1,-2,-2,0
720575940634787097,right,R8,373,1,-21,-12,-9
720575940626341680,right,R8,374,2,13,4,9
720575940622057332,right,R8,375,-6,7,9,-2
720575940629166953,right,R8,377,0,7,3,4
720575940635885759,right,R8,378,-3,18,12,6
720575940623865624,right,R8,382,3,-6,-6,0
720575940615052946,right,R8,385,-3,-18,-6,-12
720575940621743451,right,R8,386,-6,19,15,4
720575940632255530,right,R8,388,3,19,6,13
720575940613077221,right,R8,390,-6,-9,1,-10
720575940612982770,right,R8,391,4,-3,-6,3
720575940647525940,right,R8,392,-4,7,7,0
720575940632662329,right,R8,393,-1,22,12,10
720575940618327330,right,R8,394,-7,-8,3,-11
720575940621783649,right,R8,395,0,-22,-11,-11
720575940630306942,right,R8,396,-1,10,6,4
720575940636329140,right,R8,397,-3,-19,-7,-12
720575940630989879,right,R8,401,-2,-19,-8,-11
720575940624604855,right,R8,402,3,26,10,16
720575940619120453,right,R8,403,-2,-12,-4,-8
720575940618216166,right,R8,404,-1,20,11,9
720575940634301154,right,R8,405,3,10,2,8
720575940624139800,right,R8,406,1,-25,-14,-11
720575940621287104,right,R8,407,-5,-10,0,-10
720575940621423041,right,R8,408,-6,-4,4,-8
720575940610417347,right,R8,409,0,-3,-2,-1
720575940614101731,right,R8,410,-2,-2,1,-3
720575940628317778,right,R8,411,-5,-19,-5,-14
720575940625745907,right,R8,413,-2,-7,-2,-5
720575940624717565,right,R8,414,4,21,6,15
720575940615934943,right,R8,415,6,12,0,12
720575940641200512,right,R8,416,3,-8,-7,-1
720575940621040213,right,R8,417,-6,-10,1,-11
720575940623376716,right,R8,419,-3,-11,-3,-8
720575940632631097,right,R8,420,6,-3,-8,5
720575940631194167,right,R8,422,-7,-4,5,-9
720575940630487287,right,R8,423,3,-18,-12,-6
720575940624112531,right,R8,425,3,20,7,13
720575940627211522,right,R8,426,-3,0,3,-3
720575940632115983,right,R8,427,5,-18,-14,-4
720575940621190022,right,R8,429,-2,14,9,5
720575940627537497,right,R8,430,-3,-7,-1,-6
720575940630591479,right,R8,431,-2,-10,-3,-7
720575940622751145,right,R8,432,-5,7,8,-1
720575940607890121,right,R8,434,-3,7,6,1
720575940647152931,right,R8,435,5,-17,-14,-3
720575940638782953,right,R8,436,0,-15,-8,-7
720575940629678697,right,R8,437,-3,12,9,3
720575940615145011,right,R8,438,2,27,11,16
720575940631037244,right,R8,439,-3,-9,-2,-7
720575940634222049,right,R8,440,1,23,10,13
720575940614727720,right,R8,441,3,-16,-11,-5
720575940621000468,right,R8,442,-5,25,17,8
720575940610022357,right,R8,445,-2,8,6,2
720575940621905773,right,R8,446,2,-14,-9,-5
720575940633169177,right,R8,447,-1,2,2,0
720575940621922998,right,R8,449,6,-16,-14,-2
720575940609161308,right,R8,450,2,-9,-7,-2
720575940640159293,right,R8,451,4,20,6,14
720575940621996129,right,R8,452,1,-9,-6,-3
720575940625447655,right,R8,453,3,25,9,16
720575940620575281,right,R8,454,5,-12,-11,-1
720575940617999931,right,R8,455,7,-7,-11,4
720575940626533220,right,R8,456,0,21,10,11
720575940625438700,right,R8,457,-2,17,10,7
720575940605822176,right,R8,458,5,0,-5,5
720575940631433785,right,R8,459,5,-3,-7,4
720575940625550311,right,R8,460,-3,-20,-7,-13
720575940616429890,right,R8,461,7,-5,-10,5
720575940615916182,right,R8,462,-1,18,10,8
720575940628320017,right,R8,463,5,17,3,14
720575940630238567,right,R8,464,4,0,-4,4
720575940613574553,right,R8,465,3,0,-3,3
720575940623581917,right,R8,466,1,14,6,8
720575940609720843,right,R8,467,-2,-20,-8,-12
720575940624814519,right,R8,470,4,-9,-9,0
720575940626559120,right,R8,471,3,-26,-16,-10
720575940628478184,right,R8,472,1,25,11,14
720575940623937037,right,R8,476,-1,15,8,7
720575940626694949,right,R8,477,-3,2,4,-2
720575940613630742,right,R8,480,3,-19,-13,-6
720575940623710249,right,R8,481,4,-8,-8,0
720575940644731040,right,R8,482,1,17,7,10
720575940638069872,right,R8,483,2,-7,-6,-1
720575940633938643,right,R8,484,3,-9,-8,-1
720575940620740432,right,R8,485,-3,-3,1,-4
720575940624978357,right,R8,488,7,5,-5,10
720575940635854943,right,R8,489,-3,10,8,2
720575940624616375,right,R8,490,-5,6,8,-2
720575940628073554,right,R8,491,7,-1,-8,7
720575940613547890,right,R8,492,-7,-2,6,-8
720575940634431970,right,R8,493,-3,23,14,9
720575940617005836,right,R8,495,4,5,-2,7
720575940626995033,right,R8,496,7,8,-3,11
720575940617646453,right,R8,497,6,1,-6,7
720575940606412771,right,R8,498,6,10,-1,11
720575940648165508,right,R8,499,5,10,0,10
720575940618937684,right,R8,500,7,-8,-11,3
720575940624836937,right,R8,501,1,2,0,2
720575940625168457,right,R8,502,5,8,-1,9
720575940627286105,right,R8,503,3,17,5,12
720575940637042533,right,R8,504,-2,9,6,3
720575940612412110,right,R8,506,1,-12,-7,-5
720575940633614675,right,R8,507,-5,-12,-1,-11
720575940623633885,right,R8,508,-5,11,10,1
720575940623905672,right,R8,509,-4,10,9,1
720575940629673771,right,R8,511,5,-11,-11,0
720575940635324572,right,R8,512,6,0,-6,6
720575940628320789,right,R8,513,-4,-13,-3,-10
720575940615663522,right,R8,514,-4,-10,-1,-9
720575940609198684,right,R8,518,-4,22,15,7
720575940627945554,right,R8,519,-5,-5,2,-7
720575940623862040,right,R8,520,-2,-22,-9,-13
720575940619161669,right,R8,521,6,-9,-11,2
720575940626426701,right,R8,522,-4,0,4,-4
720575940628819196,right,R8,523,2,14,5,9
720575940618684673,right,R8,524,4,-20,-14,-6
720575940621535470,right,R8,527,-4,-8,0,-8
720575940624691125,right,R8,529,2,-2,-3,1
720575940619079709,right,R8,530,-3,-13,-4,-9
720575940648335748,right,R8,531,1,0,-1,1
720575940624286698,right,R8,532,-8,7,11,-4
720575940632539434,right,R8,533,0,-16,-8,-8
720575940635589530,right,R8,534,3,2,-2,4
720575940609497611,right,R8,536,3,4,-1,5
720575940635983002,right,R8,537,0,-23,-12,-11
720575940611416440,right,R8,538,-4,1,4,-3
720575940655910561,right,R8,539,-6,15,13,2
720575940625161545,right,R8,540,-2,-9,-3,-6
720575940636748911,right,R8,542,6,-13,-13,0
720575940614982451,right,R8,543,-1,-4,-1,-3
720575940616325343,right,R8,544,3,-13,-10,-3
720575940631205420,right,R8,545,5,11,0,11
720575940622718302,right,R8,546,3,6,0,6
720575940635605183,right,R8,547,-1,21,11,10
720575940626702480,right,R8,549,0,-9,-5,-4
720575940618254297,right,R8,551,-4,-9,-1,-8
720575940631547991,right,R8,552,4,-1,-5,4
720575940629232646,right,R8,553,-3,16,11,5
720575940612848858,right,R8,556,0,10,5,5
720575940627243962,right,R8,557,6,-10,-11,1
720575940619007489,right,R8,558,-4,-21,-7,-14
720575940619907032,right,R8,561,5,7,-2,9
720575940617053115,right,R8,562,-5,-2,4,-6
720575940617043468,right,R8,563,5,-13,-12,-1
720575940632053519,right,R8,564,3,-23,-15,-8
720575940638649822,right,R8,565,0,-26,-13,-13
720575940632541763,right,R8,566,5,-8,-9,1
720575940612886677,right,R8,567,-2,22,13,9
720575940613454962,right,R8,568,-6,-8,2,-10
720575940633367635,right,R8,570,2,25,10,15
720575940632200207,right,R8,571,0,-14,-7,-7
720575940642439899,right,R8,572,-8,3,9,-6
720575940632050986,right,R8,573,4,14,3,11
720575940637030007,right,R8,574,-6,5,8,-3
720575940614937666,right,R8,575,6,9,-2,11
720575940628028029,right,R8,576,0,28,14,14
720575940630975036,right,R8,579,-3,-10,-2,-8
720575940612447694,right,R8,580,-2,-23,-10,-13
720575940624073668,right,R8,581,3,9,1,8
720575940630742316,right,R8,583,3,-25,-16,-9
720575940628218129,right,R8,585,-1,-23,-11,-12
720575940618532865,right,R8,586,2,18,7,11
720575940623758616,right,R8,587,4,22,7,15
720575940632746296,right,R8,588,1,4,1,3
720575940629914115,right,R8,589,-1,-5,-2,-3
720575940607909554,right,R8,590,1,9,3,6
720575940630004792,right,R8,591,3,-3,-5,2
720575940628814084,right,R8,593,3,-14,-10,-4
720575940639130601,right,R8,595,7,-12,-13,1
720575940616488002,right,R8,596,-4,-16,-4,-12
720575940627469058,right,R8,597,4,1,-4,5
720575940608215426,right,R8,598,2,-18,-11,-7
720575940614838323,right,R8,600,3,-10,-8,-2
720575940632090666,right,R8,601,1,16,7,9
720575940625419272,right,R8,602,4,-2,-5,3
720575940631980303,right,R8,603,-3,-23,-9,-14
720575940623543501,right,R8,604,-6,-17,-3,-14
720575940636208888,right,R8,605,3,15,4,11
720575940625676787,right,R8,606,-1,-19,-9,-10
720575940618099385,right,R8,607,1,18,8,10
720575940616112543,right,R8,608,1,10,4,6
720575940630171959,right,R8,609,-2,0,2,-2
720575940628422421,right,R8,610,2,-23,-14,-9
720575940618209117,right,R8,611,-1,-18,-8,-10
720575940621979745,right,R8,613,-8,-4,6,-10
720575940629470763,right,R8,615,-7,-7,3,-10
720575940623148108,right,R8,616,-3,15,10,5
720575940626165837,right,R8,617,-2,-17,-7,-10
720575940622484852,right,R8,619,-4,-19,-6,-13
720575940627958936,right,R8,620,7,1,-7,8
720575940630909660,right,R8,621,1,24,11,13
720575940628119059,right,R8,622,-5,20,15,5
720575940625449971,right,R8,623,1,13,5,8
720575940613887858,right,R8,624,1,-17,-10,-7
720575940613775331,right,R8,625,-2,24,14,10
720575940624641205,right,R8,626,-5,-8,1,-9
720575940638214878,right,R8,627,0,-1,-1,0
720575940636397748,right,R8,628,0,0,0,0
720575940614925054,right,R8,629,4,24,8,16
720575940639696829,right,R8,630,4,8,0,8
720575940637618830,right,R8,631,1,26,12,14
720575940645427236,right,R8,632,3,-20,-13,-7
720575940625422520,right,R8,633,-1,-24,-11,-13
720575940627602206,right,R8,634,-3,-15,-5,-10
720575940625905383,right,R8,635,6,-6,-9,3
720575940633390500,right,R8,636,0,6,3,3
720575940616369218,right,R8,637,3,-21,-14,-7
720575940617269947,right,R8,640,-1,-16,-7,-9
720575940609520393,right,R8,642,-5,-11,-1,-10
720575940620089211,right,R8,643,6,14,1,13
720575940627946066,right,R8,647,-4,-7,0,-7
720575940618197433,right,R8,648,1,7,2,5
720575940621834662,right,R8,649,-1,5,3,2
720575940621503169,right,R8,651,-4,-5,1,-6
720575940621023573,right,R8,652,-6,-11,0,-11
720575940629947751,right,R8,653,-6,-12,0,-12
720575940630603255,right,R8,654,-3,8,7,1
720575940629213127,right,R8,655,6,-1,-7,6
720575940635295840,right,R8,656,0,-11,-6,-5
720575940627148546,right,R8,657,-2,-25,-11,-14
720575940621500326,right,R8,658,1,20,9,11
720575940608918108,right,R8,659,-4,-6,1,-7
720575940618455074,right,R8,662,2,-1,-3,2
720575940615199143,right,R8,663,0,8,4,4
720575940619072001,right,R8,664,1,-27,-15,-12
720575940637167582,right,R8,665,7,-2,-8,6
720575940621270443,right,R8,669,4,-16,-12,-4
720575940618540957,right,R8,671,-4,-23,-8,-15
720575940616137322,right,R8,672,-8,11,13,-2
720575940627180290,right,R8,673,2,5,0,5
720575940616829627,right,R8,676,-3,-21,-8,-13
720575940613431062,right,R8,677,0,11,5,6
720575940626152269,right,R8,678,3,-7,-7,0
720575940629673004,right,R8,679,4,18,5,13
720575940647522356,right,R8,681,-2,-21,-9,-12
720575940643067789,right,R8,682,6,-8,-10,2
720575940633541165,right,R8,683,2,6,1,5
720575940631524805,right,R8,685,-5,-9,0,-9
720575940613213875,right,R8,686,5,-22,-16,-6
720575940620718727,right,R8,687,-6,-3,4,-7
720575940621913264,right,R8,688,-7,10,12,-2
720575940613590642,right,R8,689,-2,18,11,7
720575940618875549,right,R8,690,-7,-3,5,-8
720575940656074145,right,R8,692,-4,24,16,8
720575940621016912,right,R8,693,-3,25,15,10
720575940661284993,right,R8,694,4,3,-3,6
720575940625492152,right,R8,695,-6,10,11,-1
720575940647654452,right,R8,697,1,-22,-12,-10
720575940616866747,right,R8,698,6,-7,-10,3
720575940613520498,right,R8,700,5,15,2,13
720575940661201025,right,R8,701,0,-4,-2,-2
720575940616141535,right,R8,702,-5,23,16,7
720575940612179042,right,R8,703,-3,1,3,-2
720575940628390404,right,R8,704,-7,8,11,-3
720575940626697264,right,R8,705,1,1,-1,2
720575940631662329,right,R8,709,-2,-24,-10,-14
720575940612964757,right,R8,710,4,-25,-17,-8
720575940635535002,right,R8,711,-1,19,10,9
720575940614156072,right,R8,714,5,12,1,11
720575940614658355,right,R8,715,4,10,1,9
720575940625448968,right,R8,716,4,-6,-7,1
720575940633830701,right,R8,717,2,-22,-13,-9
720575940635936703,right,R8,719,1,27,12,15
720575940614720040,right,R8,720,-5,21,15,6
720575940628189256,right,R8,721,5,13,1,12
720575940621433734,right,R8,722,6,-15,-14,-1
720575940618292697,right,R8,724,4,2,-3,5
720575940635567039,right,R8,725,-3,-24,-9,-15
720575940609785301,right,R8,727,7,6,-4,10
720575940628296872,right,R8,728,7,12,-1,13
720575940634319827,right,R8,730,7,0,-7,7
720575940618508006,right,R8,731,-6,9,10,-1
720575940643054733,right,R8,732,-3,6,6,0
720575940627709565,right,R8,734,2,0,-2,2
720575940619266880,right,R8,735,1,-23,-13,-10
720575940624795829,right,R8,736,-8,1,8,-7
720575940636270840,right,R8,737,0,19,9,10
720575940631220284,right,R8,738,-3,13,9,4
720575940615257490,right,R8,739,-7,2,8,-6
720575940634841369,right,R8,740,2,-8,-6,-2
720575940624117784,right,R8,741,-2,-14,-5,-9
720575940606492350,right,R8,742,-4,11,9,2
720575940625388948,right,R8,744,-4,25,16,9
720575940627945042,right,R8,745,0,13,6,7
720575940616858636,right,R8,746,-3,3,4,-1
720575940621447407,right,R8,747,0,2,1,1
720575940629974019,right,R8,748,-4,20,14,6
720575940635651263,right,R8,749,-2,1,2,-1
720575940624045411,right,R8,751,1,6,2,4
720575940620575573,right,R8,752,-2,7,5,2
720575940618669908,right,R8,753,-3,24,15,9
720575940644449480,right,R8,755,4,19,5,14
720575940609378571,right,R8,756,5,20,5,15
720575940626633104,right,R8,757,0,-6,-3,-3
720575940634232290,right,R8,758,5,-1,-6,5
720575940616689202,right,R8,760,0,17,8,9
720575940642562779,right,R8,761,-4,-18,-5,-13
720575940629315371,right,R8,762,0,14,7,7
720575940619853878,right,R8,763,-5,14,12,2
720575940624244420,right,R8,766,2,-4,-4,0
720575940632591171,right,R8,768,3,5,-1,6
720575940635717786,right,R8,770,5,4,-3,7
720575940634572384,right,R8,772,1,12,5,7
720575940623642723,right,R8,773,5,-19,-15,-4
720575940622659422,right,R8,774,-8,6,11,-5
720575940618606676,right,R8,775,5,22,6,16
720575940624495630,right,T1,1,-6,13,12,1
720575940628242170,right,T1,2,-8,2,9,-7
720575940617679163,right,T1,3,6,-12,-12,0
720575940618837844,right,T1,4,-5,-21,-6,-15
720575940628090184,right,T1,5,-1,16,9,7
720575940620064646,right,T1,6,-2,-4,0,-4
720575940615088530,right,T1,7,-6,-6,3,-9
720575940618479650,right,T1,8,-4,26,17,9
720575940617747851,right,T1,9,4,9,0,9
720575940614671853,right,T1,10,5,-15,-13,-2
720575940623905416,right,T1,11,7,-14,-14,0
720575940623908649,right,T1,12,-7,9,11,-2
720575940626662960,right,T1,13,-1,-26,-12,-14
720575940620980615,right,T1,14,0,-27,-14,-13
720575940617008070,right,T1,15,2,-3,-4,1
720575940632283467,right,T1,16,-2,-16,-6,-10
720575940635467887,right,T1,17,1,-5,-4,-1
720575940628071185,right,T1,18,5,-16,-13,-3
720575940621334804,right,T1,20,3,-11,-9,-2
720575940630774603,right,T1,21,-2,19,11,8
720575940638829646,right,T1,22,-1,3,2,1
720575940640201013,right,T1,23,-3,-16,-5,-11
720575940640029555,right,T1,24,-1,-10,-4,-6
720575940606741771,right,T1,25,-9,3,10,-7
720575940607643570,right,T1,26,1,-3,-3,0
720575940621986913,right,T1,27,0,-25,-13,-12
720575940624155853,right,T1,28,5,6,-2,8
720575940627494013,right,T1,29,-1,-3,-1,-2
720575940610201539,right,T1,30,6,16,2,14
720575940622317488,right,T1,31,0,16,8,8
720575940618700322,right,T1,33,3,18,6,12
720575940608177586,right,T1,34,6,18,3,15
720575940616861964,right,T1,35,1,-24,-13,-11
720575940628201274,right,T1,36,6,8,-2,10
720575940628568904,right,T1,37,1,5,1,4
720575940610932322,right,T1,38,0,-2,-1,-1
720575940614769361,right,T1,39,0,20,10,10
720575940629646183,right,T1,40,-2,-6,-1,-5
720575940620958228,right,T1,41,-3,28,17,11
720575940619803697,right,T1,42,-1,14,8,6
720575940639801251,right,T1,44,5,-10,-10,0
720575940640875427,right,T1,45,-5,-1,4,-5
720575940632344106,right,T1,46,-5,15,12,3
720575940624670748,right,T1,47,-9,-1,8,-9
720575940623480556,right,T1,48,-4,-22,-7,-15
720575940633001553,right,T1,49,4,-4,-6,2
720575940611453906,right,T1,50,-2,21,12,9
720575940612342746,right,T1,51,0,-19,-10,-9
720575940627787578,right,T1,52,-1,-22,-10,-12
720575940645368087,right,T1,53,5,14,2,12
720575940624271556,right,T1,55,-4,-11,-2,-9
720575940640271933,right,T1,56,1,-13,-8,-5
720575940623344483,right,T1,57,6,-11,-12,1
720575940624260393,right,T1,58,3,12,3,9
720575940640215504,right,T1,59,-2,2,3,-1
720575940631062572,right,T1,60,-8,8,12,-4
720575940620680357,right,T1,61,-4,-4,2,-6
720575940641748532,right,T1,63,4,12,2,10
720575940621183141,right,T1,64,4,-23,-16,-7
720575940620881867,right,T1,65,-1,28,15,13
720575940637739888,right,T1,66,2,15,5,10
720575940626997541,right,T1,67,-2,-13,-5,-8
720575940624684552,right,T1,68,3,16,5,11
720575940646913827,right,T1,71,-2,-3,0,-3
720575940621793263,right,T1,72,0,-28,-14,-14
720575940620179649,right,T1,73,2,2,-1,3
720575940621999871,right,T1,74,-1,-9,-4,-5
720575940621170968,right,T1,75,-6,14,13,1
720575940621017765,right,T1,76,-3,-4,1,-5
720575940628070421,right,T1,77,2,-5,-5,0
720575940626053390,right,T1,78,2,20,8,12
720575940610817582,right,T1,79,2,1,-2,3
720575940623575295,right,T1,80,4,13,2,11
720575940620793792,right,T1,81,6,-2,-7,5
720575940614347439,right,T1,82,-7,7,10,-3
720575940635797343,right,T1,83,2,-21,-13,-8
720575940645498647,right,T1,84,-2,12,8,4
720575940628693777,right,T1,85,4,-22,-15,-7
720575940606064416,right,T1,86,-5,-7,1,-8
720575940616405554,right,T1,87,1,11,4,7
720575940620863367,right,T1,89,1,-19,-11,-8
720575940623963747,right,T1,90,-4,5,6,-1
720575940644052128,right,T1,91,-1,6,4,2
720575940625488136,right,T1,93,-6,3,7,-4
720575940636870757,right,T1,94,5,18,4,14
720575940623961385,right,T1,95,4,-21,-15,-6
720575940629098758,right,T1,96,1,-10,-6,-4
720575940619654454,right,T1,97,-5,2,6,-4
720575940640668733,right,T1,98,-1,-12,-5,-7
720575940647710516,right,T1,99,4,15,3,12
720575940637308261,right,T1,100,2,-10,-7,-3
720575940611333654,right,T1,101,-7,6,10,-4
720575940626921244,right,T1,102,3,13,3,10
720575940637977828,right,T1,103,7,9,-3,12
720575940629333489,right,T1,104,-1,-27,-13,-14
720575940625031975,right,T1,105,3,22,8,14
720575940631392364,right,T1,106,-7,11,12,-1
720575940619603358,right,T1,107,8,-2,-9,7
720575940626916739,right,T1,108,-3,-12,-3,-9
720575940611450978,right,T1,109,4,-5,-7,2
720575940636321387,right,T1,110,-7,0,7,-7
720575940630919163,right,T1,111,2,-24,-14,-10
720575940633345567,right,T1,112,-6,1,6,-5
720575940624711916,right,T1,113,-2,4,4,0
720575940614604650,right,T1,114,2,-13,-9,-4
720575940633004079,right,T1,115,-4,2,5,-3
720575940622082657,right,T1,116,-1,-8,-3,-5
720575940638766426,right,T1,117,-8,-2,7,-9
720575940623871940,right,T1,118,3,1,-3,4
720575940621726191,right,T1,120,-1,-1,0,-1
720575940629012431,right,T1,121,-8,4,10,-6
720575940618819974,right,T1,122,-5,9,9,0
720575940612536785,right,T1,123,-8,10,13,-3
720575940616020886,right,T1,124,1,-7,-5,-2
720575940624859213,right,T1,125,5,9,-1,10
720575940627831122,right,T1,126,3,11,2,9
720575940631427535,right,T1,127,0,15,7,8
720575940606584241,right,T1,128,3,-22,-14,-8
720575940626985478,right,T1,129,0,-13,-7,-6
720575940629418345,right,T1,130,2,12,4,8
720575940620967700,right,T1,131,-6,20,16,4
720575940641868429,right,T1,132,2,4,0,4
720575940615419047,right,T1,133,-3,20,13,7
720575940632952204,right,T1,134,-5,-18,-4,-14
720575940624116715,right,T1,135,-3,-22,-8,-14
720575940619763847,right,T1,136,0,3,1,2
720575940627548285,right,T1,137,5,-7,-9,2
720575940632489017,right,T1,138,0,27,13,14
720575940615351914,right,T1,139,1,-14,-8,-6
720575940622753050,right,T1,140,3,8,1,7
720575940628831818,right,T1,142,-2,-18,-7,-11
720575940640512627,right,T1,144,7,-11,-13,2
720575940623073050,right,T1,146,1,-6,-4,-2
720575940615465322,right,T1,147,1,21,9,12
720575940624665834,right,T1,148,-7,-11,1,-12
720575940631283287,right,T1,149,6,-14,-13,-1
720575940612304179,right,T1,150,-8,5,10,-5
720575940640518528,right,T1,151,-3,-14,-4,-10
720575940636798831,right,T1,152,3,-15,-11,-4
720575940622873844,right,T1,153,8,0,-8,8
720575940639126249,right,T1,154,-8,0,8,-8
720575940639119824,right,T1,155,-8,13,14,-1
720575940648488580,right,T1,156,-9,1,9,-8
720575940646784035,right,T1,157,-1,-7,-3,-4
720575940626851100,right,T1,158,3,-5,-6,1
720575940623730957,right,T1,160,-2,20,12,8
720575940626854288,right,T1,161,4,-14,-11,-3
720575940610903342,right,T1,162,-4,-2,3,-5
720575940639631942,right,T1,163,-9,7,12,-5
720575940645318423,right,T1,164,-1,-2,0,-2
720575940611791878,right,T1,165,4,16,4,12
720575940635312831,right,T1,166,0,18,9,9
720575940617001915,right,T1,167,0,-17,-9,-8
720575940617208459,right,T1,168,-1,17,9,8
720575940632479815,right,T1,169,0,-18,-9,-9
720575940625371650,right,T1,170,-5,1,5,-4
720575940631947538,right,T1,171,6,-20,-16,-4
720575940623558413,right,T1,172,1,22,10,12
720575940608048770,right,T1,173,2,-25,-15,-10
720575940637490544,right,T1,174,4,-15,-12,-3
720575940630927164,right,T1,175,-6,-7,2,-9
720575940624217075,right,T1,176,-2,13,8,5
720575940629288451,right,T1,177,-2,-1,1,-2
720575940624606537,right,T1,178,2,11,3,8
720575940633928787,right,T1,179,-5,-16,-3,-13
720575940621197294,right,T1,180,2,-27,-16,-11
720575940620154021,right,T1,181,1,-4,-3,-1
720575940627687762,right,T1,182,7,-10,-12,2
720575940632794415,right,T1,183,-5,-15,-3,-12
720575940614334504,right,T1,184,-6,-5,3,-8
720575940631472146,right,T1,185,2,-11,-8,-3
720575940612940506,right,T1,186,-1,26,14,12
720575940609614601,right,T1,187,3,21,7,14
720575940629692715,right,T1,188,-5,17,13,4
720575940638833636,right,T1,189,6,13,0,13
720575940627217941,right,T1,190,-3,-5,0,-5
720575940612645618,right,T1,191,-1,-11,-5,-6
720575940628500228,right,T1,192,7,10,-2,12
720575940648519556,right,T1,193,-5,4,7,-3
720575940624155597,right,T1,194,0,-5,-3,-2
720575940621489390,right,T1,195,-3,-1,2,-3
720575940622040486,right,T1,196,-1,8,5,3
720575940632209209,right,T1,197,0,-20,-10,-10
720575940635695039,right,T1,198,6,2,-5,7
720575940631482476,right,T1,199,0,-12,-6,-6
720575940614945843,right,T1,200,-5,12,11,1
720575940617358267,right,T1,201,-8,9,12,-3
720575940630678007,right,T1,202,-1,27,14,13
720575940609509385,right,T1,203,3,-1,-4,3
720575940613381785,right,T1,204,5,-2,-6,4
720575940618047296,right,T1,205,5,-6,-8,2
720575940616753809,right,T1,206,-3,5,5,0
720575940617703563,right,T1,207,1,29,13,16
720575940637295991,right,T1,208,5,-21,-16,-5
720575940614733521,right,T1,209,-3,-8,-1,-7
720575940606279782,right,T1,210,-6,8,10,-2
720575940631410939,right,T1,211,-7,-1,6,-7
720575940623151393,right,T1,212,2,-16,-10,-6
720575940607180162,right,T1,213,3,-4,-5,1
720575940615604842,right,T1,214,-5,3,6,-3
720575940638554175,right,T1,216,2,19,7,12
720575940631527887,right,T1,217,6,15,1,14
720575940631217196,right,T1,218,2,10,3,7
720575940636785775,right,T1,219,6,-4,-8,4
720575940611302293,right,T1,220,2,-6,-5,-1
720575940629598449,right,T1,221,-7,3,8,-5
720575940625435687,right,T1,222,-3,26,16,10
720575940629653547,right,T1,223,-2,26,15,11
720575940627297155,right,T1,224,0,5,2,3
720575940623779864,right,T1,225,2,-26,-15,-11
720575940612135118,right,T1,226,5,19,4,15
720575940620039429,right,T1,227,-7,5,9,-4
720575940623347043,right,T1,228,-7,1,7,-6
720575940611847958,right,T1,229,5,2,-4,6
720575940623973133,right,T1,230,2,9,2,7
720575940628294888,right,T1,231,4,-12,-10,-2
720575940608081842,right,T1,233,4,-13,-11,-2
720575940607641801,right,T1,234,1,3,0,3
720575940640413091,right,T1,235,4,11,1,10
720575940629749607,right,T1,236,-1,4,3,1
720575940624293768,right,T1,237,-2,27,15,12
720575940632140586,right,T1,238,-8,-3,6,-9
720575940623207950,right,T1,239,-6,6,9,-3
720575940615010814,right,T1,240,-4,-3,2,-5
720575940614955451,right,T1,241,2,-17,-11,-6
720575940614246559,right,T1,242,-4,6,7,-1
720575940640382525,right,T1,243,-1,-21,-10,-11
720575940619383109,right,T1,244,-4,-12,-2,-10
720575940623642845,right,T1,245,-5,-3,3,-6
720575940625109995,right,T1,246,-4,15,11,4
720575940621760355,right,T1,247,-4,-15,-4,-11
720575940618066617,right,T1,248,-6,0,6,-6
720575940642723469,right,T1,249,2,-12,-8,-4
720575940608745923,right,T1,250,-1,1,1,0
720575940617571545,right,T1,251,-1,-14,-6,-8
720575940633100615,right,T1,252,3,23,8,15
720575940638829658,right,T1,253,5,16,3,13
720575940628791880,right,T1,254,3,-24,-15,-9
720575940633887533,right,T1,255,-6,-13,-1,-12
720575940635325792,right,T1,256,5,-20,-15,-5
720575940615721695,right,T1,257,2,21,8,13
720575940629066236,right,T1,258,-4,-17,-5,-12
720575940624909309,right,T1,259,-7,-5,4,-9
720575940613213682,right,T1,260,-3,19,12,7
720575940627626885,right,T1,261,-1,13,7,6
720575940635770975,right,T1,262,1,-11,-7,-4
720575940620926657,right,T1,263,-3,4,5,-1
720575940625011300,right,T1,264,-1,-6,-2,-4
720575940616212934,right,T1,265,-6,-1,5,-6
720575940614703597,right,T1,266,-1,-25,-12,-13
720575940634458010,right,T1,267,-6,2,7,-5
720575940618320212,right,T1,268,7,-6,-10,4
720575940632160460,right,T1,269,2,-19,-12,-7
720575940634456034,right,T1,270,1,-8,-5,-3
720575940633371417,right,T1,271,4,6,-1,7
720575940613807466,right,T1,272,3,-2,-4,2
720575940611938258,right,T1,273,-6,23,17,6
720575940619131675,right,T1,275,-8,-1,7,-8
720575940611050052,right,T1,276,2,3,-1,4
720575940607786882,right,T1,277,7,-3,-9,6
720575940614207971,right,T1,278,-5,10,10,0
720575940628007092,right,T1,279,-4,8,8,0
720575940627425052,right,T1,280,-6,-14,-1,-13
720575940624237450,right,T1,281,-9,2,10,-8
720575940635424959,right,T1,282,0,26,13,13
720575940630433730,right,T1,283,-4,4,6,-2
720575940630045306,right,T1,284,0,25,12,13
720575940627887891,right,T1,285,6,-18,-15,-3
720575940621370644,right,T1,286,0,-24,-12,-12
720575940638036046,right,T1,287,-5,13,11,2
720575940643345096,right,T1,289,-1,11,6,5
720575940616738866,right,T1,290,5,-24,-17,-7
720575940629023750,right,T1,291,7,2,-6,8
720575940608062594,right,T1,292,-4,18,13,5
720575940633537069,right,T1,293,4,-17,-13,-4
720575940632977828,right,T1,294,1,-20,-11,-9
720575940630596919,right,T1,296,1,-18,-10,-8
720575940640596595,right,T1,297,7,-9,-12,3
720575940609182556,right,T1,298,-5,5,7,-2
720575940648108164,right,T1,299,-4,12,10,2
720575940653287926,right,T1,300,4,-18,-13,-5
720575940628081683,right,T1,301,-5,16,13,3
720575940605487974,right,T1,302,2,17,6,11
720575940615724729,right,T1,303,-5,22,16,6
720575940625304764,right,T1,305,-7,4,9,-5
720575940628119313,right,T1,306,3,7,0,7
720575940618040157,right,T1,307,5,-25,-18,-7
720575940633734366,right,T1,308,-5,8,9,-1
720575940618043185,right,T1,309,-6,12,12,0
720575940615629418,right,T1,310,2,22,9,13
720575940631109371,right,T1,311,-7,15,14,1
720575940628742472,right,T1,312,4,-7,-8,1
720575940622278325,right,T1,314,-9,5,11,-6
720575940623733709,right,T1,315,-3,-6,0,-6
720575940621799407,right,T1,316,5,-4,-7,3
720575940610383684,right,T1,317,-5,-4,3,-7
720575940629547280,right,T1,318,4,-19,-14,-5
720575940635302300,right,T1,319,-2,5,4,1
720575940621073391,right,T1,320,-2,-5,-1,-4
720575940609106012,right,T1,322,2,26,11,15
720575940616132057,right,T1,323,-7,-13,0,-13
720575940632817000,right,T1,324,3,24,9,15
720575940609792451,right,T1,326,2,16,6,10
720575940628620806,right,T1,328,5,-9,-10,1
720575940648661124,right,T1,329,0,24,12,12
720575940628777288,right,T1,330,3,3,-2,5
720575940633687460,right,T1,331,1,-15,-9,-6
720575940632373290,right,T1,332,4,-26,-17,-9
720575940612597617,right,T1,333,0,-21,-11,-10
720575940620597707,right,T1,334,1,-26,-14,-12
720575940622537855,right,T1,335,2,8,2,6
720575940636655215,right,T1,336,0,23,11,12
720575940623742051,right,T1,337,-5,-6,2,-8
720575940622355592,right,T1,338,-1,0,1,-1
720575940645616420,right,T1,339,6,11,-1,12
720575940623451687,right,T1,341,6,-17,-15,-2
720575940616571846,right,T1,342,2,-15,-10,-5
720575940634446818,right,T1,344,-2,-15,-6,-9
720575940621044463,right,T1,345,3,-12,-9,-3
720575940639632181,right,T1,346,-7,-9,2,-11
720575940608835164,right,T1,347,-5,-13,-2,-11
720575940633846061,right,T1,348,3,14,4,10
720575940627089252,right,T1,349,-5,-14,-2,-12
720575940644228000,right,T1,350,1,15,6,9
720575940622605044,right,T1,351,-1,-17,-8,-9
720575940634806297,right,T1,352,-2,28,16,12
720575940635016288,right,T1,353,2,24,10,14
720575940624365508,right,T1,354,-2,-26,-11,-15
720575940625943827,right,T1,355,-7,-6,4,-10
720575940616450278,right,T1,356,0,22,11,11
720575940612987029,right,T1,357,4,17,4,13
720575940618489318,right,T1,358,-3,17,11,6
720575940621060033,right,T1,359,2,23,9,14
720575940612672986,right,T1,360,-5,19,14,5
720575940610349892,right,T1,361,0,-7,-4,-3
720575940629337418,right,T1,362,2,-20,-12,-8
720575940625094670,right,T1,363,7,-4,-9,5
720575940627537095,right,T1,364,4,4,-2,6
720575940632247823,right,T1,365,4,7,-1,8
720575940619096349,right,T1,366,-5,-20,-5,-15
720575940613185715,right,T1,367,-6,-15,-2,-13
720575940621100629,right,T1,368,-4,-20,-6,-14
720575940622583813,right,T1,369,5,-5,-8,3
720575940635582827,right,T1,370,-3,21,13,8
720575940607506050,right,T1,371,6,-5,-9,4
720575940645153047,right,T1,372,1,-2,-2,0
720575940633289517,right,T1,373,1,-21,-12,-9
720575940626920988,right,T1,374,2,13,4,9
720575940615985311,right,T1,375,-6,7,9,-2
720575940606066208,right,T1,376,-7,-10,2,-12
720575940621740653,right,T1,377,0,7,3,4
720575940608506325,right,T1,379,3,-17,-12,-5
720575940627295875,right,T1,380,-1,29,15,14
720575940632175435,right,T1,381,-8,-9,3,-12
720575940633234991,right,T1,382,3,-6,-6,0
720575940626796905,right,T1,383,-6,11,11,0
720575940629613809,right,T1,384,-6,-2,5,-7
720575940628563530,right,T1,385,-3,-18,-6,-12
720575940621098069,right,T1,386,-6,19,15,4
720575940617393781,right,T1,387,-1,-15,-7,-8
720575940647083811,right,T1,388,3,19,6,13
720575940627284410,right,T1,389,-6,-16,-2,-14
720575940628931856,right,T1,390,-6,-9,1,-10
720575940632617043,right,T1,391,4,-3,-6,3
720575940632377106,right,T1,392,-4,7,7,0
720575940631755339,right,T1,393,-1,22,12,10
720575940640056509,right,T1,394,-7,-8,3,-11
720575940624310453,right,T1,395,0,-22,-11,-11
720575940624471223,right,T1,396,-1,10,6,4
720575940623421389,right,T1,397,-3,-19,-7,-12
720575940618971163,right,T1,398,-3,22,14,8
720575940621344677,right,T1,399,-4,-24,-8,-16
720575940620619173,right,T1,401,-2,-19,-8,-11
720575940625339635,right,T1,402,3,26,10,16
720575940624336787,right,T1,403,-2,-12,-4,-8
720575940606268081,right,T1,404,-1,20,11,9
720575940629582491,right,T1,405,3,10,2,8
720575940614231336,right,T1,406,1,-25,-14,-11
720575940631629354,right,T1,407,-5,-10,0,-10
720575940623142157,right,T1,408,-6,-4,4,-8
720575940617582593,right,T1,409,0,-3,-2,-1
720575940634612576,right,T1,410,-2,-2,1,-3
720575940632344034,right,T1,411,-5,-19,-5,-14
720575940635339694,right,T1,412,-6,21,16,5
720575940630641143,right,T1,413,-2,-7,-2,-5
720575940629511785,right,T1,414,4,21,6,15
720575940619712670,right,T1,415,6,12,0,12
720575940621306816,right,T1,416,3,-8,-7,-1
720575940617380928,right,T1,417,-6,-10,1,-11
720575940621844801,right,T1,419,-3,-11,-3,-8
720575940618778960,right,T1,420,6,-3,-8,5
720575940629834395,right,T1,421,-1,12,7,5
720575940622877729,right,T1,422,-7,-4,5,-9
720575940612690394,right,T1,423,3,-18,-12,-6
720575940611076194,right,T1,424,-3,-2,2,-4
720575940611425122,right,T1,425,3,20,7,13
720575940618723653,right,T1,426,-3,0,3,-3
720575940629562609,right,T1,427,5,-18,-14,-4
720575940633880621,right,T1,428,-2,23,13,10
720575940631522811,right,T1,429,-2,14,9,5
720575940617468811,right,T1,430,-3,-7,-1,-6
720575940626732163,right,T1,431,-2,-10,-3,-7
720575940638227072,right,T1,432,-5,7,8,-1
720575940627366518,right,T1,433,0,-8,-4,-4
720575940616762054,right,T1,434,-3,7,6,1
720575940620855431,right,T1,435,5,-17,-14,-3
720575940613553891,right,T1,436,0,-15,-8,-7
720575940639054707,right,T1,437,-3,12,9,3
720575940623733272,right,T1,438,2,27,11,16
720575940628960455,right,T1,439,-3,-9,-2,-7
720575940626338608,right,T1,440,1,23,10,13
720575940616157638,right,T1,441,3,-16,-11,-5
720575940627746181,right,T1,442,-5,25,17,8
720575940645044788,right,T1,443,-6,4,8,-4
720575940614238639,right,T1,444,4,-10,-9,-1
720575940624877129,right,T1,445,-2,8,6,2
720575940616998412,right,T1,446,2,-14,-9,-5
720575940622550566,right,T1,447,-1,2,2,0
720575940628724721,right,T1,449,6,-16,-14,-2
720575940616528571,right,T1,450,2,-9,-7,-2
720575940630963800,right,T1,451,4,20,6,14
720575940621558767,right,T1,452,1,-9,-6,-3
720575940618843037,right,T1,454,5,-12,-11,-1
720575940621347243,right,T1,455,7,-7,-11,4
720575940621398255,right,T1,456,0,21,10,11
720575940630178048,right,T1,458,5,0,-5,5
720575940639070527,right,T1,459,5,-3,-7,4
720575940653199094,right,T1,460,-3,-20,-7,-13
720575940613095642,right,T1,461,7,-5,-10,5
720575940626986558,right,T1,462,-1,18,10,8
720575940612655027,right,T1,463,5,17,3,14
720575940625183502,right,T1,464,4,0,-4,4
720575940621148654,right,T1,465,3,0,-3,3
720575940632854423,right,T1,466,1,14,6,8
720575940626462339,right,T1,467,-2,-20,-8,-12
720575940633527460,right,T1,468,-3,11,8,3
720575940624936373,right,T1,469,-7,13,13,0
720575940621586523,right,T1,470,4,-9,-9,0
720575940624021759,right,T1,471,3,-26,-16,-10
720575940630793788,right,T1,472,1,25,11,14
720575940628944616,right,T1,473,-4,23,15,8
720575940614391347,right,T1,475,-4,-1,3,-4
720575940619746213,right,T1,476,-1,15,8,7
720575940618827165,right,T1,477,-3,2,4,-2
720575940616885721,right,T1,478,-7,16,15,1
720575940628142906,right,T1,480,3,-19,-13,-6
720575940627321150,right,T1,481,4,-8,-8,0
720575940635231383,right,T1,482,1,17,7,10
720575940632871225,right,T1,483,2,-7,-6,-1
720575940620492679,right,T1,484,3,-9,-8,-1
720575940638805850,right,T1,485,-3,-3,1,-4
720575940644014792,right,T1,486,0,1,0,1
720575940624842760,right,T1,487,1,-1,-2,1
720575940628504337,right,T1,489,-3,10,8,2
720575940605240544,right,T1,490,-5,6,8,-2
720575940624286404,right,T1,491,7,-1,-8,7
720575940624144784,right,T1,492,-7,-2,6,-8
720575940632355659,right,T1,493,-3,23,14,9
720575940640788131,right,T1,494,0,29,14,15
720575940631843858,right,T1,497,6,1,-6,7
720575940620016856,right,T1,498,6,10,-1,11
720575940615921474,right,T1,500,7,-8,-11,3
720575940622377142,right,T1,501,1,2,0,2
720575940617298363,right,T1,503,3,17,5,12
720575940638447838,right,T1,504,-2,9,6,3
720575940631393785,right,T1,505,6,-22,-17,-5
720575940648331140,right,T1,506,1,-12,-7,-5
720575940617858534,right,T1,507,-5,-12,-1,-11
720575940636370287,right,T1,508,-5,11,10,1
720575940622348214,right,T1,509,-4,10,9,1
720575940619753307,right,T1,510,-2,11,7,4
720575940627965982,right,T1,511,5,-11,-11,0
720575940609554699,right,T1,512,6,0,-6,6
720575940628070568,right,T1,513,-4,-13,-3,-10
720575940629438969,right,T1,515,-8,-7,4,-11
720575940628056914,right,T1,516,7,-18,-16,-2
720575940611620046,right,T1,518,-4,22,15,7
720575940644675232,right,T1,520,-2,-22,-9,-13
720575940621222337,right,T1,521,6,-9,-11,2
720575940627921937,right,T1,522,-4,0,4,-4
720575940631002071,right,T1,523,2,14,5,9
720575940625454055,right,T1,524,4,-20,-14,-6
720575940627072006,right,T1,525,-1,-20,-9,-11
720575940619821105,right,T1,526,0,-10,-5,-5
720575940638518249,right,T1,527,-4,-8,0,-8
720575940613589930,right,T1,528,2,7,1,6
720575940627511556,right,T1,529,2,-2,-3,1
720575940640434139,right,T1,530,-3,-13,-4,-9
720575940630326267,right,T1,531,1,0,-1,1
720575940632185615,right,T1,532,-8,7,11,-4
720575940632742713,right,T1,533,0,-16,-8,-8
720575940627456649,right,T1,534,3,2,-2,4
720575940621944486,right,T1,535,8,-4,-10,6
720575940614217965,right,T1,536,3,4,-1,5
720575940629905487,right,T1,537,0,-23,-12,-11
720575940610222805,right,T1,538,-4,1,4,-3
720575940631329128,right,T1,539,-6,15,13,2
720575940620076248,right,T1,540,-2,-9,-3,-6
720575940619407670,right,T1,541,-4,14,11,3
720575940612680883,right,T1,542,6,-13,-13,0
720575940629630823,right,T1,543,-1,-4,-1,-3
720575940629647207,right,T1,544,3,-13,-10,-3
720575940617918609,right,T1,545,5,11,0,11
720575940642620379,right,T1,546,3,6,0,6
720575940628424335,right,T1,547,-1,21,11,10
720575940626546750,right,T1,548,1,-16,-9,-7
720575940611771158,right,T1,549,0,-9,-5,-4
720575940619710191,right,T1,550,-2,3,3,0
720575940650193529,right,T1,551,-4,-9,-1,-8
720575940631595083,right,T1,552,4,-1,-5,4
720575940638665818,right,T1,554,-9,-3,7,-10
720575940628301384,right,T1,555,-4,9,8,1
720575940633476889,right,T1,556,0,10,5,5
720575940618535097,right,T1,557,6,-10,-11,1
720575940629863223,right,T1,558,-4,-21,-7,-14
720575940615309310,right,T1,559,-6,22,17,5
720575940638857168,right,T1,560,-7,14,14,0
720575940642381813,right,T1,561,5,7,-2,9
720575940631673931,right,T1,562,-5,-2,4,-6
720575940633104268,right,T1,563,5,-13,-12,-1
720575940628117562,right,T1,564,3,-23,-15,-8
720575940618360294,right,T1,565,0,-26,-13,-13
720575940613142642,right,T1,566,5,-8,-9,1
720575940623663880,right,T1,567,-2,22,13,9
720575940625305895,right,T1,568,-6,-8,2,-10
720575940637471662,right,T1,570,2,25,10,15
720575940608965899,right,T1,571,0,-14,-7,-7
720575940612574887,right,T1,572,-8,3,9,-6
720575940645665156,right,T1,573,4,14,3,11
720575940610867524,right,T1,574,-6,5,8,-3
720575940618946843,right,T1,575,6,9,-2,11
720575940633296465,right,T1,576,0,28,14,14
720575940635717567,right,T1,577,5,-14,-12,-2
720575940632230713,right,T1,578,4,-11,-10,-1
720575940635320986,right,T1,579,-3,-10,-2,-8
720575940606794673,right,T1,580,-2,-23,-10,-13
720575940612246882,right,T1,581,3,9,1,8
720575940611491538,right,T1,582,-1,23,12,11
720575940607870386,right,T1,583,3,-25,-16,-9
720575940629698151,right,T1,584,4,23,7,16
720575940627119178,right,T1,585,-1,-23,-11,-12
720575940638460735,right,T1,586,2,18,7,11
720575940635516590,right,T1,587,4,22,7,15
720575940610375492,right,T1,588,1,4,1,3
720575940632536228,right,T1,589,-1,-5,-2,-3
720575940631448261,right,T1,591,3,-3,-5,2
720575940630626807,right,T1,593,3,-14,-10,-4
720575940632481295,right,T1,594,7,-16,-15,-1
720575940632254738,right,T1,595,7,-12,-13,1
720575940644944072,right,T1,596,-4,-16,-4,-12
720575940650605689,right,T1,597,4,1,-4,5
720575940619397080,right,T1,598,2,-18,-11,-7
720575940660909185,right,T1,600,3,-10,-8,-2
720575940629826295,right,T1,601,1,16,7,9
720575940618145078,right,T1,602,4,-2,-5,3
720575940633806163,right,T1,604,-6,-17,-3,-14
720575940609021705,right,T1,605,3,15,4,11
720575940628350460,right,T1,606,-1,-19,-9,-10
720575940620609121,right,T1,607,1,18,8,10
720575940637408357,right,T1,608,1,10,4,6
720575940625438138,right,T1,609,-2,0,2,-2
720575940628142664,right,T1,610,2,-23,-14,-9
720575940615327082,right,T1,611,-1,-18,-8,-10
720575940623614344,right,T1,612,-3,-26,-10,-16
720575940661199745,right,T1,613,-8,-4,6,-10
720575940614834942,right,T1,614,-2,-8,-2,-6
720575940618243585,right,T1,615,-7,-7,3,-10
720575940618098617,right,T1,616,-3,15,10,5
720575940633353367,right,T1,617,-2,-17,-7,-10
720575940625545624,right,T1,618,-1,24,13,11
720575940624070680,right,T1,619,-4,-19,-6,-13
720575940625885840,right,T1,620,7,1,-7,8
720575940625535987,right,T1,621,1,24,11,13
720575940628487445,right,T1,622,-5,20,15,5
720575940626566986,right,T1,623,1,13,5,8
720575940646266478,right,T1,624,1,-17,-10,-7
720575940618974533,right,T1,625,-2,24,14,10
720575940619010112,right,T1,626,-5,-8,1,-9
720575940627523861,right,T1,627,0,-1,-1,0
720575940631530747,right,T1,628,0,0,0,0
720575940631351291,right,T1,629,4,24,8,16
720575940630030235,right,T1,630,4,8,0,8
720575940624205546,right,T1,631,1,26,12,14
720575940619525456,right,T1,632,3,-20,-13,-7
720575940628007506,right,T1,633,-1,-24,-11,-13
720575940622040673,right,T1,634,-3,-15,-5,-10
720575940605634784,right,T1,635,6,-6,-9,3
720575940626861370,right,T1,636,0,6,3,3
720575940628381829,right,T1,637,3,-21,-14,-7
720575940613201834,right,T1,638,-1,7,4,3
720575940612061337,right,T1,639,-4,19,13,6
720575940630757583,right,T1,640,-1,-16,-7,-9
720575940635303580,right,T1,641,-8,-5,5,-10
720575940628882506,right,T1,642,-5,-11,-1,-10
720575940660495233,right,T1,643,6,14,1,13
720575940622521323,right,T1,644,-6,18,15,3
720575940630780727,right,T1,645,-4,27,17,10
720575940632658463,right,T1,646,6,17,2,15
720575940623265123,right,T1,647,-4,-7,0,-7
720575940623546589,right,T1,648,1,7,2,5
720575940620092539,right,T1,650,-3,-25,-10,-15
720575940639977461,right,T1,651,-4,-5,1,-6
720575940632905263,right,T1,652,-6,-11,0,-11
720575940611568942,right,T1,653,-6,-12,0,-12
720575940655123361,right,T1,654,-3,8,7,1
720575940612854806,right,T1,655,6,-1,-7,6
720575940652858870,right,T1,656,0,-11,-6,-5
720575940621464747,right,T1,657,-2,-25,-11,-14
720575940628712903,right,T1,658,1,20,9,11
720575940619066369,right,T1,659,-4,-6,1,-7
720575940614994863,right,T1,661,-3,14,10,4
720575940611288689,right,T1,662,2,-1,-3,2
720575940623950600,right,T1,663,0,8,4,4
720575940628988668,right,T1,664,1,-27,-15,-12
720575940606421536,right,T1,665,7,-2,-8,6
720575940628135305,right,T1,667,1,-28,-15,-13
720575940641326032,right,T1,668,1,19,8,11
720575940628267786,right,T1,669,4,-16,-12,-4
720575940620140958,right,T1,671,-4,-23,-8,-15
720575940615688594,right,T1,672,-8,11,13,-2
720575940613645682,right,T1,673,2,5,0,5
720575940614144818,right,T1,674,-4,-14,-3,-11
720575940626458876,right,T1,675,-7,19,16,3
720575940645625892,right,T1,676,-3,-21,-8,-13
720575940625486996,right,T1,677,0,11,5,6
720575940624583753,right,T1,678,3,-7,-7,0
720575940612401839,right,T1,679,4,18,5,13
720575940636686191,right,T1,680,-1,25,13,12
720575940626433829,right,T1,681,-2,-21,-9,-12
720575940638200297,right,T1,682,6,-8,-10,2
720575940640144974,right,T1,683,2,6,1,5
720575940630609196,right,T1,685,-5,-9,0,-9
720575940620866763,right,T1,686,5,-22,-16,-6
720575940626431690,right,T1,687,-6,-3,4,-7
720575940618053067,right,T1,688,-7,10,12,-2
720575940614625320,right,T1,690,-7,-3,5,-8
720575940634935470,right,T1,691,-9,4,11,-7
720575940631632715,right,T1,692,-4,24,16,8
720575940629464875,right,T1,693,-3,25,15,10
720575940634586338,right,T1,694,4,3,-3,6
720575940625186312,right,T1,695,-6,10,11,-1
720575940627185508,right,T1,696,-2,16,10,6
720575940618701339,right,T1,697,1,-22,-12,-10
720575940631250492,right,T1,698,6,-7,-10,3
720575940611421702,right,T1,700,5,15,2,13
720575940638999997,right,T1,701,0,-4,-2,-2
720575940627301988,right,T1,702,-5,23,16,7
720575940617954049,right,T1,703,-3,1,3,-2
720575940623970147,right,T1,704,-7,8,11,-3
720575940627297608,right,T1,705,1,1,-1,2
720575940630651300,right,T1,706,-7,-12,1,-13
720575940617999419,right,T1,707,-2,25,14,11
720575940634537441,right,T1,708,-4,-25,-9,-16
720575940616298562,right,T1,709,-2,-24,-10,-14
720575940613121689,right,T1,710,4,-25,-17,-8
720575940644654280,right,T1,711,-1,19,10,9
720575940621320803,right,T1,712,-7,12,13,-1
720575940622318000,right,T1,713,-6,16,14,2
720575940616278338,right,T1,714,5,12,1,11
720575940622484212,right,T1,715,4,10,1,9
720575940615629986,right,T1,716,4,-6,-7,1
720575940631641851,right,T1,717,2,-22,-13,-9
720575940613391474,right,T1,718,-5,24,17,7
720575940623092182,right,T1,719,1,27,12,15
720575940655714721,right,T1,720,-5,21,15,6
720575940618485787,right,T1,721,5,13,1,12
720575940630736121,right,T1,722,6,-15,-14,-1
720575940620920710,right,T1,723,-2,-11,-4,-7
720575940618766875,right,T1,724,4,2,-3,5
720575940637871278,right,T1,725,-3,-24,-9,-15
720575940631315500,right,T1,726,2,-28,-16,-12
720575940623115222,right,T1,728,7,12,-1,13
720575940627987077,right,T1,729,-3,29,17,12
720575940644751048,right,T1,730,7,0,-7,7
720575940615524235,right,T1,731,-6,9,10,-1
720575940608001219,right,T1,732,-3,6,6,0
720575940615331490,right,T1,733,-5,-17,-4,-13
720575940625064445,right,T1,734,2,0,-2,2
720575940635699807,right,T1,735,1,-23,-13,-10
720575940624886556,right,T1,736,-8,1,8,-7
720575940639267893,right,T1,737,0,19,9,10
720575940619838843,right,T1,738,-3,13,9,4
720575940620248097,right,T1,739,-7,2,8,-6
720575940627675474,right,T1,740,2,-8,-6,-2
720575940626761008,right,T1,741,-2,-14,-5,-9
720575940613448874,right,T1,742,-4,11,9,2
720575940641020288,right,T1,743,6,-19,-16,-3
720575940646479982,right,T1,744,-4,25,16,9
720575940633935661,right,T1,745,0,13,6,7
720575940627877150,right,T1,746,-3,3,4,-1
720575940640262608,right,T1,747,0,2,1,1
720575940632058451,right,T1,749,-2,1,2,-1
720575940611395960,right,T1,750,4,-24,-16,-8
720575940608158082,right,T1,751,1,6,2,4
720575940624728503,right,T1,752,-2,7,5,2
720575940629614833,right,T1,753,-3,24,15,9
720575940652841462,right,T1,754,-1,-13,-6,-7
720575940640708211,right,T1,755,4,19,5,14
720575940620785261,right,T1,756,5,20,5,15
720575940611705810,right,T1,757,0,-6,-3,-3
720575940641872859,right,T1,758,5,-1,-6,5
720575940620256903,right,T1,759,7,14,0,14
720575940621395622,right,T1,761,-4,-18,-5,-13
720575940627219300,right,T1,762,0,14,7,7
720575940618399417,right,T1,763,-5,14,12,2
720575940616128413,right,T1,764,-8,-6,5,-11
720575940625797863,right,T1,765,-3,9,7,2
720575940627722841,right,T1,766,2,-4,-4,0
720575940614607085,right,T1,767,1,28,13,15
720575940612849045,right,T1,768,3,5,-1,6
720575940641599952,right,T1,769,4,-27,-18,-9
720575940615890026,right,T1,770,5,4,-3,7
720575940629409359,right,T1,772,1,12,5,7
720575940606775241,right,T1,773,5,-19,-15,-4
720575940605676972,right,T1,774,-8,6,11,-5
720575940622801996,right,T1,775,5,22,6,16
720575940613934962,right,T1,776,5,21,5,16
720575940621280594,right,T1,777,6,20,4,16
720575940616853260,right,T1,778,4,25,8,17
720575940635531671,right,T1,779,5,24,7,17
720575940645963543,right,T1,780,-6,25,18,7
720575940630556663,right,T1,781,-5,26,18,8
720575940626772272,right,T1,782,-5,27,18,9
720575940616704050,right,T1,783,-4,28,18,10
720575940623726104,right,T1,784,-4,29,18,11
720575940632789305,right,T1,785,-3,30,18,12
720575940613434597,right,T1,787,3,28,11,17
720575940627330562,right,T1,788,3,27,10,17
720575940615837846,right,T1,789,-3,-27,-11,-16
720575940611930466,right,T1,790,-2,-27,-12,-15
720575940642607579,right,T1,791,-1,-28,-13,-15
720575940622003638,right,T1,792,8,2,-7,9
720575940624362120,right,T1,794,5,-26,-18,-8
720575940618347494,right,T1,795,6,-21,-17,-4
720575940632427091,right,T2,1,-6,13,12,1
720575940603707657,right,T2,2,-8,2,9,-7
720575940627203087,right,T2,3,6,-12,-12,0
720575940633664025,right,T2,5,-1,16,9,7
720575940631673996,right,T2,6,-2,-4,0,-4
720575940605776416,right,T2,7,-6,-6,3,-9
720575940631047249,right,T2,8,-4,26,17,9
720575940634576480,right,T2,9,4,9,0,9
720575940637590750,right,T2,10,5,-15,-13,-2
720575940627062543,right,T2,11,7,-14,-14,0
720575940634472670,right,T2,12,-7,9,11,-2
720575940608368306,right,T2,13,-1,-26,-12,-14
720575940628093768,right,T2,14,0,-27,-14,-13
720575940622129780,right,T2,15,2,-3,-4,1
720575940630039567,right,T2,16,-2,-16,-6,-10
720575940632139949,right,T2,17,1,-5,-4,-1
720575940617557478,right,T2,18,5,-16,-13,-3
720575940618996894,right,T2,19,-7,17,15,2
720575940636604302,right,T2,20,3,-11,-9,-2
720575940625821733,right,T2,21,-2,19,11,8
720575940643221192,right,T2,22,-1,3,2,1
720575940618728021,right,T2,23,-3,-16,-5,-11
720575940627837205,right,T2,24,-1,-10,-4,-6
720575940624782654,right,T2,25,-9,3,10,-7
720575940629301239,right,T2,26,1,-3,-3,0
720575940620425643,right,T2,28,5,6,-2,8
720575940626316681,right,T2,29,-1,-3,-1,-2
720575940619425158,right,T2,30,6,16,2,14
720575940621540518,right,T2,31,0,16,8,8
720575940627166212,right,T2,32,0,12,6,6
720575940654976673,right,T2,35,1,-24,-13,-11
720575940626762814,right,T2,36,6,8,-2,10
720575940619722689,right,T2,37,1,5,1,4
720575940613285034,right,T2,38,0,-2,-1,-1
720575940614927155,right,T2,39,0,20,10,10
720575940632225235,right,T2,40,-2,-6,-1,-5
720575940631410730,right,T2,41,-3,28,17,11
720575940627186988,right,T2,42,-1,14,8,6
720575940626467417,right,T2,43,-5,18,14,4
720575940611206242,right,T2,44,5,-10,-10,0
720575940619470445,right,T2,45,-5,-1,4,-5
720575940626202212,right,T2,46,-5,15,12,3
720575940631871519,right,T2,47,-9,-1,8,-9
720575940628906599,right,T2,49,4,-4,-6,2
720575940660040833,right,T2,50,-2,21,12,9
720575940633775842,right,T2,51,0,-19,-10,-9
720575940631407308,right,T2,52,-1,-22,-10,-12
720575940633326244,right,T2,53,5,14,2,12
720575940623951240,right,T2,54,-4,3,5,-2
720575940641495771,right,T2,55,-4,-11,-2,-9
720575940632714835,right,T2,56,1,-13,-8,-5
720575940615146919,right,T2,57,6,-11,-12,1
720575940620217280,right,T2,58,3,12,3,9
720575940635967374,right,T2,60,-8,8,12,-4
720575940644402724,right,T2,61,-4,-4,2,-6
720575940624773524,right,T2,63,4,12,2,10
720575940625942576,right,T2,64,4,-23,-16,-7
720575940615129762,right,T2,65,-1,28,15,13
720575940618217805,right,T2,66,2,15,5,10
720575940622674141,right,T2,67,-2,-13,-5,-8
720575940622982057,right,T2,68,3,16,5,11
720575940614025135,right,T2,69,1,8,3,5
720575940617736571,right,T2,70,-4,21,14,7
720575940620036461,right,T2,71,-2,-3,0,-3
720575940612510634,right,T2,72,0,-28,-14,-14
720575940623499337,right,T2,73,2,2,-1,3
720575940633378252,right,T2,74,-1,-9,-4,-5
720575940619724109,right,T2,75,-6,14,13,1
720575940629966135,right,T2,76,-3,-4,1,-5
720575940643738784,right,T2,77,2,-5,-5,0
720575940615956934,right,T2,78,2,20,8,12
720575940615237062,right,T2,79,2,1,-2,3
720575940612274162,right,T2,80,4,13,2,11
720575940626760372,right,T2,81,6,-2,-7,5
720575940626270339,right,T2,82,-7,7,10,-3
720575940619381627,right,T2,83,2,-21,-13,-8
720575940633258722,right,T2,84,-2,12,8,4
720575940616048690,right,T2,85,4,-22,-15,-7
720575940614061539,right,T2,86,-5,-7,1,-8
720575940621292224,right,T2,87,1,11,4,7
720575940619764918,right,T2,88,7,4,-5,9
720575940622651862,right,T2,89,1,-19,-11,-8
720575940633060269,right,T2,90,-4,5,6,-1
720575940625707522,right,T2,91,-1,6,4,2
720575940624324425,right,T2,92,0,9,4,5
720575940627154106,right,T2,95,4,-21,-15,-6
720575940652427766,right,T2,96,1,-10,-6,-4
720575940629602364,right,T2,97,-5,2,6,-4
720575940612380645,right,T2,98,-1,-12,-5,-7
720575940609557771,right,T2,100,2,-10,-7,-3
720575940628413712,right,T2,101,-7,6,10,-4
720575940618891521,right,T2,102,3,13,3,10
720575940616130271,right,T2,104,-1,-27,-13,-14
720575940625539051,right,T2,105,3,22,8,14
720575940630238689,right,T2,106,-7,11,12,-1
720575940616405727,right,T2,107,8,-2,-9,7
720575940631792524,right,T2,108,-3,-12,-3,-9
720575940620608586,right,T2,109,4,-5,-7,2
720575940635030426,right,T2,110,-7,0,7,-7
720575940620863215,right,T2,111,2,-24,-14,-10
720575940624994830,right,T2,112,-6,1,6,-5
720575940644509038,right,T2,113,-2,4,4,0
720575940628182016,right,T2,114,2,-13,-9,-4
720575940633982862,right,T2,115,-4,2,5,-3
720575940615518018,right,T2,116,-1,-8,-3,-5
720575940627526652,right,T2,117,-8,-2,7,-9
720575940626128536,right,T2,118,3,1,-3,4
720575940617304916,right,T2,119,-2,6,5,1
720575940612168470,right,T2,120,-1,-1,0,-1
720575940620107034,right,T2,121,-8,4,10,-6
720575940626098178,right,T2,122,-5,9,9,0
720575940616722393,right,T2,124,1,-7,-5,-2
720575940623600639,right,T2,126,3,11,2,9
720575940635308280,right,T2,127,0,15,7,8
720575940644764196,right,T2,128,3,-22,-14,-8
720575940624730099,right,T2,129,0,-13,-7,-6
720575940618146462,right,T2,130,2,12,4,8
720575940634782174,right,T2,131,-6,20,16,4
720575940636711566,right,T2,132,2,4,0,4
720575940613569005,right,T2,133,-3,20,13,7
720575940616747869,right,T2,136,0,3,1,2
720575940633421523,right,T2,138,0,27,13,14
720575940635194464,right,T2,139,1,-14,-8,-6
720575940618202395,right,T2,140,3,8,1,7
720575940627514962,right,T2,141,5,-23,-17,-6
720575940620000891,right,T2,142,-2,-18,-7,-11
720575940623178986,right,T2,143,-4,16,12,4
720575940635278431,right,T2,144,7,-11,-13,2
720575940638574525,right,T2,145,0,4,2,2
720575940619660052,right,T2,146,1,-6,-4,-2
720575940632893011,right,T2,147,1,21,9,12
720575940604867500,right,T2,148,-7,-11,1,-12
720575940638798464,right,T2,149,6,-14,-13,-1
720575940637761252,right,T2,150,-8,5,10,-5
720575940614959254,right,T2,152,3,-15,-11,-4
720575940646461219,right,T2,153,8,0,-8,8
720575940611617429,right,T2,154,-8,0,8,-8
720575940628137922,right,T2,155,-8,13,14,-1
720575940620894273,right,T2,156,-9,1,9,-8
720575940626070291,right,T2,157,-1,-7,-3,-4
720575940622698879,right,T2,158,3,-5,-6,1
720575940628593563,right,T2,159,7,7,-4,11
720575940624315721,right,T2,161,4,-14,-11,-3
720575940631721559,right,T2,162,-4,-2,3,-5
720575940624067592,right,T2,163,-9,7,12,-5
720575940625037104,right,T2,164,-1,-2,0,-2
720575940628365574,right,T2,165,4,16,4,12
720575940629742786,right,T2,166,0,18,9,9
720575940631888963,right,T2,167,0,-17,-9,-8
720575940621020325,right,T2,168,-1,17,9,8
720575940624772588,right,T2,169,0,-18,-9,-9
720575940618204229,right,T2,170,-5,1,5,-4
720575940626384386,right,T2,172,1,22,10,12
720575940647460643,right,T2,173,2,-25,-15,-10
720575940610709038,right,T2,174,4,-15,-12,-3
720575940633059757,right,T2,175,-6,-7,2,-9
720575940630839767,right,T2,176,-2,13,8,5
720575940629501545,right,T2,177,-2,-1,1,-2
720575940634681242,right,T2,178,2,11,3,8
720575940628837114,right,T2,181,1,-4,-3,-1
720575940609438165,right,T2,182,7,-10,-12,2
720575940620889582,right,T2,183,-5,-15,-3,-12
720575940612472231,right,T2,184,-6,-5,3,-8
720575940633895137,right,T2,185,2,-11,-8,-3
720575940635403662,right,T2,186,-1,26,14,12
720575940612215449,right,T2,187,3,21,7,14
720575940604908716,right,T2,188,-5,17,13,4
720575940628276162,right,T2,189,6,13,0,13
720575940617670401,right,T2,190,-3,-5,0,-5
720575940624456848,right,T2,191,-1,-11,-5,-6
720575940626806397,right,T2,193,-5,4,7,-3
720575940620883137,right,T2,194,0,-5,-3,-2
720575940649026169,right,T2,195,-3,-1,2,-3
720575940626388738,right,T2,196,-1,8,5,3
720575940632010538,right,T2,197,0,-20,-10,-10
720575940628517192,right,T2,198,6,2,-5,7
720575940623866090,right,T2,199,0,-12,-6,-6
720575940633907854,right,T2,200,-5,12,11,1
720575940633147614,right,T2,201,-8,9,12,-3
720575940637994724,right,T2,202,-1,27,14,13
720575940617669588,right,T2,203,3,-1,-4,3
720575940634879130,right,T2,206,-3,5,5,0
720575940632075368,right,T2,207,1,29,13,16
720575940622017633,right,T2,209,-3,-8,-1,-7
720575940622819464,right,T2,210,-6,8,10,-2
720575940618758558,right,T2,211,-7,-1,6,-7
720575940635143007,right,T2,212,2,-16,-10,-6
720575940623638506,right,T2,213,3,-4,-5,1
720575940648438660,right,T2,214,-5,3,6,-3
720575940628594948,right,T2,215,6,7,-3,10
720575940620132401,right,T2,216,2,19,7,12
720575940623851411,right,T2,219,6,-4,-8,4
720575940638966947,right,T2,220,2,-6,-5,-1
720575940612248469,right,T2,221,-7,3,8,-5
720575940630824570,right,T2,222,-3,26,16,10
720575940618504093,right,T2,223,-2,26,15,11
720575940635831664,right,T2,224,0,5,2,3
720575940619711537,right,T2,225,2,-26,-15,-11
720575940622754473,right,T2,226,5,19,4,15
720575940621353716,right,T2,227,-7,5,9,-4
720575940614847903,right,T2,228,-7,1,7,-6
720575940629846775,right,T2,230,2,9,2,7
720575940609873016,right,T2,231,4,-12,-10,-2
720575940636269925,right,T2,232,-4,13,10,3
720575940618512805,right,T2,233,4,-13,-11,-2
720575940611223665,right,T2,234,1,3,0,3
720575940627282557,right,T2,235,4,11,1,10
720575940629713963,right,T2,236,-1,4,3,1
720575940637682142,right,T2,237,-2,27,15,12
720575940621868058,right,T2,238,-8,-3,6,-9
720575940646059908,right,T2,239,-6,6,9,-3
720575940645760547,right,T2,240,-4,-3,2,-5
720575940626883599,right,T2,241,2,-17,-11,-6
720575940643683232,right,T2,242,-4,6,7,-1
720575940611392462,right,T2,243,-1,-21,-10,-11
720575940626119964,right,T2,244,-4,-12,-2,-10
720575940628865335,right,T2,245,-5,-3,3,-6
720575940631109451,right,T2,246,-4,15,11,4
720575940633262818,right,T2,247,-4,-15,-4,-11
720575940619932608,right,T2,248,-6,0,6,-6
720575940615612091,right,T2,249,2,-12,-8,-4
720575940624024103,right,T2,250,-1,1,1,0
720575940614417314,right,T2,251,-1,-14,-6,-8
720575940641665933,right,T2,252,3,23,8,15
720575940625438188,right,T2,253,5,16,3,13
720575940639010394,right,T2,254,3,-24,-15,-9
720575940623089446,right,T2,255,-6,-13,-1,-12
720575940643900064,right,T2,256,5,-20,-15,-5
720575940632517162,right,T2,257,2,21,8,13
720575940612876566,right,T2,258,-4,-17,-5,-12
720575940617970260,right,T2,259,-7,-5,4,-9
720575940632371598,right,T2,260,-3,19,12,7
720575940619557712,right,T2,261,-1,13,7,6
720575940612860694,right,T2,262,1,-11,-7,-4
720575940628639079,right,T2,263,-3,4,5,-1
720575940616895517,right,T2,264,-1,-6,-2,-4
720575940622561485,right,T2,265,-6,-1,5,-6
720575940634678635,right,T2,266,-1,-25,-12,-13
720575940618237750,right,T2,267,-6,2,7,-5
720575940644075424,right,T2,268,7,-6,-10,4
720575940626940809,right,T2,269,2,-19,-12,-7
720575940636978910,right,T2,270,1,-8,-5,-3
720575940621025396,right,T2,272,3,-2,-4,2
720575940618759757,right,T2,273,-6,23,17,6
720575940637726810,right,T2,275,-8,-1,7,-8
720575940612560611,right,T2,276,2,3,-1,4
720575940620916673,right,T2,277,7,-3,-9,6
720575940617111769,right,T2,278,-5,10,10,0
720575940605395232,right,T2,279,-4,8,8,0
720575940611232206,right,T2,280,-6,-14,-1,-13
720575940623928071,right,T2,281,-9,2,10,-8
720575940623520231,right,T2,282,0,26,13,13
720575940632332842,right,T2,283,-4,4,6,-2
720575940611646670,right,T2,284,0,25,12,13
720575940618414612,right,T2,285,6,-18,-15,-3
720575940629539088,right,T2,286,0,-24,-12,-12
720575940620327606,right,T2,287,-5,13,11,2
720575940629048838,right,T2,288,-1,30,16,14
720575940605429950,right,T2,289,-1,11,6,5
720575940611501666,right,T2,290,5,-24,-17,-7
720575940631339223,right,T2,291,7,2,-6,8
720575940623390868,right,T2,292,-4,18,13,5
720575940626983439,right,T2,293,4,-17,-13,-4
720575940634899356,right,T2,294,1,-20,-11,-9
720575940631222287,right,T2,295,-2,29,16,13
720575940640625883,right,T2,296,1,-18,-10,-8
720575940634700439,right,T2,297,7,-9,-12,3
720575940611322318,right,T2,298,-5,5,7,-2
720575940632630319,right,T2,299,-4,12,10,2
720575940646626339,right,T2,300,4,-18,-13,-5
720575940618081093,right,T2,301,-5,16,13,3
720575940618814749,right,T2,302,2,17,6,11
720575940633563278,right,T2,303,-5,22,16,6
720575940626704698,right,T2,305,-7,4,9,-5
720575940621615198,right,T2,306,3,7,0,7
720575940620936619,right,T2,307,5,-25,-18,-7
720575940617737245,right,T2,308,-5,8,9,-1
720575940611462037,right,T2,309,-6,12,12,0
720575940611845618,right,T2,311,-7,15,14,1
720575940645698926,right,T2,312,4,-7,-8,1
720575940622498124,right,T2,313,7,3,-6,9
720575940625083628,right,T2,314,-9,5,11,-6
720575940630466412,right,T2,315,-3,-6,0,-6
720575940625167118,right,T2,316,5,-4,-7,3
720575940610494254,right,T2,317,-5,-4,3,-7
720575940638659416,right,T2,318,4,-19,-14,-5
720575940612941999,right,T2,319,-2,5,4,1
720575940620970662,right,T2,320,-2,-5,-1,-4
720575940618291525,right,T2,321,8,4,-6,10
720575940630099355,right,T2,322,2,26,11,15
720575940624075701,right,T2,323,-7,-13,0,-13
720575940628714492,right,T2,325,5,1,-5,6
720575940620546497,right,T2,326,2,16,6,10
720575940605758822,right,T2,327,5,3,-4,7
720575940624752108,right,T2,328,5,-9,-10,1
720575940630358327,right,T2,330,3,3,-2,5
720575940628580849,right,T2,331,1,-15,-9,-6
720575940637770559,right,T2,332,4,-26,-17,-9
720575940622651606,right,T2,333,0,-21,-11,-10
720575940633711073,right,T2,334,1,-26,-14,-12
720575940626949894,right,T2,335,2,8,2,6
720575940618053377,right,T2,336,0,23,11,12
720575940615620241,right,T2,337,-5,-6,2,-8
720575940611116334,right,T2,338,-1,0,1,-1
720575940628481899,right,T2,339,6,11,-1,12
720575940633391246,right,T2,340,-4,17,12,5
720575940608909358,right,T2,342,2,-15,-10,-5
720575940625495885,right,T2,343,-3,27,16,11
720575940633661153,right,T2,344,-2,-15,-6,-9
720575940626884879,right,T2,345,3,-12,-9,-3
720575940627343237,right,T2,346,-7,-9,2,-11
720575940626608911,right,T2,347,-5,-13,-2,-11
720575940624185085,right,T2,348,3,14,4,10
720575940609363209,right,T2,349,-5,-14,-2,-12
720575940629180154,right,T2,350,1,15,6,9
720575940630761467,right,T2,351,-1,-17,-8,-9
720575940629344335,right,T2,352,-2,28,16,12
720575940622604876,right,T2,353,2,24,10,14
720575940618568166,right,T2,354,-2,-26,-11,-15
720575940631933771,right,T2,355,-7,-6,4,-10
720575940633364269,right,T2,356,0,22,11,11
720575940617333734,right,T2,357,4,17,4,13
720575940625393639,right,T2,358,-3,17,11,6
720575940622594124,right,T2,359,2,23,9,14
720575940606118322,right,T2,360,-5,19,14,5
720575940620801776,right,T2,361,0,-7,-4,-3
720575940614148527,right,T2,362,2,-20,-12,-8
720575940627385091,right,T2,363,7,-4,-9,5
720575940618970113,right,T2,364,4,4,-2,6
720575940624795628,right,T2,365,4,7,-1,8
720575940630221434,right,T2,366,-5,-20,-5,-15
720575940626121018,right,T2,367,-6,-15,-2,-13
720575940621447706,right,T2,368,-4,-20,-6,-14
720575940631479096,right,T2,369,5,-5,-8,3
720575940634118300,right,T2,370,-3,21,13,8
720575940629015414,right,T2,371,6,-5,-9,4
720575940629236486,right,T2,372,1,-2,-2,0
720575940636509559,right,T2,373,1,-21,-12,-9
720575940645010798,right,T2,375,-6,7,9,-2
720575940643958472,right,T2,376,-7,-10,2,-12
720575940642181851,right,T2,377,0,7,3,4
720575940630239102,right,T2,378,-3,18,12,6
720575940614682110,right,T2,379,3,-17,-12,-5
720575940632061255,right,T2,380,-1,29,15,14
720575940627184765,right,T2,381,-8,-9,3,-12
720575940616797301,right,T2,382,3,-6,-6,0
720575940623522708,right,T2,383,-6,11,11,0
720575940623330963,right,T2,384,-6,-2,5,-7
720575940646574883,right,T2,385,-3,-18,-6,-12
720575940622145574,right,T2,386,-6,19,15,4
720575940612382437,right,T2,387,-1,-15,-7,-8
720575940633192365,right,T2,388,3,19,6,13
720575940613298915,right,T2,389,-6,-16,-2,-14
720575940632891449,right,T2,390,-6,-9,1,-10
720575940622611848,right,T2,391,4,-3,-6,3
720575940628276329,right,T2,392,-4,7,7,0
720575940623316173,right,T2,393,-1,22,12,10
720575940635155391,right,T2,394,-7,-8,3,-11
720575940623244824,right,T2,395,0,-22,-11,-11
720575940628214149,right,T2,396,-1,10,6,4
720575940630808284,right,T2,397,-3,-19,-7,-12
720575940636513655,right,T2,398,-3,22,14,8
720575940620531648,right,T2,399,-4,-24,-8,-16
720575940626327177,right,T2,400,1,-29,-16,-13
720575940626686851,right,T2,401,-2,-19,-8,-11
720575940625974832,right,T2,402,3,26,10,16
720575940613615638,right,T2,403,-2,-12,-4,-8
720575940631895247,right,T2,404,-1,20,11,9
720575940608327435,right,T2,405,3,10,2,8
720575940620777552,right,T2,406,1,-25,-14,-11
720575940612217002,right,T2,408,-6,-4,4,-8
720575940631169700,right,T2,409,0,-3,-2,-1
720575940637638889,right,T2,410,-2,-2,1,-3
720575940614461351,right,T2,411,-5,-19,-5,-14
720575940629539710,right,T2,412,-6,21,16,5
720575940628940367,right,T2,413,-2,-7,-2,-5
720575940629451515,right,T2,414,4,21,6,15
720575940627784945,right,T2,415,6,12,0,12
720575940607381257,right,T2,416,3,-8,-7,-1
720575940626091778,right,T2,417,-6,-10,1,-11
720575940627320378,right,T2,418,-2,15,9,6
720575940631794755,right,T2,419,-3,-11,-3,-8
720575940627189523,right,T2,421,-1,12,7,5
720575940626264348,right,T2,422,-7,-4,5,-9
720575940621296816,right,T2,423,3,-18,-12,-6
720575940619525592,right,T2,424,-3,-2,2,-4
720575940623935743,right,T2,426,-3,0,3,-3
720575940612547481,right,T2,427,5,-18,-14,-4
720575940609347140,right,T2,428,-2,23,13,10
720575940621286593,right,T2,429,-2,14,9,5
720575940612385765,right,T2,430,-3,-7,-1,-6
720575940632582760,right,T2,431,-2,-10,-3,-7
720575940639426648,right,T2,432,-5,7,8,-1
720575940612484778,right,T2,433,0,-8,-4,-4
720575940617524125,right,T2,434,-3,7,6,1
720575940625288265,right,T2,435,5,-17,-14,-3
720575940621793797,right,T2,436,0,-15,-8,-7
720575940622628632,right,T2,437,-3,12,9,3
720575940637473358,right,T2,438,2,27,11,16
720575940604646368,right,T2,439,-3,-9,-2,-7
720575940628230652,right,T2,440,1,23,10,13
720575940612218163,right,T2,441,3,-16,-11,-5
720575940619137812,right,T2,442,-5,25,17,8
720575940618348155,right,T2,443,-6,4,8,-4
720575940625900080,right,T2,444,4,-10,-9,-1
720575940614864095,right,T2,445,-2,8,6,2
720575940626900239,right,T2,446,2,-14,-9,-5
720575940611297266,right,T2,447,-1,2,2,0
720575940630010494,right,T2,448,0,30,15,15
720575940624285111,right,T2,449,6,-16,-14,-2
720575940638049855,right,T2,450,2,-9,-7,-2
720575940632038095,right,T2,451,4,20,6,14
720575940630079744,right,T2,452,1,-9,-6,-3
720575940622033791,right,T2,453,3,25,9,16
720575940627080975,right,T2,454,5,-12,-11,-1
720575940624713708,right,T2,456,0,21,10,11
720575940626370622,right,T2,457,-2,17,10,7
720575940613006358,right,T2,458,5,0,-5,5
720575940616030694,right,T2,459,5,-3,-7,4
720575940617915170,right,T2,460,-3,-20,-7,-13
720575940628910159,right,T2,461,7,-5,-10,5
720575940605545504,right,T2,462,-1,18,10,8
720575940621690239,right,T2,463,5,17,3,14
720575940627859855,right,T2,464,4,0,-4,4
720575940628325319,right,T2,465,3,0,-3,3
720575940627016762,right,T2,466,1,14,6,8
720575940660264833,right,T2,467,-2,-20,-8,-12
720575940632578861,right,T2,468,-3,11,8,3
720575940608252427,right,T2,469,-7,13,13,0
720575940622494028,right,T2,470,4,-9,-9,0
720575940639519677,right,T2,471,3,-26,-16,-10
720575940625271629,right,T2,472,1,25,11,14
720575940611502968,right,T2,473,-4,23,15,8
720575940621245616,right,T2,475,-4,-1,3,-4
720575940621769293,right,T2,476,-1,15,8,7
720575940623493559,right,T2,477,-3,2,4,-2
720575940632557281,right,T2,478,-7,16,15,1
720575940628099197,right,T2,479,-2,10,7,3
720575940605823264,right,T2,480,3,-19,-13,-6
720575940612297690,right,T2,481,4,-8,-8,0
720575940627576904,right,T2,482,1,17,7,10
720575940620558154,right,T2,483,2,-7,-6,-1
720575940632006284,right,T2,484,3,-9,-8,-1
720575940620437638,right,T2,485,-3,-3,1,-4
720575940636762766,right,T2,486,0,1,0,1
720575940624996425,right,T2,487,1,-1,-2,1
720575940605721446,right,T2,488,7,5,-5,10
720575940645009518,right,T2,490,-5,6,8,-2
720575940613054322,right,T2,491,7,-1,-8,7
720575940625632656,right,T2,492,-7,-2,6,-8
720575940628204550,right,T2,493,-3,23,14,9
720575940624688688,right,T2,494,0,29,14,15
720575940624102399,right,T2,495,4,5,-2,7
720575940635851828,right,T2,497,6,1,-6,7
720575940612496242,right,T2,498,6,10,-1,11
720575940638220378,right,T2,500,7,-8,-11,3
720575940620407572,right,T2,501,1,2,0,2
720575940619603928,right,T2,502,5,8,-1,9
720575940622148393,right,T2,504,-2,9,6,3
720575940640467163,right,T2,507,-5,-12,-1,-11
720575940632595342,right,T2,508,-5,11,10,1
720575940622670263,right,T2,509,-4,10,9,1
720575940640446939,right,T2,510,-2,11,7,4
720575940624315465,right,T2,511,5,-11,-11,0
720575940622092020,right,T2,512,6,0,-6,6
720575940609518859,right,T2,514,-4,-10,-1,-9
720575940626550927,right,T2,515,-8,-7,4,-11
720575940622002526,right,T2,516,7,-18,-16,-2
720575940623915527,right,T2,518,-4,22,15,7
720575940612549349,right,T2,520,-2,-22,-9,-13
720575940632950445,right,T2,521,6,-9,-11,2
720575940628994127,right,T2,522,-4,0,4,-4
720575940639683456,right,T2,523,2,14,5,9
720575940625158328,right,T2,524,4,-20,-14,-6
720575940622244393,right,T2,525,-1,-20,-9,-11
720575940628591303,right,T2,526,0,-10,-5,-5
720575940628460292,right,T2,527,-4,-8,0,-8
720575940633345361,right,T2,528,2,7,1,6
720575940623504637,right,T2,529,2,-2,-3,1
720575940617691137,right,T2,530,-3,-13,-4,-9
720575940624992039,right,T2,531,1,0,-1,1
720575940619441969,right,T2,532,-8,7,11,-4
720575940626481764,right,T2,533,0,-16,-8,-8
720575940610413432,right,T2,534,3,2,-2,4
720575940605564640,right,T2,536,3,4,-1,5
720575940608389724,right,T2,537,0,-23,-12,-11
720575940632579667,right,T2,538,-4,1,4,-3
720575940632016175,right,T2,539,-6,15,13,2
720575940635986807,right,T2,540,-2,-9,-3,-6
720575940620469268,right,T2,541,-4,14,11,3
720575940626595120,right,T2,542,6,-13,-13,0
720575940612934627,right,T2,543,-1,-4,-1,-3
720575940635271013,right,T2,544,3,-13,-10,-3
720575940617608633,right,T2,545,5,11,0,11
720575940628063996,right,T2,546,3,6,0,6
720575940621169473,right,T2,547,-1,21,11,10
720575940614205602,right,T2,548,1,-16,-9,-7
720575940640052096,right,T2,549,0,-9,-5,-4
720575940626796114,right,T2,550,-2,3,3,0
720575940623879146,right,T2,551,-4,-9,-1,-8
720575940631964520,right,T2,552,4,-1,-5,4
720575940614821087,right,T2,553,-3,16,11,5
720575940604248032,right,T2,554,-9,-3,7,-10
720575940619936933,right,T2,555,-4,9,8,1
720575940632613006,right,T2,556,0,10,5,5
720575940627350799,right,T2,557,6,-10,-11,1
720575940612937391,right,T2,558,-4,-21,-7,-14
720575940639633461,right,T2,559,-6,22,17,5
720575940612433578,right,T2,560,-7,14,14,0
720575940628930151,right,T2,561,5,7,-2,9
720575940647366452,right,T2,562,-5,-2,4,-6
720575940620536047,right,T2,563,5,-13,-12,-1
720575940636154804,right,T2,564,3,-23,-15,-8
720575940622273630,right,T2,565,0,-26,-13,-13
720575940627921156,right,T2,566,5,-8,-9,1
720575940627987964,right,T2,567,-2,22,13,9
720575940620102872,right,T2,568,-6,-8,2,-10
720575940630739650,right,T2,569,6,6,-3,9
720575940626147717,right,T2,570,2,25,10,15
720575940644292631,right,T2,571,0,-14,-7,-7
720575940634653079,right,T2,572,-8,3,9,-6
720575940622531060,right,T2,573,4,14,3,11
720575940622924838,right,T2,574,-6,5,8,-3
720575940618020637,right,T2,575,6,9,-2,11
720575940605401702,right,T2,576,0,28,14,14
720575940612848849,right,T2,577,5,-14,-12,-2
720575940608315740,right,T2,579,-3,-10,-2,-8
720575940617182425,right,T2,580,-2,-23,-10,-13
720575940635410356,right,T2,581,3,9,1,8
720575940616931131,right,T2,582,-1,23,12,11
720575940623690122,right,T2,583,3,-25,-16,-9
720575940624780361,right,T2,584,4,23,7,16
720575940631041989,right,T2,585,-1,-23,-11,-12
720575940621699693,right,T2,586,2,18,7,11
720575940631105567,right,T2,588,1,4,1,3
720575940625883267,right,T2,589,-1,-5,-2,-3
720575940628157205,right,T2,590,1,9,3,6
720575940608675797,right,T2,591,3,-3,-5,2
720575940618851613,right,T2,593,3,-14,-10,-4
720575940609154517,right,T2,594,7,-16,-15,-1
720575940602922976,right,T2,595,7,-12,-13,1
720575940633652705,right,T2,596,-4,-16,-4,-12
720575940626686845,right,T2,597,4,1,-4,5
720575940622245153,right,T2,598,2,-18,-11,-7
720575940620906480,right,T2,599,-1,9,5,4
720575940644010440,right,T2,600,3,-10,-8,-2
720575940618119169,right,T2,602,4,-2,-5,3
720575940645176087,right,T2,603,-3,-23,-9,-14
720575940623131661,right,T2,604,-6,-17,-3,-14
720575940654821025,right,T2,605,3,15,4,11
720575940646405667,right,T2,606,-1,-19,-9,-10
720575940619905182,right,T2,607,1,18,8,10
720575940648938873,right,T2,608,1,10,4,6
720575940619912283,right,T2,609,-2,0,2,-2
720575940620754209,right,T2,610,2,-23,-14,-9
720575940617700838,right,T2,611,-1,-18,-8,-10
720575940626262372,right,T2,612,-3,-26,-10,-16
720575940637922111,right,T2,613,-8,-4,6,-10
720575940638253022,right,T2,614,-2,-8,-2,-6
720575940638150734,right,T2,615,-7,-7,3,-10
720575940637154672,right,T2,616,-3,15,10,5
720575940628987408,right,T2,617,-2,-17,-7,-10
720575940626970901,right,T2,618,-1,24,13,11
720575940608937923,right,T2,619,-4,-19,-6,-13
720575940615708831,right,T2,620,7,1,-7,8
720575940625300784,right,T2,621,1,24,11,13
720575940627016281,right,T2,622,-5,20,15,5
720575940621024577,right,T2,623,1,13,5,8
720575940619938384,right,T2,624,1,-17,-10,-7
720575940627025738,right,T2,625,-2,24,14,10
720575940617760596,right,T2,626,-5,-8,1,-9
720575940641423824,right,T2,627,0,-1,-1,0
720575940625802627,right,T2,628,0,0,0,0
720575940620053406,right,T2,629,4,24,8,16
720575940653254902,right,T2,630,4,8,0,8
720575940634849888,right,T2,631,1,26,12,14
720575940624540907,right,T2,632,3,-20,-13,-7
720575940629425911,right,T2,633,-1,-24,-11,-13
720575940624084405,right,T2,634,-3,-15,-5,-10
720575940624352041,right,T2,635,6,-6,-9,3
720575940632213677,right,T2,636,0,6,3,3
720575940629481063,right,T2,637,3,-21,-14,-7
720575940625852602,right,T2,639,-4,19,13,6
720575940630731973,right,T2,640,-1,-16,-7,-9
720575940630912220,right,T2,641,-8,-5,5,-10
720575940632392735,right,T2,642,-5,-11,-1,-10
720575940627274298,right,T2,643,6,14,1,13
720575940614499551,right,T2,644,-6,18,15,3
720575940639831155,right,T2,645,-4,27,17,10
720575940620658029,right,T2,647,-4,-7,0,-7
720575940626326334,right,T2,648,1,7,2,5
720575940622897652,right,T2,649,-1,5,3,2
720575940632341388,right,T2,650,-3,-25,-10,-15
720575940630595415,right,T2,651,-4,-5,1,-6
720575940622216012,right,T2,652,-6,-11,0,-11
720575940646313507,right,T2,653,-6,-12,0,-12
720575940634950239,right,T2,654,-3,8,7,1
720575940643005325,right,T2,655,6,-1,-7,6
720575940651975926,right,T2,656,0,-11,-6,-5
720575940642399989,right,T2,657,-2,-25,-11,-14
720575940620611975,right,T2,658,1,20,9,11
720575940623931143,right,T2,659,-4,-6,1,-7
720575940618616384,right,T2,660,2,28,12,16
720575940613364338,right,T2,661,-3,14,10,4
720575940620298223,right,T2,662,2,-1,-3,2
720575940632574094,right,T2,663,0,8,4,4
720575940642374285,right,T2,664,1,-27,-15,-12
720575940623253261,right,T2,665,7,-2,-8,6
720575940642594720,right,T2,666,7,-13,-14,1
720575940626950148,right,T2,667,1,-28,-15,-13
720575940632584877,right,T2,668,1,19,8,11
720575940643540168,right,T2,669,4,-16,-12,-4
720575940630737014,right,T2,671,-4,-23,-8,-15
720575940652186102,right,T2,672,-8,11,13,-2
720575940609470659,right,T2,673,2,5,0,5
720575940620763937,right,T2,674,-4,-14,-3,-11
720575940621113782,right,T2,675,-7,19,16,3
720575940630217436,right,T2,676,-3,-21,-8,-13
720575940628138408,right,T2,677,0,11,5,6
720575940622145192,right,T2,678,3,-7,-7,0
720575940609024451,right,T2,679,4,18,5,13
720575940640046424,right,T2,680,-1,25,13,12
720575940609852740,right,T2,681,-2,-21,-9,-12
720575940627943701,right,T2,682,6,-8,-10,2
720575940633643033,right,T2,683,2,6,1,5
720575940631185227,right,T2,684,-6,17,14,3
720575940624195837,right,T2,685,-5,-9,0,-9
720575940611780465,right,T2,686,5,-22,-16,-6
720575940639648829,right,T2,687,-6,-3,4,-7
720575940627540241,right,T2,688,-7,10,12,-2
720575940626681945,right,T2,689,-2,18,11,7
720575940630434678,right,T2,690,-7,-3,5,-8
720575940623978239,right,T2,691,-9,4,11,-7
720575940625091879,right,T2,692,-4,24,16,8
720575940611935637,right,T2,693,-3,25,15,10
720575940623787533,right,T2,694,4,3,-3,6
720575940635206392,right,T2,695,-6,10,11,-1
720575940617925588,right,T2,696,-2,16,10,6
720575940617190459,right,T2,697,1,-22,-12,-10
720575940624872456,right,T2,698,6,-7,-10,3
720575940617405494,right,T2,699,-5,0,5,-5
720575940605423282,right,T2,700,5,15,2,13
720575940629533495,right,T2,701,0,-4,-2,-2
720575940624252308,right,T2,702,-5,23,16,7
720575940621243045,right,T2,703,-3,1,3,-2
720575940611560341,right,T2,704,-7,8,11,-3
720575940615514683,right,T2,705,1,1,-1,2
720575940630444867,right,T2,706,-7,-12,1,-13
720575940611924373,right,T2,707,-2,25,14,11
720575940630838124,right,T2,708,-4,-25,-9,-16
720575940638070079,right,T2,709,-2,-24,-10,-14
720575940631301932,right,T2,710,4,-25,-17,-8
720575940617302745,right,T2,711,-1,19,10,9
720575940621970598,right,T2,712,-7,12,13,-1
720575940612229349,right,T2,713,-6,16,14,2
720575940611329230,right,T2,714,5,12,1,11
720575940635766896,right,T2,717,2,-22,-13,-9
720575940630685241,right,T2,718,-5,24,17,7
720575940634180377,right,T2,719,1,27,12,15
720575940625309001,right,T2,723,-2,-11,-4,-7
720575940632015171,right,T2,724,4,2,-3,5
720575940622375638,right,T2,725,-3,-24,-9,-15
720575940612592281,right,T2,726,2,-28,-16,-12
720575940617416148,right,T2,728,7,12,-1,13
720575940615541590,right,T2,729,-3,29,17,12
720575940635266740,right,T2,731,-6,9,10,-1
720575940605735345,right,T2,732,-3,6,6,0
720575940631094031,right,T2,733,-5,-17,-4,-13
720575940625961817,right,T2,734,2,0,-2,2
720575940605028320,right,T2,735,1,-23,-13,-10
720575940616622849,right,T2,736,-8,1,8,-7
720575940616486668,right,T2,737,0,19,9,10
720575940623270122,right,T2,738,-3,13,9,4
720575940620030191,right,T2,739,-7,2,8,-6
720575940633608674,right,T2,740,2,-8,-6,-2
720575940612381925,right,T2,741,-2,-14,-5,-9
720575940629417342,right,T2,742,-4,11,9,2
720575940627082511,right,T2,743,6,-19,-16,-3
720575940655155105,right,T2,744,-4,25,16,9
720575940628859900,right,T2,745,0,13,6,7
720575940625071132,right,T2,746,-3,3,4,-1
720575940635579839,right,T2,747,0,2,1,1
720575940610908122,right,T2,750,4,-24,-16,-8
720575940614861378,right,T2,751,1,6,2,4
720575940632665764,right,T2,752,-2,7,5,2
720575940629043499,right,T2,753,-3,24,15,9
720575940640919797,right,T2,755,4,19,5,14
720575940624301641,right,T2,756,5,20,5,15
720575940639913936,right,T2,757,0,-6,-3,-3
720575940613681778,right,T2,758,5,-1,-6,5
720575940615686749,right,T2,759,7,14,0,14
720575940611926195,right,T2,760,0,17,8,9
720575940637683775,right,T2,761,-4,-18,-5,-13
720575940626721054,right,T2,762,0,14,7,7
720575940629949495,right,T2,763,-5,14,12,2
720575940640013427,right,T2,764,-8,-6,5,-11
720575940638948515,right,T2,765,-3,9,7,2
720575940619845568,right,T2,766,2,-4,-4,0
720575940637086576,right,T2,767,1,28,13,15
720575940639251645,right,T2,768,3,5,-1,6
720575940624191669,right,T2,770,5,4,-3,7
720575940625474637,right,T2,771,3,-27,-17,-10
720575940622563524,right,T2,773,5,-19,-15,-4
720575940627883367,right,T2,774,-8,6,11,-5
720575940654906529,right,T2,775,5,22,6,16
720575940612766170,right,T2,776,5,21,5,16
720575940624294729,right,T2,777,6,20,4,16
720575940636908645,right,T2,778,4,25,8,17
720575940621528496,right,T2,780,-6,25,18,7
720575940621840222,right,T2,781,-5,26,18,8
720575940618509893,right,T2,783,-4,28,18,10
720575940646616355,right,T2,785,-3,30,18,12
720575940638057818,right,T2,786,-2,30,17,13
720575940624201545,right,T2,787,3,28,11,17
720575940624218665,right,T2,789,-3,-27,-11,-16
720575940644243104,right,T2,790,-2,-27,-12,-15
720575940660259457,right,T2,791,-1,-28,-13,-15
720575940604610225,right,T2,792,8,2,-7,9
720575940638497368,right,T2,794,5,-26,-18,-8
720575940615465578,right,T2,796,4,26,9,17
720575940617232825,right,T2a,1,-6,13,12,1
720575940626644111,right,T2a,2,-8,2,9,-7
720575940620366795,right,T2a,3,6,-12,-12,0
720575940615327906,right,T2a,4,-5,-21,-6,-15
720575940614124967,right,T2a,5,-1,16,9,7
720575940619653278,right,T2a,6,-2,-4,0,-4
720575940624253882,right,T2a,7,-6,-6,3,-9
720575940630734244,right,T2a,8,-4,26,17,9
720575940628772763,right,T2a,9,4,9,0,9
720575940614393297,right,T2a,10,5,-15,-13,-2
720575940620353520,right,T2a,11,7,-14,-14,0
720575940627537832,right,T2a,12,-7,9,11,-2
720575940631600938,right,T2a,13,-1,-26,-12,-14
720575940608755977,right,T2a,14,0,-27,-14,-13
720575940635660399,right,T2a,15,2,-3,-4,1
720575940622297980,right,T2a,16,-2,-16,-6,-10
720575940626270666,right,T2a,17,1,-5,-4,-1
720575940611133650,right,T2a,18,5,-16,-13,-3
720575940623798316,right,T2a,19,-7,17,15,2
720575940640877008,right,T2a,20,3,-11,-9,-2
720575940624421268,right,T2a,21,-2,19,11,8
720575940620129857,right,T2a,22,-1,3,2,1
720575940619058205,right,T2a,23,-3,-16,-5,-11
720575940644710510,right,T2a,24,-1,-10,-4,-6
720575940622356950,right,T2a,25,-9,3,10,-7
720575940621521601,right,T2a,26,1,-3,-3,0
720575940622478716,right,T2a,27,0,-25,-13,-12
720575940608389385,right,T2a,28,5,6,-2,8
720575940604585504,right,T2a,29,-1,-3,-1,-2
720575940636733156,right,T2a,31,0,16,8,8
720575940628021834,right,T2a,32,0,12,6,6
720575940624414205,right,T2a,33,3,18,6,12
720575940616464214,right,T2a,34,6,18,3,15
720575940636503159,right,T2a,35,1,-24,-13,-11
720575940619451339,right,T2a,36,6,8,-2,10
720575940604415148,right,T2a,37,1,5,1,4
720575940636791438,right,T2a,38,0,-2,-1,-1
720575940613032434,right,T2a,39,0,20,10,10
720575940612000218,right,T2a,40,-2,-6,-1,-5
720575940628007144,right,T2a,41,-3,28,17,11
720575940626442904,right,T2a,42,-1,14,8,6
720575940622903309,right,T2a,43,-5,18,14,4
720575940619078454,right,T2a,44,5,-10,-10,0
720575940628569243,right,T2a,45,-5,-1,4,-5
720575940637644004,right,T2a,46,-5,15,12,3
720575940629007259,right,T2a,47,-9,-1,8,-9
720575940619657381,right,T2a,48,-4,-22,-7,-15
720575940627676971,right,T2a,49,4,-4,-6,2
720575940617427897,right,T2a,50,-2,21,12,9
720575940615380898,right,T2a,51,0,-19,-10,-9
720575940623149021,right,T2a,52,-1,-22,-10,-12
720575940634452631,right,T2a,53,5,14,2,12
720575940616366709,right,T2a,54,-4,3,5,-2
720575940624932366,right,T2a,55,-4,-11,-2,-9
720575940620925934,right,T2a,56,1,-13,-8,-5
720575940634199321,right,T2a,57,6,-11,-12,1
720575940617034589,right,T2a,58,3,12,3,9
720575940619969300,right,T2a,59,-2,2,3,-1
720575940630842199,right,T2a,60,-8,8,12,-4
720575940630890344,right,T2a,61,-4,-4,2,-6
720575940612727770,right,T2a,63,4,12,2,10
720575940621362452,right,T2a,65,-1,28,15,13
720575940621375728,right,T2a,66,2,15,5,10
720575940620658091,right,T2a,67,-2,-13,-5,-8
720575940606974386,right,T2a,68,3,16,5,11
720575940610492339,right,T2a,69,1,8,3,5
720575940633525134,right,T2a,70,-4,21,14,7
720575940619579216,right,T2a,71,-2,-3,0,-3
720575940630101559,right,T2a,72,0,-28,-14,-14
720575940616169845,right,T2a,73,2,2,-1,3
720575940619120293,right,T2a,74,-1,-9,-4,-5
720575940628289423,right,T2a,75,-6,14,13,1
720575940635741808,right,T2a,76,-3,-4,1,-5
720575940622945515,right,T2a,77,2,-5,-5,0
720575940625208126,right,T2a,78,2,20,8,12
720575940607930889,right,T2a,79,2,1,-2,3
720575940638145087,right,T2a,80,4,13,2,11
720575940640296576,right,T2a,81,6,-2,-7,5
720575940620443014,right,T2a,82,-7,7,10,-3
720575940612082602,right,T2a,83,2,-21,-13,-8
720575940622120998,right,T2a,84,-2,12,8,4
720575940605799712,right,T2a,85,4,-22,-15,-7
720575940620248769,right,T2a,87,1,11,4,7
720575940622501069,right,T2a,88,7,4,-5,9
720575940621020993,right,T2a,90,-4,5,6,-1
720575940622581801,right,T2a,91,-1,6,4,2
720575940631363651,right,T2a,92,0,9,4,5
720575940627675983,right,T2a,93,-6,3,7,-4
720575940628233468,right,T2a,94,5,18,4,14
720575940617421110,right,T2a,95,4,-21,-15,-6
720575940630980311,right,T2a,96,1,-10,-6,-4
720575940604336049,right,T2a,97,-5,2,6,-4
720575940621985089,right,T2a,98,-1,-12,-5,-7
720575940633667923,right,T2a,100,2,-10,-7,-3
720575940635531956,right,T2a,101,-7,6,10,-4
720575940627315989,right,T2a,102,3,13,3,10
720575940623195085,right,T2a,104,-1,-27,-13,-14
720575940638148698,right,T2a,105,3,22,8,14
720575940633371859,right,T2a,106,-7,11,12,-1
720575940620275220,right,T2a,107,8,-2,-9,7
720575940636748766,right,T2a,108,-3,-12,-3,-9
720575940608742923,right,T2a,109,4,-5,-7,2
720575940613738035,right,T2a,110,-7,0,7,-7
720575940625288323,right,T2a,111,2,-24,-14,-10
720575940624253939,right,T2a,112,-6,1,6,-5
720575940632209038,right,T2a,113,-2,4,4,0
720575940627013465,right,T2a,114,2,-13,-9,-4
720575940626640659,right,T2a,115,-4,2,5,-3
720575940639771776,right,T2a,116,-1,-8,-3,-5
720575940626009274,right,T2a,117,-8,-2,7,-9
720575940639352893,right,T2a,118,3,1,-3,4
720575940609070531,right,T2a,119,-2,6,5,1
720575940609313860,right,T2a,120,-1,-1,0,-1
720575940620042886,right,T2a,121,-8,4,10,-6
720575940645803287,right,T2a,122,-5,9,9,0
720575940614111711,right,T2a,123,-8,10,13,-3
720575940629938220,right,T2a,124,1,-7,-5,-2
720575940630504279,right,T2a,125,5,9,-1,10
720575940621723004,right,T2a,126,3,11,2,9
720575940632375950,right,T2a,127,0,15,7,8
720575940605823422,right,T2a,128,3,-22,-14,-8
720575940628504326,right,T2a,129,0,-13,-7,-6
720575940622631448,right,T2a,130,2,12,4,8
720575940639864739,right,T2a,131,-6,20,16,4
720575940626711427,right,T2a,132,2,4,0,4
720575940626897964,right,T2a,133,-3,20,13,7
720575940610140878,right,T2a,134,-5,-18,-4,-14
720575940626504476,right,T2a,135,-3,-22,-8,-14
720575940616890708,right,T2a,136,0,3,1,2
720575940633340589,right,T2a,137,5,-7,-9,2
720575940630604860,right,T2a,138,0,27,13,14
720575940622810506,right,T2a,139,1,-14,-8,-6
720575940630568535,right,T2a,140,3,8,1,7
720575940640513907,right,T2a,142,-2,-18,-7,-11
720575940629705577,right,T2a,143,-4,16,12,4
720575940644574756,right,T2a,144,7,-11,-13,2
720575940619234353,right,T2a,145,0,4,2,2
720575940620848110,right,T2a,146,1,-6,-4,-2
720575940646535203,right,T2a,147,1,21,9,12
720575940635183002,right,T2a,149,6,-14,-13,-1
720575940620335270,right,T2a,150,-8,5,10,-5
720575940634877039,right,T2a,151,-3,-14,-4,-10
720575940619250590,right,T2a,152,3,-15,-11,-4
720575940620571819,right,T2a,153,8,0,-8,8
720575940631704271,right,T2a,154,-8,0,8,-8
720575940620729510,right,T2a,155,-8,13,14,-1
720575940614046114,right,T2a,156,-9,1,9,-8
720575940631750727,right,T2a,157,-1,-7,-3,-4
720575940620218862,right,T2a,158,3,-5,-6,1
720575940614624146,right,T2a,159,7,7,-4,11
720575940609782997,right,T2a,160,-2,20,12,8
720575940626942077,right,T2a,161,4,-14,-11,-3
720575940622347755,right,T2a,162,-4,-2,3,-5
720575940636070519,right,T2a,163,-9,7,12,-5
720575940626771143,right,T2a,164,-1,-2,0,-2
720575940618526262,right,T2a,165,4,16,4,12
720575940628310121,right,T2a,166,0,18,9,9
720575940611495214,right,T2a,167,0,-17,-9,-8
720575940619740481,right,T2a,168,-1,17,9,8
720575940623171085,right,T2a,169,0,-18,-9,-9
720575940626156419,right,T2a,170,-5,1,5,-4
720575940621411649,right,T2a,172,1,22,10,12
720575940611857138,right,T2a,173,2,-25,-15,-10
720575940626981647,right,T2a,174,4,-15,-12,-3
720575940626381570,right,T2a,175,-6,-7,2,-9
720575940626168965,right,T2a,176,-2,13,8,5
720575940623381941,right,T2a,177,-2,-1,1,-2
720575940631227599,right,T2a,178,2,11,3,8
720575940622127871,right,T2a,179,-5,-16,-3,-13
720575940624333385,right,T2a,180,2,-27,-16,-11
720575940623780877,right,T2a,181,1,-4,-3,-1
720575940628385866,right,T2a,183,-5,-15,-3,-12
720575940630327547,right,T2a,184,-6,-5,3,-8
720575940610689326,right,T2a,185,2,-11,-8,-3
720575940630337591,right,T2a,186,-1,26,14,12
720575940629016791,right,T2a,187,3,21,7,14
720575940624642803,right,T2a,188,-5,17,13,4
720575940610712930,right,T2a,189,6,13,0,13
720575940616226747,right,T2a,190,-3,-5,0,-5
720575940623929863,right,T2a,191,-1,-11,-5,-6
720575940627192164,right,T2a,192,7,10,-2,12
720575940607972956,right,T2a,193,-5,4,7,-3
720575940621160468,right,T2a,194,0,-5,-3,-2
720575940616920347,right,T2a,195,-3,-1,2,-3
720575940643507764,right,T2a,196,-1,8,5,3
720575940623228184,right,T2a,197,0,-20,-10,-10
720575940617654673,right,T2a,198,6,2,-5,7
720575940623209677,right,T2a,199,0,-12,-6,-6
720575940627305833,right,T2a,200,-5,12,11,1
720575940619951342,right,T2a,201,-8,9,12,-3
720575940620602351,right,T2a,202,-1,27,14,13
720575940643512372,right,T2a,203,3,-1,-4,3
720575940619075566,right,T2a,204,5,-2,-6,4
720575940618277456,right,T2a,205,5,-6,-8,2
720575940628836908,right,T2a,206,-3,5,5,0
720575940632165944,right,T2a,207,1,29,13,16
720575940621391087,right,T2a,208,5,-21,-16,-5
720575940619436337,right,T2a,209,-3,-8,-1,-7
720575940612293273,right,T2a,210,-6,8,10,-2
720575940641114676,right,T2a,211,-7,-1,6,-7
720575940615466911,right,T2a,212,2,-16,-10,-6
720575940635444398,right,T2a,213,3,-4,-5,1
720575940659975297,right,T2a,214,-5,3,6,-3
720575940634470114,right,T2a,215,6,7,-3,10
720575940618555321,right,T2a,216,2,19,7,12
720575940617523746,right,T2a,217,6,15,1,14
720575940624293961,right,T2a,218,2,10,3,7
720575940634720248,right,T2a,219,6,-4,-8,4
720575940632831775,right,T2a,220,2,-6,-5,-1
720575940614696242,right,T2a,221,-7,3,8,-5
720575940606129854,right,T2a,222,-3,26,16,10
720575940623194504,right,T2a,223,-2,26,15,11
720575940624204984,right,T2a,224,0,5,2,3
720575940612124785,right,T2a,225,2,-26,-15,-11
720575940630675474,right,T2a,226,5,19,4,15
720575940638597941,right,T2a,227,-7,5,9,-4
720575940629369026,right,T2a,228,-7,1,7,-6
720575940637251703,right,T2a,229,5,2,-4,6
720575940623658461,right,T2a,230,2,9,2,7
720575940620336549,right,T2a,231,4,-12,-10,-2
720575940625154568,right,T2a,232,-4,13,10,3
720575940650015609,right,T2a,233,4,-13,-11,-2
720575940620971696,right,T2a,234,1,3,0,3
720575940616684082,right,T2a,235,4,11,1,10
720575940638505038,right,T2a,236,-1,4,3,1
720575940635120223,right,T2a,237,-2,27,15,12
720575940617904614,right,T2a,238,-8,-3,6,-9
720575940620666704,right,T2a,239,-6,6,9,-3
720575940635458040,right,T2a,240,-4,-3,2,-5
720575940626986014,right,T2a,241,2,-17,-11,-6
720575940604013926,right,T2a,242,-4,6,7,-1
720575940630582777,right,T2a,243,-1,-21,-10,-11
720575940633210323,right,T2a,244,-4,-12,-2,-10
720575940635143263,right,T2a,245,-5,-3,3,-6
720575940622199164,right,T2a,246,-4,15,11,4
720575940624970168,right,T2a,247,-4,-15,-4,-11
720575940632063116,right,T2a,248,-6,0,6,-6
720575940634604442,right,T2a,249,2,-12,-8,-4
720575940615187250,right,T2a,250,-1,1,1,0
720575940624591177,right,T2a,251,-1,-14,-6,-8
720575940615750047,right,T2a,252,3,23,8,15
720575940615121986,right,T2a,253,5,16,3,13
720575940621657441,right,T2a,254,3,-24,-15,-9
720575940629337082,right,T2a,255,-6,-13,-1,-12
720575940631912519,right,T2a,257,2,21,8,13
720575940627543061,right,T2a,258,-4,-17,-5,-12
720575940635162475,right,T2a,259,-7,-5,4,-9
720575940645587566,right,T2a,260,-3,19,12,7
720575940620191168,right,T2a,261,-1,13,7,6
720575940630908631,right,T2a,262,1,-11,-7,-4
720575940628570186,right,T2a,263,-3,4,5,-1
720575940630983223,right,T2a,264,-1,-6,-2,-4
720575940617334758,right,T2a,265,-6,-1,5,-6
720575940622581226,right,T2a,266,-1,-25,-12,-13
720575940618050880,right,T2a,267,-6,2,7,-5
720575940646347299,right,T2a,268,7,-6,-10,4
720575940615862459,right,T2a,269,2,-19,-12,-7
720575940623541483,right,T2a,270,1,-8,-5,-3
720575940620273946,right,T2a,271,4,6,-1,7
720575940641328692,right,T2a,272,3,-2,-4,2
720575940611601250,right,T2a,273,-6,23,17,6
720575940619049125,right,T2a,274,6,4,-4,8
720575940615697314,right,T2a,275,-8,-1,7,-8
720575940627044358,right,T2a,276,2,3,-1,4
720575940614444967,right,T2a,277,7,-3,-9,6
720575940621744508,right,T2a,278,-5,10,10,0
720575940628440698,right,T2a,279,-4,8,8,0
720575940627430202,right,T2a,280,-6,-14,-1,-13
720575940615982965,right,T2a,281,-9,2,10,-8
720575940609973060,right,T2a,282,0,26,13,13
720575940628745063,right,T2a,283,-4,4,6,-2
720575940626404807,right,T2a,284,0,25,12,13
720575940646276387,right,T2a,285,6,-18,-15,-3
720575940632594084,right,T2a,286,0,-24,-12,-12
720575940633858958,right,T2a,287,-5,13,11,2
720575940632066834,right,T2a,288,-1,30,16,14
720575940635207781,right,T2a,289,-1,11,6,5
720575940621277044,right,T2a,290,5,-24,-17,-7
720575940623082595,right,T2a,291,7,2,-6,8
720575940635602783,right,T2a,292,-4,18,13,5
720575940632366675,right,T2a,293,4,-17,-13,-4
720575940623647256,right,T2a,294,1,-20,-11,-9
720575940617065522,right,T2a,295,-2,29,16,13
720575940618370885,right,T2a,296,1,-18,-10,-8
720575940643586868,right,T2a,298,-5,5,7,-2
720575940633858446,right,T2a,299,-4,12,10,2
720575940613909475,right,T2a,300,4,-18,-13,-5
720575940621832197,right,T2a,301,-5,16,13,3
720575940645194606,right,T2a,302,2,17,6,11
720575940607278345,right,T2a,303,-5,22,16,6
720575940623631031,right,T2a,304,6,5,-4,9
720575940634024599,right,T2a,305,-7,4,9,-5
720575940616891707,right,T2a,306,3,7,0,7
720575940619807793,right,T2a,307,5,-25,-18,-7
720575940622346590,right,T2a,308,-5,8,9,-1
720575940630225377,right,T2a,309,-6,12,12,0
720575940633532898,right,T2a,310,2,22,9,13
720575940603333804,right,T2a,311,-7,15,14,1
720575940616001804,right,T2a,312,4,-7,-8,1
720575940617017305,right,T2a,313,7,3,-6,9
720575940632313675,right,T2a,314,-9,5,11,-6
720575940613776435,right,T2a,315,-3,-6,0,-6
720575940615709762,right,T2a,316,5,-4,-7,3
720575940629251194,right,T2a,317,-5,-4,3,-7
720575940619821677,right,T2a,318,4,-19,-14,-5
720575940623428681,right,T2a,319,-2,5,4,1
720575940610902226,right,T2a,320,-2,-5,-1,-4
720575940624107144,right,T2a,321,8,4,-6,10
720575940623714794,right,T2a,322,2,26,11,15
720575940622994884,right,T2a,323,-7,-13,0,-13
720575940622036044,right,T2a,324,3,24,9,15
720575940613428195,right,T2a,325,5,1,-5,6
720575940635134576,right,T2a,326,2,16,6,10
720575940617402139,right,T2a,327,5,3,-4,7
720575940624752364,right,T2a,328,5,-9,-10,1
720575940613288857,right,T2a,329,0,24,12,12
720575940635207092,right,T2a,330,3,3,-2,5
720575940626925583,right,T2a,331,1,-15,-9,-6
720575940634510176,right,T2a,332,4,-26,-17,-9
720575940628717073,right,T2a,333,0,-21,-11,-10
720575940627918611,right,T2a,334,1,-26,-14,-12
720575940628810139,right,T2a,335,2,8,2,6
720575940634896480,right,T2a,336,0,23,11,12
720575940606973826,right,T2a,337,-5,-6,2,-8
720575940613384913,right,T2a,338,-1,0,1,-1
720575940627520455,right,T2a,339,6,11,-1,12
720575940623748813,right,T2a,340,-4,17,12,5
720575940622941464,right,T2a,341,6,-17,-15,-2
720575940618165661,right,T2a,342,2,-15,-10,-5
720575940631105956,right,T2a,343,-3,27,16,11
720575940620698704,right,T2a,344,-2,-15,-6,-9
720575940605483977,right,T2a,345,3,-12,-9,-3
720575940623860477,right,T2a,346,-7,-9,2,-11
720575940624018939,right,T2a,347,-5,-13,-2,-11
720575940625572901,right,T2a,348,3,14,4,10
720575940630412842,right,T2a,349,-5,-14,-2,-12
720575940638801597,right,T2a,350,1,15,6,9
720575940611089618,right,T2a,351,-1,-17,-8,-9
720575940632433747,right,T2a,352,-2,28,16,12
720575940620803499,right,T2a,353,2,24,10,14
720575940615320482,right,T2a,354,-2,-26,-11,-15
720575940616972486,right,T2a,355,-7,-6,4,-10
720575940614651298,right,T2a,356,0,22,11,11
720575940628600143,right,T2a,357,4,17,4,13
720575940630979279,right,T2a,358,-3,17,11,6
720575940626928968,right,T2a,359,2,23,9,14
720575940627089801,right,T2a,360,-5,19,14,5
720575940627310394,right,T2a,361,0,-7,-4,-3
720575940625108412,right,T2a,363,7,-4,-9,5
720575940628902120,right,T2a,364,4,4,-2,6
720575940619684288,right,T2a,365,4,7,-1,8
720575940615905036,right,T2a,366,-5,-20,-5,-15
720575940615607362,right,T2a,367,-6,-15,-2,-13
720575940629188967,right,T2a,368,-4,-20,-6,-14
720575940632628644,right,T2a,369,5,-5,-8,3
720575940629756663,right,T2a,370,-3,21,13,8
720575940645067316,right,T2a,371,6,-5,-9,4
720575940619604756,right,T2a,372,1,-2,-2,0
720575940623768781,right,T2a,373,1,-21,-12,-9
720575940644599063,right,T2a,374,2,13,4,9
720575940622150614,right,T2a,375,-6,7,9,-2
720575940626937602,right,T2a,376,-7,-10,2,-12
720575940639495512,right,T2a,377,0,7,3,4
720575940633793249,right,T2a,378,-3,18,12,6
720575940628371671,right,T2a,379,3,-17,-12,-5
720575940629125675,right,T2a,380,-1,29,15,14
720575940631960633,right,T2a,381,-8,-9,3,-12
720575940614793122,right,T2a,382,3,-6,-6,0
720575940627046931,right,T2a,383,-6,11,11,0
720575940624614292,right,T2a,384,-6,-2,5,-7
720575940620692318,right,T2a,385,-3,-18,-6,-12
720575940620418987,right,T2a,386,-6,19,15,4
720575940635263156,right,T2a,387,-1,-15,-7,-8
720575940630902469,right,T2a,388,3,19,6,13
720575940630751183,right,T2a,389,-6,-16,-2,-14
720575940626618895,right,T2a,390,-6,-9,1,-10
720575940632487213,right,T2a,391,4,-3,-6,3
720575940621648019,right,T2a,392,-4,7,7,0
720575940643554852,right,T2a,393,-1,22,12,10
720575940660628609,right,T2a,394,-7,-8,3,-11
720575940641363701,right,T2a,395,0,-22,-11,-11
720575940627088940,right,T2a,396,-1,10,6,4
720575940609069507,right,T2a,397,-3,-19,-7,-12
720575940627089033,right,T2a,398,-3,22,14,8
720575940637979226,right,T2a,399,-4,-24,-8,-16
720575940628457018,right,T2a,400,1,-29,-16,-13
720575940631895400,right,T2a,402,3,26,10,16
720575940619858928,right,T2a,403,-2,-12,-4,-8
720575940626914092,right,T2a,404,-1,20,11,9
720575940625414288,right,T2a,405,3,10,2,8
720575940635671220,right,T2a,406,1,-25,-14,-11
720575940626372354,right,T2a,407,-5,-10,0,-10
720575940638265577,right,T2a,408,-6,-4,4,-8
720575940639007039,right,T2a,409,0,-3,-2,-1
720575940620631990,right,T2a,410,-2,-2,1,-3
720575940625647768,right,T2a,411,-5,-19,-5,-14
720575940620458004,right,T2a,412,-6,21,16,5
720575940614520999,right,T2a,413,-2,-7,-2,-5
720575940660049537,right,T2a,414,4,21,6,15
720575940633887955,right,T2a,415,6,12,0,12
720575940628572521,right,T2a,416,3,-8,-7,-1
720575940626659343,right,T2a,417,-6,-10,1,-11
720575940623407812,right,T2a,418,-2,15,9,6
720575940608992469,right,T2a,419,-3,-11,-3,-8
720575940612263321,right,T2a,420,6,-3,-8,5
720575940627088684,right,T2a,421,-1,12,7,5
720575940622784717,right,T2a,422,-7,-4,5,-9
720575940636647822,right,T2a,423,3,-18,-12,-6
720575940627249541,right,T2a,424,-3,-2,2,-4
720575940628290033,right,T2a,425,3,20,7,13
720575940630356956,right,T2a,426,-3,0,3,-3
720575940627289449,right,T2a,427,5,-18,-14,-4
720575940615151722,right,T2a,428,-2,23,13,10
720575940617236665,right,T2a,429,-2,14,9,5
720575940614593170,right,T2a,430,-3,-7,-1,-6
720575940608534281,right,T2a,431,-2,-10,-3,-7
720575940625703098,right,T2a,432,-5,7,8,-1
720575940620091216,right,T2a,433,0,-8,-4,-4
720575940632666276,right,T2a,434,-3,7,6,1
720575940639692659,right,T2a,435,5,-17,-14,-3
720575940618782800,right,T2a,436,0,-15,-8,-7
720575940609623253,right,T2a,437,-3,12,9,3
720575940624167176,right,T2a,438,2,27,11,16
720575940631781945,right,T2a,439,-3,-9,-2,-7
720575940622029960,right,T2a,440,1,23,10,13
720575940613480367,right,T2a,441,3,-16,-11,-5
720575940635398551,right,T2a,442,-5,25,17,8
720575940632666020,right,T2a,443,-6,4,8,-4
720575940623423880,right,T2a,444,4,-10,-9,-1
720575940611993523,right,T2a,445,-2,8,6,2
720575940635276698,right,T2a,446,2,-14,-9,-5
720575940616825062,right,T2a,447,-1,2,2,0
720575940621019501,right,T2a,449,6,-16,-14,-2
720575940623494697,right,T2a,450,2,-9,-7,-2
720575940622763997,right,T2a,451,4,20,6,14
720575940632215251,right,T2a,452,1,-9,-6,-3
720575940617333307,right,T2a,453,3,25,9,16
720575940641187829,right,T2a,454,5,-12,-11,-1
720575940629773306,right,T2a,455,7,-7,-11,4
720575940612035697,right,T2a,456,0,21,10,11
720575940626730268,right,T2a,457,-2,17,10,7
720575940623640247,right,T2a,458,5,0,-5,5
720575940619794598,right,T2a,459,5,-3,-7,4
720575940615212511,right,T2a,460,-3,-20,-7,-13
720575940610268017,right,T2a,461,7,-5,-10,5
720575940632409230,right,T2a,462,-1,18,10,8
720575940647803524,right,T2a,463,5,17,3,14
720575940639585112,right,T2a,464,4,0,-4,4
720575940618863153,right,T2a,465,3,0,-3,3
720575940621353972,right,T2a,466,1,14,6,8
720575940636709231,right,T2a,467,-2,-20,-8,-12
720575940604508960,right,T2a,468,-3,11,8,3
720575940633210846,right,T2a,469,-7,13,13,0
720575940621303535,right,T2a,470,4,-9,-9,0
720575940632356367,right,T2a,471,3,-26,-16,-10
720575940638291263,right,T2a,472,1,25,11,14
720575940621362753,right,T2a,473,-4,23,15,8
720575940624280555,right,T2a,474,-3,-17,-6,-11
720575940613149146,right,T2a,475,-4,-1,3,-4
720575940622145037,right,T2a,476,-1,15,8,7
720575940613127976,right,T2a,477,-3,2,4,-2
720575940608857557,right,T2a,478,-7,16,15,1
720575940629657687,right,T2a,479,-2,10,7,3
720575940624253163,right,T2a,480,3,-19,-13,-6
720575940635197547,right,T2a,481,4,-8,-8,0
720575940623682997,right,T2a,482,1,17,7,10
720575940638349631,right,T2a,483,2,-7,-6,-1
720575940622224884,right,T2a,484,3,-9,-8,-1
720575940614526119,right,T2a,485,-3,-3,1,-4
720575940623879916,right,T2a,486,0,1,0,1
720575940620551777,right,T2a,487,1,-1,-2,1
720575940640854656,right,T2a,488,7,5,-5,10
720575940624980467,right,T2a,489,-3,10,8,2
720575940613860915,right,T2a,490,-5,6,8,-2
720575940638102106,right,T2a,491,7,-1,-8,7
720575940632416543,right,T2a,492,-7,-2,6,-8
720575940620665990,right,T2a,493,-3,23,14,9
720575940614747810,right,T2a,494,0,29,14,15
720575940613428451,right,T2a,495,4,5,-2,7
720575940627272325,right,T2a,496,7,8,-3,11
720575940616990837,right,T2a,497,6,1,-6,7
720575940620191425,right,T2a,498,6,10,-1,11
720575940645138632,right,T2a,499,5,10,0,10
720575940614242257,right,T2a,500,7,-8,-11,3
720575940624067367,right,T2a,501,1,2,0,2
720575940632719244,right,T2a,502,5,8,-1,9
720575940619120088,right,T2a,503,3,17,5,12
720575940630013822,right,T2a,504,-2,9,6,3
720575940627761210,right,T2a,505,6,-22,-17,-5
720575940625892912,right,T2a,506,1,-12,-7,-5
720575940640149813,right,T2a,507,-5,-12,-1,-11
720575940639582627,right,T2a,508,-5,11,10,1
720575940633852046,right,T2a,509,-4,10,9,1
720575940621020598,right,T2a,510,-2,11,7,4
720575940626425700,right,T2a,511,5,-11,-11,0
720575940606860721,right,T2a,512,6,0,-6,6
720575940610946266,right,T2a,513,-4,-13,-3,-10
720575940629411966,right,T2a,514,-4,-10,-1,-9
720575940618968222,right,T2a,515,-8,-7,4,-11
720575940624702222,right,T2a,516,7,-18,-16,-2
720575940617712273,right,T2a,517,6,3,-5,8
720575940607081161,right,T2a,518,-4,22,15,7
720575940630771564,right,T2a,519,-5,-5,2,-7
720575940629703939,right,T2a,520,-2,-22,-9,-13
720575940627013721,right,T2a,521,6,-9,-11,2
720575940631289155,right,T2a,522,-4,0,4,-4
720575940634453655,right,T2a,523,2,14,5,9
720575940632699565,right,T2a,524,4,-20,-14,-6
720575940647573300,right,T2a,525,-1,-20,-9,-11
720575940607987330,right,T2a,526,0,-10,-5,-5
720575940646768180,right,T2a,527,-4,-8,0,-8
720575940617751581,right,T2a,528,2,7,1,6
720575940641274676,right,T2a,529,2,-2,-3,1
720575940636073579,right,T2a,530,-3,-13,-4,-9
720575940636775342,right,T2a,531,1,0,-1,1
720575940628238577,right,T2a,532,-8,7,11,-4
720575940624569085,right,T2a,533,0,-16,-8,-8
720575940626661660,right,T2a,534,3,2,-2,4
720575940639600829,right,T2a,535,8,-4,-10,6
720575940630243431,right,T2a,536,3,4,-1,5
720575940631189199,right,T2a,537,0,-23,-12,-11
720575940627759753,right,T2a,538,-4,1,4,-3
720575940622044698,right,T2a,539,-6,15,13,2
720575940624151303,right,T2a,540,-2,-9,-3,-6
720575940626139932,right,T2a,541,-4,14,11,3
720575940617761510,right,T2a,542,6,-13,-13,0
720575940613576367,right,T2a,543,-1,-4,-1,-3
720575940620759534,right,T2a,544,3,-13,-10,-3
720575940631842700,right,T2a,545,5,11,0,11
720575940617528065,right,T2a,546,3,6,0,6
720575940637611109,right,T2a,547,-1,21,11,10
720575940624331755,right,T2a,548,1,-16,-9,-7
720575940623438377,right,T2a,549,0,-9,-5,-4
720575940604218028,right,T2a,550,-2,3,3,0
720575940635452596,right,T2a,551,-4,-9,-1,-8
720575940620139399,right,T2a,552,4,-1,-5,4
720575940634356124,right,T2a,553,-3,16,11,5
720575940620528038,right,T2a,554,-9,-3,7,-10
720575940646565684,right,T2a,555,-4,9,8,1
720575940616895627,right,T2a,556,0,10,5,5
720575940612915478,right,T2a,557,6,-10,-11,1
720575940620858221,right,T2a,559,-6,22,17,5
720575940631940895,right,T2a,560,-7,14,14,0
720575940621813748,right,T2a,561,5,7,-2,9
720575940620073711,right,T2a,562,-5,-2,4,-6
720575940626366526,right,T2a,563,5,-13,-12,-1
720575940624389193,right,T2a,564,3,-23,-15,-8
720575940624374601,right,T2a,565,0,-26,-13,-13
720575940627305487,right,T2a,566,5,-8,-9,1
720575940638314462,right,T2a,567,-2,22,13,9
720575940617339353,right,T2a,568,-6,-8,2,-10
720575940621413766,right,T2a,569,6,6,-3,9
720575940635294560,right,T2a,570,2,25,10,15
720575940622351338,right,T2a,571,0,-14,-7,-7
720575940633052314,right,T2a,572,-8,3,9,-6
720575940626820604,right,T2a,573,4,14,3,11
720575940639661952,right,T2a,574,-6,5,8,-3
720575940621999393,right,T2a,575,6,9,-2,11
720575940622244009,right,T2a,576,0,28,14,14
720575940640518797,right,T2a,577,5,-14,-12,-2
720575940621558000,right,T2a,578,4,-11,-10,-1
720575940620915809,right,T2a,579,-3,-10,-2,-8
720575940632738095,right,T2a,580,-2,-23,-10,-13
720575940631366979,right,T2a,581,3,9,1,8
720575940621879792,right,T2a,582,-1,23,12,11
720575940633262509,right,T2a,583,3,-25,-16,-9
720575940628589329,right,T2a,584,4,23,7,16
720575940623325951,right,T2a,585,-1,-23,-11,-12
720575940629179898,right,T2a,586,2,18,7,11
720575940613178265,right,T2a,588,1,4,1,3
720575940639165493,right,T2a,589,-1,-5,-2,-3
720575940643084488,right,T2a,590,1,9,3,6
720575940619180923,right,T2a,591,3,-3,-5,2
720575940626949647,right,T2a,593,3,-14,-10,-4
720575940623252521,right,T2a,594,7,-16,-15,-1
720575940628814391,right,T2a,595,7,-12,-13,1
720575940612857651,right,T2a,596,-4,-16,-4,-12
720575940632881709,right,T2a,597,4,1,-4,5
720575940602572768,right,T2a,598,2,-18,-11,-7
720575940605759776,right,T2a,599,-1,9,5,4
720575940631695315,right,T2a,600,3,-10,-8,-2
720575940626398252,right,T2a,601,1,16,7,9
720575940613192173,right,T2a,602,4,-2,-5,3
720575940632994989,right,T2a,603,-3,-23,-9,-14
720575940606056126,right,T2a,604,-6,-17,-3,-14
720575940636568943,right,T2a,605,3,15,4,11
720575940616989627,right,T2a,606,-1,-19,-9,-10
720575940627336530,right,T2a,607,1,18,8,10
720575940610694314,right,T2a,608,1,10,4,6
720575940632233517,right,T2a,609,-2,0,2,-2
720575940630958732,right,T2a,611,-1,-18,-8,-10
720575940632607652,right,T2a,612,-3,-26,-10,-16
720575940631270444,right,T2a,613,-8,-4,6,-10
720575940612429018,right,T2a,614,-2,-8,-2,-6
720575940609269771,right,T2a,615,-7,-7,3,-10
720575940612560537,right,T2a,616,-3,15,10,5
720575940618728277,right,T2a,617,-2,-17,-7,-10
720575940617134011,right,T2a,618,-1,24,13,11
720575940625442649,right,T2a,619,-4,-19,-6,-13
720575940620200283,right,T2a,620,7,1,-7,8
720575940613976301,right,T2a,621,1,24,11,13
720575940643855304,right,T2a,622,-5,20,15,5
720575940614682986,right,T2a,623,1,13,5,8
720575940619955915,right,T2a,624,1,-17,-10,-7
720575940618198811,right,T2a,625,-2,24,14,10
720575940630118144,right,T2a,626,-5,-8,1,-9
720575940621067525,right,T2a,627,0,-1,-1,0
720575940623862676,right,T2a,628,0,0,0,0
720575940623182349,right,T2a,629,4,24,8,16
720575940606684802,right,T2a,630,4,8,0,8
720575940614833314,right,T2a,631,1,26,12,14
720575940626765693,right,T2a,632,3,-20,-13,-7
720575940618378333,right,T2a,633,-1,-24,-11,-13
720575940636867440,right,T2a,634,-3,-15,-5,-10
720575940616835701,right,T2a,635,6,-6,-9,3
720575940608730379,right,T2a,636,0,6,3,3
720575940611407843,right,T2a,637,3,-21,-14,-7
720575940623443469,right,T2a,638,-1,7,4,3
720575940628402929,right,T2a,639,-4,19,13,6
720575940628693839,right,T2a,640,-1,-16,-7,-9
720575940625043179,right,T2a,641,-8,-5,5,-10
720575940626490908,right,T2a,642,-5,-11,-1,-10
720575940612166835,right,T2a,643,6,14,1,13
720575940632365383,right,T2a,644,-6,18,15,3
720575940614688766,right,T2a,645,-4,27,17,10
720575940628943463,right,T2a,647,-4,-7,0,-7
720575940632616078,right,T2a,648,1,7,2,5
720575940621589836,right,T2a,649,-1,5,3,2
720575940615721845,right,T2a,651,-4,-5,1,-6
720575940629954876,right,T2a,652,-6,-11,0,-11
720575940630902957,right,T2a,653,-6,-12,0,-12
720575940613235123,right,T2a,654,-3,8,7,1
720575940632515553,right,T2a,655,6,-1,-7,6
720575940624508819,right,T2a,656,0,-11,-6,-5
720575940626227504,right,T2a,657,-2,-25,-11,-14
720575940622758071,right,T2a,658,1,20,9,11
720575940640143744,right,T2a,659,-4,-6,1,-7
720575940614628007,right,T2a,660,2,28,12,16
720575940646110852,right,T2a,661,-3,14,10,4
720575940627244561,right,T2a,662,2,-1,-3,2
720575940637770473,right,T2a,663,0,8,4,4
720575940627215891,right,T2a,664,1,-27,-15,-12
720575940620343489,right,T2a,665,7,-2,-8,6
720575940612322417,right,T2a,666,7,-13,-14,1
720575940632529962,right,T2a,667,1,-28,-15,-13
720575940610329976,right,T2a,668,1,19,8,11
720575940609496782,right,T2a,669,4,-16,-12,-4
720575940620330832,right,T2a,670,5,5,-3,8
720575940617938077,right,T2a,671,-4,-23,-8,-15
720575940611248760,right,T2a,672,-8,11,13,-2
720575940638331206,right,T2a,673,2,5,0,5
720575940624878119,right,T2a,674,-4,-14,-3,-11
720575940615263199,right,T2a,675,-7,19,16,3
720575940631220495,right,T2a,676,-3,-21,-8,-13
720575940633123228,right,T2a,677,0,11,5,6
720575940628656231,right,T2a,678,3,-7,-7,0
720575940623000269,right,T2a,679,4,18,5,13
720575940617893981,right,T2a,680,-1,25,13,12
720575940618547897,right,T2a,681,-2,-21,-9,-12
720575940632583588,right,T2a,682,6,-8,-10,2
720575940639385149,right,T2a,683,2,6,1,5
720575940629709438,right,T2a,684,-6,17,14,3
720575940625982792,right,T2a,685,-5,-9,0,-9
720575940604952544,right,T2a,686,5,-22,-16,-6
720575940638316084,right,T2a,687,-6,-3,4,-7
720575940626428179,right,T2a,688,-7,10,12,-2
720575940613720239,right,T2a,689,-2,18,11,7
720575940628075281,right,T2a,690,-7,-3,5,-8
720575940631821871,right,T2a,691,-9,4,11,-7
720575940619132726,right,T2a,692,-4,24,16,8
720575940617732820,right,T2a,693,-3,25,15,10
720575940621693633,right,T2a,694,4,3,-3,6
720575940624633639,right,T2a,695,-6,10,11,-1
720575940625314352,right,T2a,696,-2,16,10,6
720575940642564749,right,T2a,698,6,-7,-10,3
720575940613617002,right,T2a,699,-5,0,5,-5
720575940617656404,right,T2a,700,5,15,2,13
720575940628456574,right,T2a,701,0,-4,-2,-2
720575940614845330,right,T2a,702,-5,23,16,7
720575940614660511,right,T2a,703,-3,1,3,-2
720575940620570989,right,T2a,704,-7,8,11,-3
720575940659819137,right,T2a,705,1,1,-1,2
720575940629354737,right,T2a,706,-7,-12,1,-13
720575940627505746,right,T2a,707,-2,25,14,11
720575940643689160,right,T2a,710,4,-25,-17,-8
720575940636717742,right,T2a,711,-1,19,10,9
720575940630418683,right,T2a,712,-7,12,13,-1
720575940623066153,right,T2a,713,-6,16,14,2
720575940625688250,right,T2a,714,5,12,1,11
720575940616027714,right,T2a,715,4,10,1,9
720575940619844811,right,T2a,716,4,-6,-7,1
720575940635715508,right,T2a,717,2,-22,-13,-9
720575940621984589,right,T2a,718,-5,24,17,7
720575940622663548,right,T2a,719,1,27,12,15
720575940622024013,right,T2a,720,-5,21,15,6
720575940623276046,right,T2a,721,5,13,1,12
720575940627725957,right,T2a,722,6,-15,-14,-1
720575940624758986,right,T2a,723,-2,-11,-4,-7
720575940627336553,right,T2a,724,4,2,-3,5
720575940627457850,right,T2a,725,-3,-24,-9,-15
720575940638098404,right,T2a,726,2,-28,-16,-12
720575940622180684,right,T2a,728,7,12,-1,13
720575940625157875,right,T2a,729,-3,29,17,12
720575940623432682,right,T2a,730,7,0,-7,7
720575940624980723,right,T2a,731,-6,9,10,-1
720575940634856555,right,T2a,732,-3,6,6,0
720575940627425157,right,T2a,733,-5,-17,-4,-13
720575940634948856,right,T2a,734,2,0,-2,2
720575940634785119,right,T2a,735,1,-23,-13,-10
720575940624686060,right,T2a,736,-8,1,8,-7
720575940626418819,right,T2a,737,0,19,9,10
720575940640760960,right,T2a,738,-3,13,9,4
720575940617066708,right,T2a,739,-7,2,8,-6
720575940625731842,right,T2a,740,2,-8,-6,-2
720575940605682976,right,T2a,741,-2,-14,-5,-9
720575940624578062,right,T2a,742,-4,11,9,2
720575940607265410,right,T2a,744,-4,25,16,9
720575940608943369,right,T2a,745,0,13,6,7
720575940611745962,right,T2a,746,-3,3,4,-1
720575940614740546,right,T2a,747,0,2,1,1
720575940622118313,right,T2a,748,-4,20,14,6
720575940616908033,right,T2a,749,-2,1,2,-1
720575940630698044,right,T2a,750,4,-24,-16,-8
720575940625394064,right,T2a,751,1,6,2,4
720575940627927300,right,T2a,752,-2,7,5,2
720575940633501326,right,T2a,753,-3,24,15,9
720575940624838636,right,T2a,754,-1,-13,-6,-7
720575940622946282,right,T2a,755,4,19,5,14
720575940621759356,right,T2a,756,5,20,5,15
720575940622832734,right,T2a,757,0,-6,-3,-3
720575940617461538,right,T2a,758,5,-1,-6,5
720575940646488372,right,T2a,759,7,14,0,14
720575940617192081,right,T2a,760,0,17,8,9
720575940624154887,right,T2a,761,-4,-18,-5,-13
720575940628350632,right,T2a,762,0,14,7,7
720575940633857934,right,T2a,763,-5,14,12,2
720575940630281436,right,T2a,764,-8,-6,5,-11
720575940631910979,right,T2a,765,-3,9,7,2
720575940626816649,right,T2a,766,2,-4,-4,0
720575940605760945,right,T2a,767,1,28,13,15
720575940632335780,right,T2a,768,3,5,-1,6
720575940620135504,right,T2a,770,5,4,-3,7
720575940617750562,right,T2a,771,3,-27,-17,-10
720575940625003341,right,T2a,772,1,12,5,7
720575940626026298,right,T2a,773,5,-19,-15,-4
720575940642187680,right,T2a,774,-8,6,11,-5
720575940613757736,right,T2a,775,5,22,6,16
720575940639506083,right,T2a,776,5,21,5,16
720575940621758588,right,T2a,777,6,20,4,16
720575940617847675,right,T2a,778,4,25,8,17
720575940616452914,right,T2a,780,-6,25,18,7
720575940618219009,right,T2a,781,-5,26,18,8
720575940620319309,right,T2a,782,-5,27,18,9
720575940612820850,right,T2a,783,-4,28,18,10
720575940618400837,right,T2a,784,-4,29,18,11
720575940640402851,right,T2a,785,-3,30,18,12
720575940639926643,right,T2a,786,-2,30,17,13
720575940630714332,right,T2a,787,3,28,11,17
720575940617703261,right,T2a,788,3,27,10,17
720575940628401285,right,T2a,790,-2,-27,-12,-15
720575940635496087,right,T2a,791,-1,-28,-13,-15
720575940636375988,right,T2a,792,8,2,-7,9
720575940613625128,right,T2a,794,5,-26,-18,-8
720575940617643665,right,T2a,795,6,-21,-17,-4
720575940632131403,right,T2a,796,4,26,9,17
720575940634792858,right,T3,1,-6,13,12,1
720575940626807098,right,T3,2,-8,2,9,-7
720575940628083016,right,T3,3,6,-12,-12,0
720575940619450072,right,T3,4,-5,-21,-6,-15
720575940642463373,right,T3,5,-1,16,9,7
720575940640052864,right,T3,6,-2,-4,0,-4
720575940629794304,right,T3,7,-6,-6,3,-9
720575940630112768,right,T3,8,-4,26,17,9
720575940605384992,right,T3,9,4,9,0,9
720575940614385960,right,T3,10,5,-15,-13,-2
720575940618286420,right,T3,11,7,-14,-14,0
720575940642561243,right,T3,12,-7,9,11,-2
720575940617477561,right,T3,13,-1,-26,-12,-14
720575940615611531,right,T3,14,0,-27,-14,-13
720575940636903401,right,T3,15,2,-3,-4,1
720575940604519014,right,T3,16,-2,-16,-6,-10
720575940626491032,right,T3,17,1,-5,-4,-1
720575940613188835,right,T3,18,5,-16,-13,-3
720575940622890189,right,T3,19,-7,17,15,2
720575940619896779,right,T3,20,3,-11,-9,-2
720575940622908916,right,T3,21,-2,19,11,8
720575940630333381,right,T3,22,-1,3,2,1
720575940628249799,right,T3,23,-3,-16,-5,-11
720575940615111318,right,T3,24,-1,-10,-4,-6
720575940605270816,right,T3,25,-9,3,10,-7
720575940619085642,right,T3,26,1,-3,-3,0
720575940626333370,right,T3,27,0,-25,-13,-12
720575940632881453,right,T3,28,5,6,-2,8
720575940626885501,right,T3,29,-1,-3,-1,-2
720575940618172224,right,T3,31,0,16,8,8
720575940622944588,right,T3,32,0,12,6,6
720575940639912536,right,T3,33,3,18,6,12
720575940627547665,right,T3,34,6,18,3,15
720575940617805969,right,T3,35,1,-24,-13,-11
720575940622545629,right,T3,36,6,8,-2,10
720575940622342499,right,T3,37,1,5,1,4
720575940628735899,right,T3,38,0,-2,-1,-1
720575940606454705,right,T3,39,0,20,10,10
720575940635973743,right,T3,40,-2,-6,-1,-5
720575940628382026,right,T3,41,-3,28,17,11
720575940633343457,right,T3,42,-1,14,8,6
720575940627525246,right,T3,43,-5,18,14,4
720575940625998925,right,T3,44,5,-10,-10,0
720575940639357136,right,T3,45,-5,-1,4,-5
720575940631688515,right,T3,46,-5,15,12,3
720575940640733043,right,T3,48,-4,-22,-7,-15
720575940615047166,right,T3,49,4,-4,-6,2
720575940627456901,right,T3,50,-2,21,12,9
720575940628673871,right,T3,51,0,-19,-10,-9
720575940607182466,right,T3,52,-1,-22,-10,-12
720575940630179287,right,T3,53,5,14,2,12
720575940614546578,right,T3,54,-4,3,5,-2
720575940604968108,right,T3,55,-4,-11,-2,-9
720575940626995471,right,T3,56,1,-13,-8,-5
720575940630344748,right,T3,57,6,-11,-12,1
720575940618904653,right,T3,58,3,12,3,9
720575940617040418,right,T3,59,-2,2,3,-1
720575940622379594,right,T3,61,-4,-4,2,-6
720575940612634341,right,T3,63,4,12,2,10
720575940622159348,right,T3,64,4,-23,-16,-7
720575940629333403,right,T3,65,-1,28,15,13
720575940629112394,right,T3,66,2,15,5,10
720575940605072300,right,T3,67,-2,-13,-5,-8
720575940620225473,right,T3,68,3,16,5,11
720575940622744327,right,T3,69,1,8,3,5
720575940617277401,right,T3,70,-4,21,14,7
720575940642471988,right,T3,71,-2,-3,0,-3
720575940631770639,right,T3,72,0,-28,-14,-14
720575940642958132,right,T3,73,2,2,-1,3
720575940627051535,right,T3,74,-1,-9,-4,-5
720575940624236296,right,T3,75,-6,14,13,1
720575940619843486,right,T3,76,-3,-4,1,-5
720575940637432944,right,T3,77,2,-5,-5,0
720575940614720296,right,T3,78,2,20,8,12
720575940629569018,right,T3,79,2,1,-2,3
720575940608071004,right,T3,80,4,13,2,11
720575940626512412,right,T3,81,6,-2,-7,5
720575940626972478,right,T3,82,-7,7,10,-3
720575940616884619,right,T3,83,2,-21,-13,-8
720575940610938586,right,T3,84,-2,12,8,4
720575940632716088,right,T3,85,4,-22,-15,-7
720575940621145204,right,T3,86,-5,-7,1,-8
720575940622980393,right,T3,87,1,11,4,7
720575940635150443,right,T3,88,7,4,-5,9
720575940630801090,right,T3,89,1,-19,-11,-8
720575940619965643,right,T3,90,-4,5,6,-1
720575940616677830,right,T3,91,-1,6,4,2
720575940626444844,right,T3,92,0,9,4,5
720575940638701877,right,T3,93,-6,3,7,-4
720575940638704454,right,T3,95,4,-21,-15,-6
720575940631194386,right,T3,96,1,-10,-6,-4
720575940635098743,right,T3,97,-5,2,6,-4
720575940622178940,right,T3,98,-1,-12,-5,-7
720575940623782985,right,T3,99,4,15,3,12
720575940609928260,right,T3,100,2,-10,-7,-3
720575940644331031,right,T3,101,-7,6,10,-4
720575940618198336,right,T3,102,3,13,3,10
720575940615342239,right,T3,103,7,9,-3,12
720575940636266341,right,T3,106,-7,11,12,-1
720575940630601723,right,T3,107,8,-2,-9,7
720575940627474490,right,T3,108,-3,-12,-3,-9
720575940615873036,right,T3,109,4,-5,-7,2
720575940628304656,right,T3,110,-7,0,7,-7
720575940625042675,right,T3,111,2,-24,-14,-10
720575940623053715,right,T3,112,-6,1,6,-5
720575940616371771,right,T3,113,-2,4,4,0
720575940626979855,right,T3,114,2,-13,-9,-4
720575940622641159,right,T3,115,-4,2,5,-3
720575940632615711,right,T3,116,-1,-8,-3,-5
720575940639288637,right,T3,117,-8,-2,7,-9
720575940618090821,right,T3,118,3,1,-3,4
720575940630677323,right,T3,119,-2,6,5,1
720575940638480948,right,T3,120,-1,-1,0,-1
720575940627221036,right,T3,121,-8,4,10,-6
720575940633908110,right,T3,122,-5,9,9,0
720575940627579665,right,T3,123,-8,10,13,-3
720575940637516685,right,T3,124,1,-7,-5,-2
720575940628777731,right,T3,125,5,9,-1,10
720575940624541623,right,T3,126,3,11,2,9
720575940626716824,right,T3,127,0,15,7,8
720575940640997517,right,T3,128,3,-22,-14,-8
720575940619822171,right,T3,129,0,-13,-7,-6
720575940628324201,right,T3,130,2,12,4,8
720575940609040597,right,T3,131,-6,20,16,4
720575940622935293,right,T3,132,2,4,0,4
720575940624301320,right,T3,133,-3,20,13,7
720575940630480911,right,T3,134,-5,-18,-4,-14
720575940619283510,right,T3,135,-3,-22,-8,-14
720575940623877052,right,T3,136,0,3,1,2
720575940620627547,right,T3,137,5,-7,-9,2
720575940630201978,right,T3,138,0,27,13,14
720575940627058703,right,T3,139,1,-14,-8,-6
720575940623641351,right,T3,140,3,8,1,7
720575940635245759,right,T3,141,5,-23,-17,-6
720575940622651357,right,T3,142,-2,-18,-7,-11
720575940636472542,right,T3,143,-4,16,12,4
720575940620130865,right,T3,144,7,-11,-13,2
720575940620776959,right,T3,145,0,4,2,2
720575940646151715,right,T3,146,1,-6,-4,-2
720575940630293303,right,T3,147,1,21,9,12
720575940628829443,right,T3,148,-7,-11,1,-12
720575940625520217,right,T3,149,6,-14,-13,-1
720575940629602108,right,T3,150,-8,5,10,-5
720575940626193470,right,T3,151,-3,-14,-4,-10
720575940626917903,right,T3,152,3,-15,-11,-4
720575940626269989,right,T3,153,8,0,-8,8
720575940622411021,right,T3,154,-8,0,8,-8
720575940627046671,right,T3,157,-1,-7,-3,-4
720575940636480174,right,T3,158,3,-5,-6,1
720575940608004035,right,T3,159,7,7,-4,11
720575940627753020,right,T3,160,-2,20,12,8
720575940626979087,right,T3,161,4,-14,-11,-3
720575940605775294,right,T3,162,-4,-2,3,-5
720575940624296230,right,T3,164,-1,-2,0,-2
720575940619758215,right,T3,165,4,16,4,12
720575940628357126,right,T3,166,0,18,9,9
720575940619302278,right,T3,167,0,-17,-9,-8
720575940630984267,right,T3,168,-1,17,9,8
720575940627829781,right,T3,169,0,-18,-9,-9
720575940611739571,right,T3,170,-5,1,5,-4
720575940621597167,right,T3,171,6,-20,-16,-4
720575940609042901,right,T3,172,1,22,10,12
720575940638716230,right,T3,174,4,-15,-12,-3
720575940623971509,right,T3,175,-6,-7,2,-9
720575940625281771,right,T3,176,-2,13,8,5
720575940643260360,right,T3,177,-2,-1,1,-2
720575940606709890,right,T3,178,2,11,3,8
720575940621339568,right,T3,179,-5,-16,-3,-13
720575940608674908,right,T3,180,2,-27,-16,-11
720575940637639822,right,T3,181,1,-4,-3,-1
720575940618657616,right,T3,182,7,-10,-12,2
720575940630159404,right,T3,184,-6,-5,3,-8
720575940621025389,right,T3,185,2,-11,-8,-3
720575940624864007,right,T3,186,-1,26,14,12
720575940627860808,right,T3,187,3,21,7,14
720575940620244139,right,T3,188,-5,17,13,4
720575940620343089,right,T3,189,6,13,0,13
720575940623905287,right,T3,190,-3,-5,0,-5
720575940635204975,right,T3,191,-1,-11,-5,-6
720575940623865614,right,T3,192,7,10,-2,12
720575940637521641,right,T3,193,-5,4,7,-3
720575940631282681,right,T3,194,0,-5,-3,-2
720575940628759596,right,T3,195,-3,-1,2,-3
720575940616993885,right,T3,196,-1,8,5,3
720575940636693678,right,T3,197,0,-20,-10,-10
720575940637309303,right,T3,198,6,2,-5,7
720575940627054095,right,T3,199,0,-12,-6,-6
720575940613014243,right,T3,200,-5,12,11,1
720575940631013071,right,T3,202,-1,27,14,13
720575940614742322,right,T3,203,3,-1,-4,3
720575940624119846,right,T3,204,5,-2,-6,4
720575940627400250,right,T3,205,5,-6,-8,2
720575940629162695,right,T3,206,-3,5,5,0
720575940639690659,right,T3,208,5,-21,-16,-5
720575940619738827,right,T3,209,-3,-8,-1,-7
720575940633928078,right,T3,210,-6,8,10,-2
720575940619712085,right,T3,211,-7,-1,6,-7
720575940640514419,right,T3,212,2,-16,-10,-6
720575940626540828,right,T3,213,3,-4,-5,1
720575940618206021,right,T3,214,-5,3,6,-3
720575940629624446,right,T3,215,6,7,-3,10
720575940616832373,right,T3,216,2,19,7,12
720575940614153026,right,T3,217,6,15,1,14
720575940627177004,right,T3,218,2,10,3,7
720575940622153084,right,T3,219,6,-4,-8,4
720575940643739552,right,T3,220,2,-6,-5,-1
720575940606741682,right,T3,221,-7,3,8,-5
720575940633787873,right,T3,222,-3,26,16,10
720575940633740569,right,T3,223,-2,26,15,11
720575940632543886,right,T3,224,0,5,2,3
720575940638430271,right,T3,225,2,-26,-15,-11
720575940605353062,right,T3,226,5,19,4,15
720575940625525054,right,T3,227,-7,5,9,-4
720575940614723234,right,T3,228,-7,1,7,-6
720575940642773044,right,T3,229,5,2,-4,6
720575940623149692,right,T3,230,2,9,2,7
720575940632960045,right,T3,231,4,-12,-10,-2
720575940628888731,right,T3,232,-4,13,10,3
720575940622302335,right,T3,233,4,-13,-11,-2
720575940619651894,right,T3,234,1,3,0,3
720575940621637470,right,T3,235,4,11,1,10
720575940619611096,right,T3,236,-1,4,3,1
720575940631625258,right,T3,237,-2,27,15,12
720575940630741241,right,T3,238,-8,-3,6,-9
720575940633938574,right,T3,239,-6,6,9,-3
720575940626341916,right,T3,240,-4,-3,2,-5
720575940634723007,right,T3,241,2,-17,-11,-6
720575940633802638,right,T3,242,-4,6,7,-1
720575940607614933,right,T3,243,-1,-21,-10,-11
720575940622209574,right,T3,244,-4,-12,-2,-10
720575940635252831,right,T3,245,-5,-3,3,-6
720575940634517017,right,T3,246,-4,15,11,4
720575940626833234,right,T3,247,-4,-15,-4,-11
720575940617337089,right,T3,248,-6,0,6,-6
720575940627059471,right,T3,249,2,-12,-8,-4
720575940619702955,right,T3,250,-1,1,1,0
720575940613021810,right,T3,252,3,23,8,15
720575940637091758,right,T3,254,3,-24,-15,-9
720575940633721058,right,T3,255,-6,-13,-1,-12
720575940624097357,right,T3,256,5,-20,-15,-5
720575940645124388,right,T3,257,2,21,8,13
720575940631755320,right,T3,258,-4,-17,-5,-12
720575940652333814,right,T3,260,-3,19,12,7
720575940620165285,right,T3,261,-1,13,7,6
720575940632096583,right,T3,262,1,-11,-7,-4
720575940635811184,right,T3,263,-3,4,5,-1
720575940626903311,right,T3,264,-1,-6,-2,-4
720575940627319683,right,T3,265,-6,-1,5,-6
720575940639371317,right,T3,266,-1,-25,-12,-13
720575940609475140,right,T3,267,-6,2,7,-5
720575940626085157,right,T3,268,7,-6,-10,4
720575940616032710,right,T3,269,2,-19,-12,-7
720575940618518969,right,T3,270,1,-8,-5,-3
720575940632527149,right,T3,271,4,6,-1,7
720575940627033993,right,T3,272,3,-2,-4,2
720575940631730499,right,T3,273,-6,23,17,6
720575940643647028,right,T3,274,6,4,-4,8
720575940619298520,right,T3,275,-8,-1,7,-8
720575940639720253,right,T3,276,2,3,-1,4
720575940605666662,right,T3,277,7,-3,-9,6
720575940621476336,right,T3,278,-5,10,10,0
720575940629496954,right,T3,279,-4,8,8,0
720575940611701978,right,T3,281,-9,2,10,-8
720575940610782766,right,T3,282,0,26,13,13
720575940624452685,right,T3,283,-4,4,6,-2
720575940624688056,right,T3,284,0,25,12,13
720575940633715667,right,T3,285,6,-18,-15,-3
720575940634096496,right,T3,286,0,-24,-12,-12
720575940611895770,right,T3,287,-5,13,11,2
720575940620367854,right,T3,289,-1,11,6,5
720575940625720778,right,T3,291,7,2,-6,8
720575940613453458,right,T3,292,-4,18,13,5
720575940623000456,right,T3,293,4,-17,-13,-4
720575940621723909,right,T3,294,1,-20,-11,-9
720575940619466587,right,T3,295,-2,29,16,13
720575940624204237,right,T3,296,1,-18,-10,-8
720575940613610346,right,T3,298,-5,5,7,-2
720575940625906253,right,T3,299,-4,12,10,2
720575940617282777,right,T3,300,4,-18,-13,-5
720575940613490026,right,T3,301,-5,16,13,3
720575940611092946,right,T3,302,2,17,6,11
720575940627059608,right,T3,303,-5,22,16,6
720575940622265162,right,T3,304,6,5,-4,9
720575940624158100,right,T3,305,-7,4,9,-5
720575940633386721,right,T3,306,3,7,0,7
720575940640198864,right,T3,308,-5,8,9,-1
720575940631428419,right,T3,309,-6,12,12,0
720575940620395456,right,T3,310,2,22,9,13
720575940608991957,right,T3,311,-7,15,14,1
720575940628104135,right,T3,312,4,-7,-8,1
720575940632750623,right,T3,313,7,3,-6,9
720575940630841431,right,T3,314,-9,5,11,-6
720575940605706686,right,T3,315,-3,-6,0,-6
720575940619296960,right,T3,316,5,-4,-7,3
720575940628985387,right,T3,317,-5,-4,3,-7
720575940623604458,right,T3,318,4,-19,-14,-5
720575940642942004,right,T3,319,-2,5,4,1
720575940638628669,right,T3,320,-2,-5,-1,-4
720575940639396174,right,T3,323,-7,-13,0,-13
720575940632017208,right,T3,324,3,24,9,15
720575940626081466,right,T3,325,5,1,-5,6
720575940621638750,right,T3,326,2,16,6,10
720575940606099377,right,T3,327,5,3,-4,7
720575940605717792,right,T3,328,5,-9,-10,1
720575940621278273,right,T3,329,0,24,12,12
720575940622442495,right,T3,330,3,3,-2,5
720575940621292208,right,T3,331,1,-15,-9,-6
720575940630335223,right,T3,332,4,-26,-17,-9
720575940613138328,right,T3,333,0,-21,-11,-10
720575940653463798,right,T3,334,1,-26,-14,-12
720575940629562873,right,T3,335,2,8,2,6
720575940609042645,right,T3,336,0,23,11,12
720575940606803401,right,T3,337,-5,-6,2,-8
720575940614526431,right,T3,338,-1,0,1,-1
720575940619848533,right,T3,340,-4,17,12,5
720575940623125518,right,T3,341,6,-17,-15,-2
720575940626972687,right,T3,342,2,-15,-10,-5
720575940642285453,right,T3,343,-3,27,16,11
720575940606999497,right,T3,344,-2,-15,-6,-9
720575940619396998,right,T3,345,3,-12,-9,-3
720575940636420270,right,T3,346,-7,-9,2,-11
720575940615255618,right,T3,347,-5,-13,-2,-11
720575940626010826,right,T3,348,3,14,4,10
720575940617293785,right,T3,350,1,15,6,9
720575940606488510,right,T3,351,-1,-17,-8,-9
720575940624143916,right,T3,352,-2,28,16,12
720575940627394181,right,T3,353,2,24,10,14
720575940621276609,right,T3,354,-2,-26,-11,-15
720575940630316538,right,T3,355,-7,-6,4,-10
720575940611801720,right,T3,356,0,22,11,11
720575940641233115,right,T3,357,4,17,4,13
720575940634897503,right,T3,358,-3,17,11,6
720575940624065357,right,T3,359,2,23,9,14
720575940624750887,right,T3,360,-5,19,14,5
720575940627784264,right,T3,361,0,-7,-4,-3
720575940620917357,right,T3,362,2,-20,-12,-8
720575940617402229,right,T3,363,7,-4,-9,5
720575940612225194,right,T3,364,4,4,-2,6
720575940618651446,right,T3,365,4,7,-1,8
720575940635388046,right,T3,368,-4,-20,-6,-14
720575940625856381,right,T3,369,5,-5,-8,3
720575940612489625,right,T3,370,-3,21,13,8
720575940631407179,right,T3,371,6,-5,-9,4
720575940645661731,right,T3,372,1,-2,-2,0
720575940618101465,right,T3,373,1,-21,-12,-9
720575940626970387,right,T3,374,2,13,4,9
720575940632665508,right,T3,375,-6,7,9,-2
720575940624289516,right,T3,377,0,7,3,4
720575940605783840,right,T3,378,-3,18,12,6
720575940620926317,right,T3,379,3,-17,-12,-5
720575940612778213,right,T3,380,-1,29,15,14
720575940639038542,right,T3,381,-8,-9,3,-12
720575940631418666,right,T3,382,3,-6,-6,0
720575940615379778,right,T3,383,-6,11,11,0
720575940628940623,right,T3,384,-6,-2,5,-7
720575940624601126,right,T3,385,-3,-18,-6,-12
720575940634873054,right,T3,386,-6,19,15,4
720575940627964181,right,T3,387,-1,-15,-7,-8
720575940631185782,right,T3,388,3,19,6,13
720575940611604082,right,T3,389,-6,-16,-2,-14
720575940614095667,right,T3,390,-6,-9,1,-10
720575940620153816,right,T3,391,4,-3,-6,3
720575940626586645,right,T3,392,-4,7,7,0
720575940626818348,right,T3,393,-1,22,12,10
720575940629183985,right,T3,394,-7,-8,3,-11
720575940612541081,right,T3,395,0,-22,-11,-11
720575940644582423,right,T3,396,-1,10,6,4
720575940627768853,right,T3,397,-3,-19,-7,-12
720575940623500070,right,T3,398,-3,22,14,8
720575940635850608,right,T3,400,1,-29,-16,-13
720575940602401214,right,T3,401,-2,-19,-8,-11
720575940616483487,right,T3,402,3,26,10,16
720575940641349840,right,T3,403,-2,-12,-4,-8
720575940623413995,right,T3,404,-1,20,11,9
720575940632293191,right,T3,405,3,10,2,8
720575940620880987,right,T3,406,1,-25,-14,-11
720575940614098995,right,T3,407,-5,-10,0,-10
720575940623246550,right,T3,408,-6,-4,4,-8
720575940641331764,right,T3,409,0,-3,-2,-1
720575940623915271,right,T3,410,-2,-2,1,-3
720575940621299120,right,T3,412,-6,21,16,5
720575940617370297,right,T3,413,-2,-7,-2,-5
720575940617374950,right,T3,414,4,21,6,15
720575940619562968,right,T3,416,3,-8,-7,-1
720575940639799203,right,T3,417,-6,-10,1,-11
720575940632505683,right,T3,418,-2,15,9,6
720575940630951484,right,T3,419,-3,-11,-3,-8
720575940627661711,right,T3,420,6,-3,-8,5
720575940617744798,right,T3,421,-1,12,7,5
720575940623329535,right,T3,423,3,-18,-12,-6
720575940628484092,right,T3,424,-3,-2,2,-4
720575940610760824,right,T3,425,3,20,7,13
720575940620319727,right,T3,426,-3,0,3,-3
720575940627148047,right,T3,427,5,-18,-14,-4
720575940627794449,right,T3,428,-2,23,13,10
720575940638903869,right,T3,429,-2,14,9,5
720575940628004072,right,T3,430,-3,-7,-1,-6
720575940623906567,right,T3,431,-2,-10,-3,-7
720575940622857909,right,T3,432,-5,7,8,-1
720575940612241370,right,T3,433,0,-8,-4,-4
720575940615051158,right,T3,434,-3,7,6,1
720575940626980623,right,T3,435,5,-17,-14,-3
720575940623267210,right,T3,436,0,-15,-8,-7
720575940617689428,right,T3,437,-3,12,9,3
720575940626871596,right,T3,438,2,27,11,16
720575940622512342,right,T3,439,-3,-9,-2,-7
720575940626290732,right,T3,440,1,23,10,13
720575940626930191,right,T3,441,3,-16,-11,-5
720575940606913481,right,T3,442,-5,25,17,8
720575940608085513,right,T3,443,-6,4,8,-4
720575940640149376,right,T3,444,4,-10,-9,-1
720575940633232610,right,T3,445,-2,8,6,2
720575940621065933,right,T3,446,2,-14,-9,-5
720575940620925311,right,T3,447,-1,2,2,0
720575940621847832,right,T3,449,6,-16,-14,-2
720575940637975386,right,T3,450,2,-9,-7,-2
720575940605479870,right,T3,451,4,20,6,14
720575940627784520,right,T3,452,1,-9,-6,-3
720575940627877735,right,T3,453,3,25,9,16
720575940620642182,right,T3,454,5,-12,-11,-1
720575940627007896,right,T3,455,7,-7,-11,4
720575940626965292,right,T3,456,0,21,10,11
720575940625757328,right,T3,457,-2,17,10,7
720575940608313948,right,T3,458,5,0,-5,5
720575940627734788,right,T3,459,5,-3,-7,4
720575940635086617,right,T3,460,-3,-20,-7,-13
720575940635712119,right,T3,461,7,-5,-10,5
720575940635129963,right,T3,462,-1,18,10,8
720575940630952844,right,T3,464,4,0,-4,4
720575940632638884,right,T3,465,3,0,-3,3
720575940634918591,right,T3,466,1,14,6,8
720575940605671358,right,T3,467,-2,-20,-8,-12
720575940639374243,right,T3,468,-3,11,8,3
720575940623168297,right,T3,470,4,-9,-9,0
720575940622426906,right,T3,471,3,-26,-16,-10
720575940613005078,right,T3,472,1,25,11,14
720575940629191939,right,T3,473,-4,23,15,8
720575940613145767,right,T3,474,-3,-17,-6,-11
720575940625742780,right,T3,475,-4,-1,3,-4
720575940633174815,right,T3,476,-1,15,8,7
720575940627854217,right,T3,477,-3,2,4,-2
720575940627143994,right,T3,478,-7,16,15,1
720575940652371446,right,T3,479,-2,10,7,3
720575940626104613,right,T3,480,3,-19,-13,-6
720575940622253857,right,T3,481,4,-8,-8,0
720575940620312048,right,T3,482,1,17,7,10
720575940637536141,right,T3,483,2,-7,-6,-1
720575940626094885,right,T3,484,3,-9,-8,-1
720575940623697101,right,T3,485,-3,-3,1,-4
720575940622403976,right,T3,486,0,1,0,1
720575940621324833,right,T3,487,1,-1,-2,1
720575940612983011,right,T3,488,7,5,-5,10
720575940621611132,right,T3,489,-3,10,8,2
720575940617422849,right,T3,490,-5,6,8,-2
720575940615644319,right,T3,491,7,-1,-8,7
720575940629516282,right,T3,492,-7,-2,6,-8
720575940610668920,right,T3,493,-3,23,14,9
720575940623267208,right,T3,494,0,29,14,15
720575940624670648,right,T3,495,4,5,-2,7
720575940640054144,right,T3,496,7,8,-3,11
720575940616890944,right,T3,497,6,1,-6,7
720575940628424811,right,T3,498,6,10,-1,11
720575940615090079,right,T3,499,5,10,0,10
720575940627314703,right,T3,500,7,-8,-11,3
720575940634636514,right,T3,501,1,2,0,2
720575940617828609,right,T3,502,5,8,-1,9
720575940622310621,right,T3,503,3,17,5,12
720575940614745450,right,T3,504,-2,9,6,3
720575940636415966,right,T3,506,1,-12,-7,-5
720575940628602371,right,T3,507,-5,-12,-1,-11
720575940617285332,right,T3,508,-5,11,10,1
720575940622190276,right,T3,509,-4,10,9,1
720575940617036812,right,T3,510,-2,11,7,4
720575940627316751,right,T3,511,5,-11,-11,0
720575940627541265,right,T3,512,6,0,-6,6
720575940648594297,right,T3,513,-4,-13,-3,-10
720575940627006345,right,T3,514,-4,-10,-1,-9
720575940631329361,right,T3,515,-8,-7,4,-11
720575940621043532,right,T3,516,7,-18,-16,-2
720575940638903605,right,T3,517,6,3,-5,8
720575940632310087,right,T3,518,-4,22,15,7
720575940622028577,right,T3,519,-5,-5,2,-7
720575940608382556,right,T3,520,-2,-22,-9,-13
720575940636664432,right,T3,521,6,-9,-11,2
720575940639383896,right,T3,522,-4,0,4,-4
720575940616843579,right,T3,523,2,14,5,9
720575940631479909,right,T3,524,4,-20,-14,-6
720575940646468387,right,T3,525,-1,-20,-9,-11
720575940627036943,right,T3,526,0,-10,-5,-5
720575940614676018,right,T3,527,-4,-8,0,-8
720575940632584334,right,T3,528,2,7,1,6
720575940636801135,right,T3,529,2,-2,-3,1
720575940622728662,right,T3,530,-3,-13,-4,-9
720575940605111230,right,T3,531,1,0,-1,1
720575940619865441,right,T3,532,-8,7,11,-4
720575940620267655,right,T3,533,0,-16,-8,-8
720575940624132488,right,T3,534,3,2,-2,4
720575940639619645,right,T3,535,8,-4,-10,6
720575940643899808,right,T3,536,3,4,-1,5
720575940636995561,right,T3,537,0,-23,-12,-11
720575940632561633,right,T3,538,-4,1,4,-3
720575940623615751,right,T3,539,-6,15,13,2
720575940616161979,right,T3,540,-2,-9,-3,-6
720575940608549385,right,T3,541,-4,14,11,3
720575940613474710,right,T3,542,6,-13,-13,0
720575940630325366,right,T3,543,-1,-4,-1,-3
720575940619232448,right,T3,544,3,-13,-10,-3
720575940628247659,right,T3,545,5,11,0,11
720575940633483998,right,T3,546,3,6,0,6
720575940620579777,right,T3,547,-1,21,11,10
720575940632827219,right,T3,548,1,-16,-9,-7
720575940616785420,right,T3,549,0,-9,-5,-4
720575940635600247,right,T3,550,-2,3,3,0
720575940622823962,right,T3,551,-4,-9,-1,-8
720575940643512884,right,T3,552,4,-1,-5,4
720575940632408206,right,T3,553,-3,16,11,5
720575940627127866,right,T3,555,-4,9,8,1
720575940617657684,right,T3,556,0,10,5,5
720575940610519364,right,T3,557,6,-10,-11,1
720575940633969520,right,T3,558,-4,-21,-7,-14
720575940626362776,right,T3,560,-7,14,14,0
720575940626425116,right,T3,561,5,7,-2,9
720575940621765503,right,T3,562,-5,-2,4,-6
720575940627352591,right,T3,563,5,-13,-12,-1
720575940623522186,right,T3,564,3,-23,-15,-8
720575940637263790,right,T3,565,0,-26,-13,-13
720575940627275023,right,T3,566,5,-8,-9,1
720575940640725080,right,T3,567,-2,22,13,9
720575940629481835,right,T3,569,6,6,-3,9
720575940627490179,right,T3,571,0,-14,-7,-7
720575940615629398,right,T3,572,-8,3,9,-6
720575940637757929,right,T3,573,4,14,3,11
720575940625037607,right,T3,574,-6,5,8,-3
720575940616061627,right,T3,575,6,9,-2,11
720575940623545565,right,T3,576,0,28,14,14
720575940635604984,right,T3,577,5,-14,-12,-2
720575940619200670,right,T3,578,4,-11,-10,-1
720575940638374589,right,T3,579,-3,-10,-2,-8
720575940641271285,right,T3,580,-2,-23,-10,-13
720575940649439097,right,T3,581,3,9,1,8
720575940624160008,right,T3,582,-1,23,12,11
720575940633253971,right,T3,584,4,23,7,16
720575940618965918,right,T3,585,-1,-23,-11,-12
720575940623647159,right,T3,586,2,18,7,11
720575940626954109,right,T3,587,4,22,7,15
720575940629697835,right,T3,588,1,4,1,3
720575940627849896,right,T3,589,-1,-5,-2,-3
720575940644806600,right,T3,590,1,9,3,6
720575940622719237,right,T3,591,3,-3,-5,2
720575940629932818,right,T3,593,3,-14,-10,-4
720575940635105375,right,T3,594,7,-16,-15,-1
720575940627362831,right,T3,595,7,-12,-13,1
720575940636688526,right,T3,596,-4,-16,-4,-12
720575940622033228,right,T3,597,4,1,-4,5
720575940636030575,right,T3,598,2,-18,-11,-7
720575940629902018,right,T3,599,-1,9,5,4
720575940612472217,right,T3,600,3,-10,-8,-2
720575940622965542,right,T3,601,1,16,7,9
720575940626090242,right,T3,602,4,-2,-5,3
720575940614551806,right,T3,603,-3,-23,-9,-14
720575940619123870,right,T3,604,-6,-17,-3,-14
720575940612544790,right,T3,605,3,15,4,11
720575940631140764,right,T3,606,-1,-19,-9,-10
720575940633550562,right,T3,607,1,18,8,10
720575940644604183,right,T3,608,1,10,4,6
720575940629341484,right,T3,609,-2,0,2,-2
720575940628037141,right,T3,610,2,-23,-14,-9
720575940634344217,right,T3,611,-1,-18,-8,-10
720575940629956624,right,T3,612,-3,-26,-10,-16
720575940612630963,right,T3,613,-8,-4,6,-10
720575940609043413,right,T3,614,-2,-8,-2,-6
720575940639578182,right,T3,615,-7,-7,3,-10
720575940634743544,right,T3,616,-3,15,10,5
720575940630373591,right,T3,617,-2,-17,-7,-10
720575940626836780,right,T3,618,-1,24,13,11
720575940619360680,right,T3,620,7,1,-7,8
720575940616527617,right,T3,621,1,24,11,13
720575940620693953,right,T3,622,-5,20,15,5
720575940617078673,right,T3,623,1,13,5,8
720575940626747663,right,T3,624,1,-17,-10,-7
720575940629483855,right,T3,625,-2,24,14,10
720575940629140327,right,T3,626,-5,-8,1,-9
720575940616888203,right,T3,627,0,-1,-1,0
720575940624347978,right,T3,628,0,0,0,0
720575940643026212,right,T3,629,4,24,8,16
720575940608687964,right,T3,630,4,8,0,8
720575940630007290,right,T3,631,1,26,12,14
720575940624240324,right,T3,632,3,-20,-13,-7
720575940616721083,right,T3,633,-1,-24,-11,-13
720575940631419695,right,T3,634,-3,-15,-5,-10
720575940622102298,right,T3,635,6,-6,-9,3
720575940625397434,right,T3,636,0,6,3,3
720575940605942718,right,T3,637,3,-21,-14,-7
720575940616895883,right,T3,638,-1,7,4,3
720575940620689390,right,T3,639,-4,19,13,6
720575940631258788,right,T3,640,-1,-16,-7,-9
720575940629129692,right,T3,641,-8,-5,5,-10
720575940623916807,right,T3,642,-5,-11,-1,-10
720575940628126571,right,T3,643,6,14,1,13
720575940620429183,right,T3,644,-6,18,15,3
720575940633206476,right,T3,645,-4,27,17,10
720575940611492984,right,T3,647,-4,-7,0,-7
720575940635562906,right,T3,648,1,7,2,5
720575940623697589,right,T3,649,-1,5,3,2
720575940605998513,right,T3,651,-4,-5,1,-6
720575940618885243,right,T3,652,-6,-11,0,-11
720575940617557945,right,T3,653,-6,-12,0,-12
720575940630081244,right,T3,654,-3,8,7,1
720575940643373216,right,T3,655,6,-1,-7,6
720575940627035663,right,T3,656,0,-11,-6,-5
720575940630949394,right,T3,658,1,20,9,11
720575940623791613,right,T3,659,-4,-6,1,-7
720575940629996076,right,T3,660,2,28,12,16
720575940631348444,right,T3,661,-3,14,10,4
720575940633101741,right,T3,662,2,-1,-3,2
720575940627811015,right,T3,663,0,8,4,4
720575940637435504,right,T3,665,7,-2,-8,6
720575940627700040,right,T3,667,1,-28,-15,-13
720575940632012136,right,T3,668,1,19,8,11
720575940612886898,right,T3,669,4,-16,-12,-4
720575940639331443,right,T3,670,5,5,-3,8
720575940630995340,right,T3,671,-4,-23,-8,-15
720575940640398043,right,T3,672,-8,11,13,-2
720575940642858036,right,T3,673,2,5,0,5
720575940623440836,right,T3,674,-4,-14,-3,-11
720575940617866385,right,T3,676,-3,-21,-8,-13
720575940626323075,right,T3,677,0,11,5,6
720575940637545869,right,T3,678,3,-7,-7,0
720575940617194129,right,T3,679,4,18,5,13
720575940620284245,right,T3,680,-1,25,13,12
720575940617750848,right,T3,681,-2,-21,-9,-12
720575940627363343,right,T3,682,6,-8,-10,2
720575940633974355,right,T3,683,2,6,1,5
720575940617488313,right,T3,684,-6,17,14,3
720575940618180123,right,T3,685,-5,-9,0,-9
720575940626390044,right,T3,686,5,-22,-16,-6
720575940632647249,right,T3,687,-6,-3,4,-7
720575940622369869,right,T3,688,-7,10,12,-2
720575940643396000,right,T3,689,-2,18,11,7
720575940617914881,right,T3,690,-7,-3,5,-8
720575940621285552,right,T3,691,-9,4,11,-7
720575940624907815,right,T3,692,-4,24,16,8
720575940626802476,right,T3,693,-3,25,15,10
720575940620831879,right,T3,694,4,3,-3,6
720575940608133042,right,T3,695,-6,10,11,-1
720575940635018335,right,T3,696,-2,16,10,6
720575940617808569,right,T3,697,1,-22,-12,-10
720575940631091653,right,T3,698,6,-7,-10,3
720575940633190369,right,T3,699,-5,0,5,-5
720575940614552588,right,T3,701,0,-4,-2,-2
720575940620200525,right,T3,702,-5,23,16,7
720575940636955870,right,T3,703,-3,1,3,-2
720575940620048660,right,T3,704,-7,8,11,-3
720575940610388434,right,T3,705,1,1,-1,2
720575940630283642,right,T3,706,-7,-12,1,-13
720575940609888324,right,T3,707,-2,25,14,11
720575940613839218,right,T3,709,-2,-24,-10,-14
720575940622441129,right,T3,710,4,-25,-17,-8
720575940621756148,right,T3,711,-1,19,10,9
720575940626802460,right,T3,712,-7,12,13,-1
720575940619401607,right,T3,713,-6,16,14,2
720575940632524063,right,T3,714,5,12,1,11
720575940617504001,right,T3,715,4,10,1,9
720575940632403539,right,T3,716,4,-6,-7,1
720575940621170036,right,T3,717,2,-22,-13,-9
720575940635043738,right,T3,719,1,27,12,15
720575940622214576,right,T3,720,-5,21,15,6
720575940625829988,right,T3,721,5,13,1,12
720575940622396284,right,T3,722,6,-15,-14,-1
720575940632323941,right,T3,723,-2,-11,-4,-7
720575940622314205,right,T3,724,4,2,-3,5
720575940627693906,right,T3,725,-3,-24,-9,-15
720575940660660865,right,T3,726,2,-28,-16,-12
720575940622079913,right,T3,727,7,6,-4,10
720575940628962923,right,T3,728,7,12,-1,13
720575940638055002,right,T3,729,-3,29,17,12
720575940603767980,right,T3,730,7,0,-7,7
720575940620720475,right,T3,731,-6,9,10,-1
720575940627027018,right,T3,732,-3,6,6,0
720575940646400547,right,T3,733,-5,-17,-4,-13
720575940638869557,right,T3,734,2,0,-2,2
720575940630751788,right,T3,735,1,-23,-13,-10
720575940623592842,right,T3,737,0,19,9,10
720575940623917319,right,T3,738,-3,13,9,4
720575940623635785,right,T3,739,-7,2,8,-6
720575940621885168,right,T3,740,2,-8,-6,-2
720575940605682022,right,T3,741,-2,-14,-5,-9
720575940617376310,right,T3,742,-4,11,9,2
720575940632103499,right,T3,743,6,-19,-16,-3
720575940628438769,right,T3,744,-4,25,16,9
720575940629176314,right,T3,745,0,13,6,7
720575940612020453,right,T3,746,-3,3,4,-1
720575940653998497,right,T3,747,0,2,1,1
720575940639855704,right,T3,748,-4,20,14,6
720575940623878124,right,T3,749,-2,1,2,-1
720575940630152503,right,T3,750,4,-24,-16,-8
720575940617519873,right,T3,751,1,6,2,4
720575940604923616,right,T3,752,-2,7,5,2
720575940631654095,right,T3,753,-3,24,15,9
720575940614501073,right,T3,754,-1,-13,-6,-7
720575940628251142,right,T3,755,4,19,5,14
720575940618487109,right,T3,757,0,-6,-3,-3
720575940632651212,right,T3,758,5,-1,-6,5
720575940655969441,right,T3,759,7,14,0,14
720575940630482519,right,T3,760,0,17,8,9
720575940628726787,right,T3,761,-4,-18,-5,-13
720575940637856233,right,T3,762,0,14,7,7
720575940618076957,right,T3,763,-5,14,12,2
720575940628900507,right,T3,765,-3,9,7,2
720575940614792354,right,T3,766,2,-4,-4,0
720575940626829868,right,T3,767,1,28,13,15
720575940632779565,right,T3,768,3,5,-1,6
720575940645818734,right,T3,769,4,-27,-18,-9
720575940615071906,right,T3,770,5,4,-3,7
720575940634974615,right,T3,771,3,-27,-17,-10
720575940627206188,right,T3,772,1,12,5,7
720575940618616630,right,T3,773,5,-19,-15,-4
720575940624037611,right,T3,774,-8,6,11,-5
720575940628001362,right,T3,775,5,22,6,16
720575940637814494,right,T3,778,4,25,8,17
720575940614932630,right,T3,780,-6,25,18,7
720575940636576869,right,T3,781,-5,26,18,8
720575940621582507,right,T3,783,-4,28,18,10
720575940627944979,right,T3,784,-4,29,18,11
720575940630024976,right,T3,790,-2,-27,-12,-15
720575940621024862,right,T3,791,-1,-28,-13,-15
720575940624253675,right,T3,792,8,2,-7,9
720575940612657010,right,T3,796,4,26,9,17
720575940604828849,right,T4a,1,-6,13,12,1
720575940638598709,right,T4a,2,-8,2,9,-7
720575940632444431,right,T4a,3,6,-12,-12,0
720575940633877087,right,T4a,4,-5,-21,-6,-15
720575940623290343,right,T4a,5,-1,16,9,7
720575940606181762,right,T4a,6,-2,-4,0,-4
720575940620419207,right,T4a,8,-4,26,17,9
720575940628947459,right,T4a,9,4,9,0,9
720575940625910576,right,T4a,10,5,-15,-13,-2
720575940632299335,right,T4a,11,7,-14,-14,0
720575940630812231,right,T4a,12,-7,9,11,-2
720575940615078831,right,T4a,13,-1,-26,-12,-14
720575940619710293,right,T4a,14,0,-27,-14,-13
720575940621002108,right,T4a,15,2,-3,-4,1
720575940624257021,right,T4a,16,-2,-16,-6,-10
720575940625877552,right,T4a,17,1,-5,-4,-1
720575940615794738,right,T4a,18,5,-16,-13,-3
720575940632490527,right,T4a,19,-7,17,15,2
720575940630524631,right,T4a,20,3,-11,-9,-2
720575940621243672,right,T4a,21,-2,19,11,8
720575940635213157,right,T4a,22,-1,3,2,1
720575940623504359,right,T4a,24,-1,-10,-4,-6
720575940635031447,right,T4a,26,1,-3,-3,0
720575940615911583,right,T4a,27,0,-25,-13,-12
720575940609751138,right,T4a,28,5,6,-2,8
720575940655109793,right,T4a,29,-1,-3,-1,-2
720575940641000181,right,T4a,30,6,16,2,14
720575940620496913,right,T4a,31,0,16,8,8
720575940617306068,right,T4a,32,0,12,6,6
720575940618066715,right,T4a,33,3,18,6,12
720575940629178923,right,T4a,34,6,18,3,15
720575940633496545,right,T4a,35,1,-24,-13,-11
720575940621618209,right,T4a,36,6,8,-2,10
720575940623261418,right,T4a,37,1,5,1,4
720575940627870151,right,T4a,38,0,-2,-1,-1
720575940604836012,right,T4a,39,0,20,10,10
720575940626091706,right,T4a,40,-2,-6,-1,-5
720575940610367044,right,T4a,41,-3,28,17,11
720575940624750268,right,T4a,42,-1,14,8,6
720575940634254748,right,T4a,43,-5,18,14,4
720575940608391691,right,T4a,44,5,-10,-10,0
720575940618444155,right,T4a,45,-5,-1,4,-5
720575940620611866,right,T4a,46,-5,15,12,3
720575940626654864,right,T4a,48,-4,-22,-7,-15
720575940617975586,right,T4a,49,4,-4,-6,2
720575940609420043,right,T4a,50,-2,21,12,9
720575940616084948,right,T4a,51,0,-19,-10,-9
720575940637980762,right,T4a,52,-1,-22,-10,-12
720575940617416660,right,T4a,53,5,14,2,12
720575940637467102,right,T4a,54,-4,3,5,-2
720575940614791645,right,T4a,55,-4,-11,-2,-9
720575940632611615,right,T4a,56,1,-13,-8,-5
720575940627066364,right,T4a,57,6,-11,-12,1
720575940616228725,right,T4a,58,3,12,3,9
720575940637099236,right,T4a,59,-2,2,3,-1
720575940624928333,right,T4a,60,-8,8,12,-4
720575940630834316,right,T4a,61,-4,-4,2,-6
720575940625467011,right,T4a,62,0,-29,-15,-14
720575940616492305,right,T4a,63,4,12,2,10
720575940626623516,right,T4a,64,4,-23,-16,-7
720575940626211884,right,T4a,65,-1,28,15,13
720575940620076208,right,T4a,66,2,15,5,10
720575940619354539,right,T4a,67,-2,-13,-5,-8
720575940625923770,right,T4a,68,3,16,5,11
720575940622581395,right,T4a,69,1,8,3,5
720575940636387502,right,T4a,70,-4,21,14,7
720575940630100471,right,T4a,71,-2,-3,0,-3
720575940612124851,right,T4a,72,0,-28,-14,-14
720575940614701836,right,T4a,73,2,2,-1,3
720575940643722184,right,T4a,74,-1,-9,-4,-5
720575940637519757,right,T4a,76,-3,-4,1,-5
720575940608262106,right,T4a,77,2,-5,-5,0
720575940610651346,right,T4a,78,2,20,8,12
720575940619090555,right,T4a,79,2,1,-2,3
720575940622566825,right,T4a,80,4,13,2,11
720575940609740381,right,T4a,81,6,-2,-7,5
720575940635980139,right,T4a,82,-7,7,10,-3
720575940629660239,right,T4a,83,2,-21,-13,-8
720575940644596260,right,T4a,84,-2,12,8,4
720575940639650638,right,T4a,85,4,-22,-15,-7
720575940626680665,right,T4a,86,-5,-7,1,-8
720575940617861649,right,T4a,87,1,11,4,7
720575940654435489,right,T4a,88,7,4,-5,9
720575940625943340,right,T4a,90,-4,5,6,-1
720575940633770091,right,T4a,91,-1,6,4,2
720575940629723639,right,T4a,92,0,9,4,5
720575940626534858,right,T4a,93,-6,3,7,-4
720575940616194677,right,T4a,94,5,18,4,14
720575940637834637,right,T4a,95,4,-21,-15,-6
720575940630705995,right,T4a,96,1,-10,-6,-4
720575940617684027,right,T4a,97,-5,2,6,-4
720575940629305347,right,T4a,98,-1,-12,-5,-7
720575940628081226,right,T4a,99,4,15,3,12
720575940622779061,right,T4a,101,-7,6,10,-4
720575940617803911,right,T4a,102,3,13,3,10
720575940629489602,right,T4a,103,7,9,-3,12
720575940646718004,right,T4a,104,-1,-27,-13,-14
720575940619788169,right,T4a,105,3,22,8,14
720575940648109956,right,T4a,106,-7,11,12,-1
720575940622571213,right,T4a,107,8,-2,-9,7
720575940614803933,right,T4a,108,-3,-12,-3,-9
720575940627730793,right,T4a,109,4,-5,-7,2
720575940633963949,right,T4a,110,-7,0,7,-7
720575940615816635,right,T4a,111,2,-24,-14,-10
720575940626422805,right,T4a,112,-6,1,6,-5
720575940643830472,right,T4a,113,-2,4,4,0
720575940608618197,right,T4a,114,2,-13,-9,-4
720575940629761146,right,T4a,115,-4,2,5,-3
720575940639337936,right,T4a,116,-1,-8,-3,-5
720575940627839656,right,T4a,118,3,1,-3,4
720575940638973824,right,T4a,119,-2,6,5,1
720575940627561290,right,T4a,120,-1,-1,0,-1
720575940619810068,right,T4a,121,-8,4,10,-6
720575940625522320,right,T4a,122,-5,9,9,0
720575940631248079,right,T4a,124,1,-7,-5,-2
720575940624535590,right,T4a,125,5,9,-1,10
720575940645532980,right,T4a,126,3,11,2,9
720575940623278630,right,T4a,127,0,15,7,8
720575940643322509,right,T4a,128,3,-22,-14,-8
720575940621721838,right,T4a,129,0,-13,-7,-6
720575940626951877,right,T4a,130,2,12,4,8
720575940628459526,right,T4a,131,-6,20,16,4
720575940617005639,right,T4a,132,2,4,0,4
720575940627375106,right,T4a,133,-3,20,13,7
720575940626951549,right,T4a,135,-3,-22,-8,-14
720575940626218877,right,T4a,136,0,3,1,2
720575940619209408,right,T4a,137,5,-7,-9,2
720575940628794615,right,T4a,138,0,27,13,14
720575940622578183,right,T4a,139,1,-14,-8,-6
720575940631855687,right,T4a,140,3,8,1,7
720575940619171604,right,T4a,143,-4,16,12,4
720575940636784105,right,T4a,144,7,-11,-13,2
720575940606964145,right,T4a,145,0,4,2,2
720575940628420551,right,T4a,146,1,-6,-4,-2
720575940634840683,right,T4a,147,1,21,9,12
720575940633605345,right,T4a,148,-7,-11,1,-12
720575940616148330,right,T4a,149,6,-14,-13,-1
720575940621181678,right,T4a,150,-8,5,10,-5
720575940611837304,right,T4a,151,-3,-14,-4,-10
720575940624163253,right,T4a,152,3,-15,-11,-4
720575940628811523,right,T4a,153,8,0,-8,8
720575940630325591,right,T4a,154,-8,0,8,-8
720575940621496609,right,T4a,156,-9,1,9,-8
720575940638282566,right,T4a,157,-1,-7,-3,-4
720575940632336941,right,T4a,158,3,-5,-6,1
720575940624503531,right,T4a,159,7,7,-4,11
720575940625994506,right,T4a,160,-2,20,12,8
720575940638467672,right,T4a,161,4,-14,-11,-3
720575940621169392,right,T4a,162,-4,-2,3,-5
720575940620639050,right,T4a,164,-1,-2,0,-2
720575940620436912,right,T4a,165,4,16,4,12
720575940641161205,right,T4a,166,0,18,9,9
720575940617554900,right,T4a,167,0,-17,-9,-8
720575940626217085,right,T4a,168,-1,17,9,8
720575940619057531,right,T4a,169,0,-18,-9,-9
720575940628979892,right,T4a,170,-5,1,5,-4
720575940615800114,right,T4a,171,6,-20,-16,-4
720575940608623115,right,T4a,172,1,22,10,12
720575940623178189,right,T4a,173,2,-25,-15,-10
720575940629123175,right,T4a,174,4,-15,-12,-3
720575940626462768,right,T4a,175,-6,-7,2,-9
720575940627160709,right,T4a,176,-2,13,8,5
720575940613660071,right,T4a,177,-2,-1,1,-2
720575940607283977,right,T4a,178,2,11,3,8
720575940622343804,right,T4a,179,-5,-16,-3,-13
720575940638057961,right,T4a,180,2,-27,-16,-11
720575940621551220,right,T4a,181,1,-4,-3,-1
720575940628259594,right,T4a,182,7,-10,-12,2
720575940609578702,right,T4a,183,-5,-15,-3,-12
720575940622278890,right,T4a,184,-6,-5,3,-8
720575940614580689,right,T4a,185,2,-11,-8,-3
720575940618818462,right,T4a,186,-1,26,14,12
720575940614187774,right,T4a,187,3,21,7,14
720575940620623469,right,T4a,188,-5,17,13,4
720575940609803989,right,T4a,189,6,13,0,13
720575940604831456,right,T4a,190,-3,-5,0,-5
720575940608720137,right,T4a,191,-1,-11,-5,-6
720575940635930987,right,T4a,192,7,10,-2,12
720575940622739725,right,T4a,193,-5,4,7,-3
720575940620419824,right,T4a,194,0,-5,-3,-2
720575940615070431,right,T4a,195,-3,-1,2,-3
720575940623627667,right,T4a,196,-1,8,5,3
720575940629890364,right,T4a,197,0,-20,-10,-10
720575940608363531,right,T4a,198,6,2,-5,7
720575940646150435,right,T4a,199,0,-12,-6,-6
720575940631507287,right,T4a,200,-5,12,11,1
720575940633334112,right,T4a,201,-8,9,12,-3
720575940631929431,right,T4a,202,-1,27,14,13
720575940619999818,right,T4a,203,3,-1,-4,3
720575940620530091,right,T4a,204,5,-2,-6,4
720575940629532657,right,T4a,205,5,-6,-8,2
720575940623675831,right,T4a,206,-3,5,5,0
720575940641057744,right,T4a,207,1,29,13,16
720575940637352845,right,T4a,208,5,-21,-16,-5
720575940617407705,right,T4a,209,-3,-8,-1,-7
720575940639584317,right,T4a,210,-6,8,10,-2
720575940626962746,right,T4a,211,-7,-1,6,-7
720575940614564146,right,T4a,212,2,-16,-10,-6
720575940608257754,right,T4a,213,3,-4,-5,1
720575940638814286,right,T4a,214,-5,3,6,-3
720575940612681898,right,T4a,215,6,7,-3,10
720575940624141385,right,T4a,216,2,19,7,12
720575940607463369,right,T4a,217,6,15,1,14
720575940625472002,right,T4a,218,2,10,3,7
720575940627201929,right,T4a,219,6,-4,-8,4
720575940623328892,right,T4a,220,2,-6,-5,-1
720575940629228816,right,T4a,222,-3,26,16,10
720575940623544551,right,T4a,223,-2,26,15,11
720575940623961101,right,T4a,224,0,5,2,3
720575940622193953,right,T4a,225,2,-26,-15,-11
720575940633378274,right,T4a,226,5,19,4,15
720575940613492143,right,T4a,227,-7,5,9,-4
720575940636466032,right,T4a,228,-7,1,7,-6
720575940617988353,right,T4a,229,5,2,-4,6
720575940610532757,right,T4a,230,2,9,2,7
720575940618865472,right,T4a,231,4,-12,-10,-2
720575940618459712,right,T4a,232,-4,13,10,3
720575940641655860,right,T4a,234,1,3,0,3
720575940621938857,right,T4a,235,4,11,1,10
720575940610253410,right,T4a,236,-1,4,3,1
720575940632894174,right,T4a,237,-2,27,15,12
720575940639999989,right,T4a,239,-6,6,9,-3
720575940633497570,right,T4a,240,-4,-3,2,-5
720575940625761917,right,T4a,241,2,-17,-11,-6
720575940612290969,right,T4a,242,-4,6,7,-1
720575940612858520,right,T4a,243,-1,-21,-10,-11
720575940614620381,right,T4a,244,-4,-12,-2,-10
720575940614891462,right,T4a,246,-4,15,11,4
720575940635682159,right,T4a,247,-4,-15,-4,-11
720575940629211756,right,T4a,248,-6,0,6,-6
720575940624541163,right,T4a,249,2,-12,-8,-4
720575940635997850,right,T4a,250,-1,1,1,0
720575940646039575,right,T4a,251,-1,-14,-6,-8
720575940629366631,right,T4a,252,3,23,8,15
720575940631236772,right,T4a,253,5,16,3,13
720575940633687972,right,T4a,254,3,-24,-15,-9
720575940625009131,right,T4a,255,-6,-13,-1,-12
720575940633401313,right,T4a,256,5,-20,-15,-5
720575940620986025,right,T4a,257,2,21,8,13
720575940614621661,right,T4a,258,-4,-17,-5,-12
720575940623517320,right,T4a,259,-7,-5,4,-9
720575940618458176,right,T4a,260,-3,19,12,7
720575940607321353,right,T4a,261,-1,13,7,6
720575940622393724,right,T4a,262,1,-11,-7,-4
720575940626092218,right,T4a,263,-3,4,5,-1
720575940637542285,right,T4a,264,-1,-6,-2,-4
720575940620745242,right,T4a,265,-6,-1,5,-6
720575940632070284,right,T4a,266,-1,-25,-12,-13
720575940625628772,right,T4a,267,-6,2,7,-5
720575940603568757,right,T4a,268,7,-6,-10,4
720575940630175488,right,T4a,269,2,-19,-12,-7
720575940630084060,right,T4a,270,1,-8,-5,-3
720575940632718623,right,T4a,271,4,6,-1,7
720575940618097821,right,T4a,272,3,-2,-4,2
720575940627811132,right,T4a,273,-6,23,17,6
720575940617128377,right,T4a,274,6,4,-4,8
720575940643217568,right,T4a,275,-8,-1,7,-8
720575940627727134,right,T4a,276,2,3,-1,4
720575940631975505,right,T4a,277,7,-3,-9,6
720575940630520407,right,T4a,278,-5,10,10,0
720575940631909037,right,T4a,279,-4,8,8,0
720575940636555877,right,T4a,280,-6,-14,-1,-13
720575940624538928,right,T4a,282,0,26,13,13
720575940643963592,right,T4a,283,-4,4,6,-2
720575940614943455,right,T4a,284,0,25,12,13
720575940626510937,right,T4a,285,6,-18,-15,-3
720575940634580331,right,T4a,286,0,-24,-12,-12
720575940621048240,right,T4a,287,-5,13,11,2
720575940622866836,right,T4a,288,-1,30,16,14
720575940622647907,right,T4a,289,-1,11,6,5
720575940621540544,right,T4a,290,5,-24,-17,-7
720575940638300724,right,T4a,291,7,2,-6,8
720575940615234207,right,T4a,292,-4,18,13,5
720575940638369252,right,T4a,293,4,-17,-13,-4
720575940623392214,right,T4a,294,1,-20,-11,-9
720575940634520683,right,T4a,295,-2,29,16,13
720575940626097189,right,T4a,296,1,-18,-10,-8
720575940618910621,right,T4a,297,7,-9,-12,3
720575940618331456,right,T4a,298,-5,5,7,-2
720575940619120037,right,T4a,299,-4,12,10,2
720575940614290897,right,T4a,300,4,-18,-13,-5
720575940622773530,right,T4a,301,-5,16,13,3
720575940627806480,right,T4a,302,2,17,6,11
720575940632067665,right,T4a,303,-5,22,16,6
720575940621275775,right,T4a,304,6,5,-4,9
720575940623240595,right,T4a,306,3,7,0,7
720575940629239772,right,T4a,308,-5,8,9,-1
720575940637863657,right,T4a,309,-6,12,12,0
720575940620479038,right,T4a,310,2,22,9,13
720575940634346391,right,T4a,311,-7,15,14,1
720575940610968562,right,T4a,312,4,-7,-8,1
720575940615731131,right,T4a,313,7,3,-6,9
720575940617270621,right,T4a,315,-3,-6,0,-6
720575940631251919,right,T4a,316,5,-4,-7,3
720575940616165738,right,T4a,317,-5,-4,3,-7
720575940623494925,right,T4a,318,4,-19,-14,-5
720575940631410060,right,T4a,319,-2,5,4,1
720575940619387973,right,T4a,320,-2,-5,-1,-4
720575940621841833,right,T4a,321,8,4,-6,10
720575940625414448,right,T4a,322,2,26,11,15
720575940631382851,right,T4a,324,3,24,9,15
720575940640037072,right,T4a,325,5,1,-5,6
720575940633096659,right,T4a,326,2,16,6,10
720575940641621812,right,T4a,327,5,3,-4,7
720575940613465581,right,T4a,329,0,24,12,12
720575940616208982,right,T4a,330,3,3,-2,5
720575940621434333,right,T4a,331,1,-15,-9,-6
720575940628584386,right,T4a,332,4,-26,-17,-9
720575940605055660,right,T4a,333,0,-21,-11,-10
720575940623501055,right,T4a,334,1,-26,-14,-12
720575940614556363,right,T4a,335,2,8,2,6
720575940630484311,right,T4a,336,0,23,11,12
720575940622967832,right,T4a,337,-5,-6,2,-8
720575940639190912,right,T4a,338,-1,0,1,-1
720575940625678606,right,T4a,339,6,11,-1,12
720575940624756408,right,T4a,340,-4,17,12,5
720575940631999951,right,T4a,341,6,-17,-15,-2
720575940633177517,right,T4a,342,2,-15,-10,-5
720575940624564016,right,T4a,343,-3,27,16,11
720575940604712688,right,T4a,344,-2,-15,-6,-9
720575940620687599,right,T4a,345,3,-12,-9,-3
720575940620968361,right,T4a,348,3,14,4,10
720575940658932097,right,T4a,349,-5,-14,-2,-12
720575940632979100,right,T4a,350,1,15,6,9
720575940604745456,right,T4a,351,-1,-17,-8,-9
720575940620310208,right,T4a,352,-2,28,16,12
720575940620890748,right,T4a,353,2,24,10,14
720575940622171416,right,T4a,354,-2,-26,-11,-15
720575940620576773,right,T4a,355,-7,-6,4,-10
720575940630548055,right,T4a,356,0,22,11,11
720575940617308277,right,T4a,357,4,17,4,13
720575940639952000,right,T4a,358,-3,17,11,6
720575940631951756,right,T4a,359,2,23,9,14
720575940622534614,right,T4a,360,-5,19,14,5
720575940623890685,right,T4a,361,0,-7,-4,-3
720575940637707098,right,T4a,362,2,-20,-12,-8
720575940617948957,right,T4a,363,7,-4,-9,5
720575940635997594,right,T4a,364,4,4,-2,6
720575940626548368,right,T4a,365,4,7,-1,8
720575940614579837,right,T4a,368,-4,-20,-6,-14
720575940627598852,right,T4a,369,5,-5,-8,3
720575940639773568,right,T4a,370,-3,21,13,8
720575940609744733,right,T4a,371,6,-5,-9,4
720575940634499832,right,T4a,372,1,-2,-2,0
720575940618038109,right,T4a,373,1,-21,-12,-9
720575940636224363,right,T4a,374,2,13,4,9
720575940628926467,right,T4a,377,0,7,3,4
720575940617795668,right,T4a,378,-3,18,12,6
720575940635113919,right,T4a,379,3,-17,-12,-5
720575940633981921,right,T4a,380,-1,29,15,14
720575940637284493,right,T4a,382,3,-6,-6,0
720575940612211826,right,T4a,383,-6,11,11,0
720575940637995632,right,T4a,384,-6,-2,5,-7
720575940619713645,right,T4a,385,-3,-18,-6,-12
720575940643758280,right,T4a,386,-6,19,15,4
720575940614991997,right,T4a,387,-1,-15,-7,-8
720575940622126847,right,T4a,388,3,19,6,13
720575940661224065,right,T4a,390,-6,-9,1,-10
720575940603491957,right,T4a,391,4,-3,-6,3
720575940622851511,right,T4a,392,-4,7,7,0
720575940624046630,right,T4a,393,-1,22,12,10
720575940628110854,right,T4a,394,-7,-8,3,-11
720575940616641058,right,T4a,396,-1,10,6,4
720575940617614265,right,T4a,397,-3,-19,-7,-12
720575940623824713,right,T4a,398,-3,22,14,8
720575940636434424,right,T4a,400,1,-29,-16,-13
720575940620128438,right,T4a,401,-2,-19,-8,-11
720575940632946340,right,T4a,402,3,26,10,16
720575940599755718,right,T4a,403,-2,-12,-4,-8
720575940623458348,right,T4a,404,-1,20,11,9
720575940637688639,right,T4a,405,3,10,2,8
720575940622300810,right,T4a,406,1,-25,-14,-11
720575940640283701,right,T4a,407,-5,-10,0,-10
720575940634622359,right,T4a,408,-6,-4,4,-8
720575940614122646,right,T4a,409,0,-3,-2,-1
720575940613565849,right,T4a,410,-2,-2,1,-3
720575940634696161,right,T4a,411,-5,-19,-5,-14
720575940626370947,right,T4a,413,-2,-7,-2,-5
720575940632803921,right,T4a,414,4,21,6,15
720575940620765793,right,T4a,415,6,12,0,12
720575940635694328,right,T4a,416,3,-8,-7,-1
720575940622676464,right,T4a,417,-6,-10,1,-11
720575940620785574,right,T4a,418,-2,15,9,6
720575940635232180,right,T4a,420,6,-3,-8,5
720575940621130593,right,T4a,421,-1,12,7,5
720575940637592127,right,T4a,422,-7,-4,5,-9
720575940635518093,right,T4a,423,3,-18,-12,-6
720575940622595572,right,T4a,424,-3,-2,2,-4
720575940625924144,right,T4a,425,3,20,7,13
720575940629210292,right,T4a,426,-3,0,3,-3
720575940630719340,right,T4a,427,5,-18,-14,-4
720575940629663938,right,T4a,428,-2,23,13,10
720575940641120653,right,T4a,429,-2,14,9,5
720575940632643245,right,T4a,430,-3,-7,-1,-6
720575940635245492,right,T4a,431,-2,-10,-3,-7
720575940641231757,right,T4a,432,-5,7,8,-1
720575940606444930,right,T4a,433,0,-8,-4,-4
720575940620755717,right,T4a,434,-3,7,6,1
720575940638950051,right,T4a,436,0,-15,-8,-7
720575940627200812,right,T4a,437,-3,12,9,3
720575940626312997,right,T4a,438,2,27,11,16
720575940634124057,right,T4a,439,-3,-9,-2,-7
720575940608498955,right,T4a,440,1,23,10,13
720575940615181974,right,T4a,441,3,-16,-11,-5
720575940615337895,right,T4a,442,-5,25,17,8
720575940623132125,right,T4a,443,-6,4,8,-4
720575940623438828,right,T4a,444,4,-10,-9,-1
720575940649994361,right,T4a,445,-2,8,6,2
720575940637706125,right,T4a,446,2,-14,-9,-5
720575940615307682,right,T4a,447,-1,2,2,0
720575940634302419,right,T4a,449,6,-16,-14,-2
720575940644600343,right,T4a,450,2,-9,-7,-2
720575940621488922,right,T4a,451,4,20,6,14
720575940645056110,right,T4a,452,1,-9,-6,-3
720575940637090416,right,T4a,453,3,25,9,16
720575940632720485,right,T4a,454,5,-12,-11,-1
720575940621422774,right,T4a,455,7,-7,-11,4
720575940614109892,right,T4a,456,0,21,10,11
720575940631378755,right,T4a,457,-2,17,10,7
720575940632208927,right,T4a,458,5,0,-5,5
720575940607902682,right,T4a,459,5,-3,-7,4
720575940629480433,right,T4a,460,-3,-20,-7,-13
720575940623858616,right,T4a,461,7,-5,-10,5
720575940614578338,right,T4a,462,-1,18,10,8
720575940633005212,right,T4a,463,5,17,3,14
720575940621531584,right,T4a,464,4,0,-4,4
720575940634355993,right,T4a,465,3,0,-3,3
720575940608305500,right,T4a,466,1,14,6,8
720575940636686990,right,T4a,467,-2,-20,-8,-12
720575940627147052,right,T4a,468,-3,11,8,3
720575940607814106,right,T4a,470,4,-9,-9,0
720575940624938940,right,T4a,471,3,-26,-16,-10
720575940631027275,right,T4a,472,1,25,11,14
720575940626777496,right,T4a,473,-4,23,15,8
720575940634256279,right,T4a,475,-4,-1,3,-4
720575940618989214,right,T4a,476,-1,15,8,7
720575940620131237,right,T4a,477,-3,2,4,-2
720575940638487155,right,T4a,479,-2,10,7,3
720575940614191766,right,T4a,480,3,-19,-13,-6
720575940617925067,right,T4a,481,4,-8,-8,0
720575940620511249,right,T4a,482,1,17,7,10
720575940613443084,right,T4a,483,2,-7,-6,-1
720575940623949309,right,T4a,484,3,-9,-8,-1
720575940618651864,right,T4a,485,-3,-3,1,-4
720575940639988176,right,T4a,486,0,1,0,1
720575940600101641,right,T4a,487,1,-1,-2,1
720575940628954883,right,T4a,488,7,5,-5,10
720575940647066932,right,T4a,489,-3,10,8,2
720575940629837868,right,T4a,490,-5,6,8,-2
720575940626047492,right,T4a,491,7,-1,-8,7
720575940627149834,right,T4a,492,-7,-2,6,-8
720575940610736533,right,T4a,493,-3,23,14,9
720575940626217516,right,T4a,494,0,29,14,15
720575940626245016,right,T4a,495,4,5,-2,7
720575940619375900,right,T4a,496,7,8,-3,11
720575940630735447,right,T4a,497,6,1,-6,7
720575940611969778,right,T4a,498,6,10,-1,11
720575940609425347,right,T4a,499,5,10,0,10
720575940621750255,right,T4a,500,7,-8,-11,3
720575940607814665,right,T4a,501,1,2,0,2
720575940621529536,right,T4a,502,5,8,-1,9
720575940621963433,right,T4a,503,3,17,5,12
720575940624321865,right,T4a,504,-2,9,6,3
720575940612039154,right,T4a,506,1,-12,-7,-5
720575940627385877,right,T4a,507,-5,-12,-1,-11
720575940628552556,right,T4a,508,-5,11,10,1
720575940642820388,right,T4a,509,-4,10,9,1
720575940626489644,right,T4a,510,-2,11,7,4
720575940623627411,right,T4a,511,5,-11,-11,0
720575940635781684,right,T4a,512,6,0,-6,6
720575940636955199,right,T4a,514,-4,-10,-1,-9
720575940625114109,right,T4a,516,7,-18,-16,-2
720575940635806772,right,T4a,517,6,3,-5,8
720575940629794295,right,T4a,518,-4,22,15,7
720575940627541480,right,T4a,519,-5,-5,2,-7
720575940615985164,right,T4a,520,-2,-22,-9,-13
720575940624193255,right,T4a,521,6,-9,-11,2
720575940635998362,right,T4a,522,-4,0,4,-4
720575940660772993,right,T4a,523,2,14,5,9
720575940629784108,right,T4a,524,4,-20,-14,-6
720575940608511068,right,T4a,525,-1,-20,-9,-11
720575940630230376,right,T4a,526,0,-10,-5,-5
720575940625371280,right,T4a,527,-4,-8,0,-8
720575940621678785,right,T4a,528,2,7,1,6
720575940635282332,right,T4a,529,2,-2,-3,1
720575940626967311,right,T4a,530,-3,-13,-4,-9
720575940628777463,right,T4a,531,1,0,-1,1
720575940605852192,right,T4a,532,-8,7,11,-4
720575940617847454,right,T4a,533,0,-16,-8,-8
720575940641657396,right,T4a,534,3,2,-2,4
720575940637514974,right,T4a,535,8,-4,-10,6
720575940620685039,right,T4a,536,3,4,-1,5
720575940622106409,right,T4a,537,0,-23,-12,-11
720575940640090752,right,T4a,538,-4,1,4,-3
720575940622969853,right,T4a,539,-6,15,13,2
720575940611187298,right,T4a,540,-2,-9,-3,-6
720575940620277942,right,T4a,541,-4,14,11,3
720575940645617262,right,T4a,542,6,-13,-13,0
720575940635928176,right,T4a,543,-1,-4,-1,-3
720575940616951947,right,T4a,544,3,-13,-10,-3
720575940612230553,right,T4a,545,5,11,0,11
720575940617018183,right,T4a,546,3,6,0,6
720575940624749749,right,T4a,547,-1,21,11,10
720575940623384968,right,T4a,548,1,-16,-9,-7
720575940605803744,right,T4a,549,0,-9,-5,-4
720575940613118760,right,T4a,550,-2,3,3,0
720575940630368732,right,T4a,551,-4,-9,-1,-8
720575940638662708,right,T4a,552,4,-1,-5,4
720575940619812717,right,T4a,553,-3,16,11,5
720575940638196157,right,T4a,555,-4,9,8,1
720575940620220598,right,T4a,556,0,10,5,5
720575940620575067,right,T4a,557,6,-10,-11,1
720575940622106657,right,T4a,558,-4,-21,-7,-14
720575940621625953,right,T4a,560,-7,14,14,0
720575940632008007,right,T4a,561,5,7,-2,9
720575940629929925,right,T4a,562,-5,-2,4,-6
720575940633879853,right,T4a,563,5,-13,-12,-1
720575940628774782,right,T4a,564,3,-23,-15,-8
720575940626482840,right,T4a,565,0,-26,-13,-13
720575940632744621,right,T4a,566,5,-8,-9,1
720575940629524730,right,T4a,567,-2,22,13,9
720575940625347661,right,T4a,568,-6,-8,2,-10
720575940627214504,right,T4a,569,6,6,-3,9
720575940619233585,right,T4a,570,2,25,10,15
720575940639500963,right,T4a,571,0,-14,-7,-7
720575940606821250,right,T4a,573,4,14,3,11
720575940629875906,right,T4a,574,-6,5,8,-3
720575940635931755,right,T4a,575,6,9,-2,11
720575940633672078,right,T4a,576,0,28,14,14
720575940616454210,right,T4a,577,5,-14,-12,-2
720575940605939814,right,T4a,578,4,-11,-10,-1
720575940613994671,right,T4a,579,-3,-10,-2,-8
720575940633786975,right,T4a,580,-2,-23,-10,-13
720575940638646874,right,T4a,581,3,9,1,8
720575940617212987,right,T4a,582,-1,23,12,11
720575940627286153,right,T4a,583,3,-25,-16,-9
720575940647830404,right,T4a,584,4,23,7,16
720575940619453318,right,T4a,585,-1,-23,-11,-12
720575940620572781,right,T4a,586,2,18,7,11
720575940614709446,right,T4a,588,1,4,1,3
720575940618774848,right,T4a,589,-1,-5,-2,-3
720575940610862638,right,T4a,590,1,9,3,6
720575940627922180,right,T4a,591,3,-3,-5,2
720575940628189833,right,T4a,592,3,-28,-17,-11
720575940626666877,right,T4a,593,3,-14,-10,-4
720575940626452880,right,T4a,594,7,-16,-15,-1
720575940636515429,right,T4a,595,7,-12,-13,1
720575940623801272,right,T4a,597,4,1,-4,5
720575940627170437,right,T4a,598,2,-18,-11,-7
720575940623692775,right,T4a,599,-1,9,5,4
720575940627326825,right,T4a,600,3,-10,-8,-2
720575940637379550,right,T4a,601,1,16,7,9
720575940605793726,right,T4a,602,4,-2,-5,3
720575940617825629,right,T4a,603,-3,-23,-9,-14
720575940632417363,right,T4a,604,-6,-17,-3,-14
720575940629170519,right,T4a,605,3,15,4,11
720575940613669784,right,T4a,606,-1,-19,-9,-10
720575940623188420,right,T4a,607,1,18,8,10
720575940626444741,right,T4a,608,1,10,4,6
720575940628426366,right,T4a,609,-2,0,2,-2
720575940631620089,right,T4a,610,2,-23,-14,-9
720575940627534613,right,T4a,611,-1,-18,-8,-10
720575940611108194,right,T4a,612,-3,-26,-10,-16
720575940619196143,right,T4a,613,-8,-4,6,-10
720575940618214685,right,T4a,614,-2,-8,-2,-6
720575940660454017,right,T4a,615,-7,-7,3,-10
720575940628169371,right,T4a,616,-3,15,10,5
720575940654955937,right,T4a,617,-2,-17,-7,-10
720575940617391249,right,T4a,618,-1,24,13,11
720575940643136456,right,T4a,619,-4,-19,-6,-13
720575940639503448,right,T4a,620,7,1,-7,8
720575940620335437,right,T4a,621,1,24,11,13
720575940622227068,right,T4a,622,-5,20,15,5
720575940626427589,right,T4a,623,1,13,5,8
720575940618059604,right,T4a,624,1,-17,-10,-7
720575940614119218,right,T4a,625,-2,24,14,10
720575940637668574,right,T4a,626,-5,-8,1,-9
720575940632879841,right,T4a,627,0,-1,-1,0
720575940620584319,right,T4a,628,0,0,0,0
720575940617390910,right,T4a,629,4,24,8,16
720575940619197854,right,T4a,630,4,8,0,8
720575940613037037,right,T4a,631,1,26,12,14
720575940640779984,right,T4a,634,-3,-15,-5,-10
720575940621038677,right,T4a,635,6,-6,-9,3
720575940609942136,right,T4a,636,0,6,3,3
720575940621871469,right,T4a,637,3,-21,-14,-7
720575940618038651,right,T4a,638,-1,7,4,3
720575940660868481,right,T4a,639,-4,19,13,6
720575940632297901,right,T4a,640,-1,-16,-7,-9
720575940613378541,right,T4a,641,-8,-5,5,-10
720575940629088508,right,T4a,642,-5,-11,-1,-10
720575940615541654,right,T4a,643,6,14,1,13
720575940621238767,right,T4a,644,-6,18,15,3
720575940614300211,right,T4a,645,-4,27,17,10
720575940625584933,right,T4a,646,6,17,2,15
720575940617376985,right,T4a,648,1,7,2,5
720575940618700248,right,T4a,649,-1,5,3,2
720575940620977788,right,T4a,650,-3,-25,-10,-15
720575940604383776,right,T4a,651,-4,-5,1,-6
720575940617345753,right,T4a,652,-6,-11,0,-11
720575940611509966,right,T4a,653,-6,-12,0,-12
720575940622286625,right,T4a,654,-3,8,7,1
720575940614169086,right,T4a,655,6,-1,-7,6
720575940649880441,right,T4a,656,0,-11,-6,-5
720575940631879225,right,T4a,657,-2,-25,-11,-14
720575940615512898,right,T4a,658,1,20,9,11
720575940622780543,right,T4a,659,-4,-6,1,-7
720575940618181606,right,T4a,660,2,28,12,16
720575940614743190,right,T4a,661,-3,14,10,4
720575940600143369,right,T4a,662,2,-1,-3,2
720575940604474982,right,T4a,663,0,8,4,4
720575940626647464,right,T4a,664,1,-27,-15,-12
720575940626947271,right,T4a,665,7,-2,-8,6
720575940616579841,right,T4a,666,7,-13,-14,1
720575940612685864,right,T4a,667,1,-28,-15,-13
720575940604640945,right,T4a,668,1,19,8,11
720575940616997062,right,T4a,669,4,-16,-12,-4
720575940623982216,right,T4a,670,5,5,-3,8
720575940616695835,right,T4a,673,2,5,0,5
720575940639036494,right,T4a,674,-4,-14,-3,-11
720575940620981108,right,T4a,676,-3,-21,-8,-13
720575940631624248,right,T4a,677,0,11,5,6
720575940627873448,right,T4a,678,3,-7,-7,0
720575940620326929,right,T4a,679,4,18,5,13
720575940618375197,right,T4a,680,-1,25,13,12
720575940618936733,right,T4a,681,-2,-21,-9,-12
720575940603526005,right,T4a,682,6,-8,-10,2
720575940635637428,right,T4a,683,2,6,1,5
720575940624513255,right,T4a,684,-6,17,14,3
720575940630825338,right,T4a,685,-5,-9,0,-9
720575940617306841,right,T4a,686,5,-22,-16,-6
720575940624679719,right,T4a,687,-6,-3,4,-7
720575940613534870,right,T4a,688,-7,10,12,-2
720575940608924740,right,T4a,689,-2,18,11,7
720575940613526422,right,T4a,692,-4,24,16,8
720575940617874781,right,T4a,693,-3,25,15,10
720575940621780001,right,T4a,694,4,3,-3,6
720575940621757832,right,T4a,695,-6,10,11,-1
720575940633170076,right,T4a,696,-2,16,10,6
720575940624708169,right,T4a,697,1,-22,-12,-10
720575940632803411,right,T4a,698,6,-7,-10,3
720575940619837387,right,T4a,699,-5,0,5,-5
720575940622950161,right,T4a,700,5,15,2,13
720575940629413194,right,T4a,701,0,-4,-2,-2
720575940635718751,right,T4a,702,-5,23,16,7
720575940623066392,right,T4a,703,-3,1,3,-2
720575940628637519,right,T4a,704,-7,8,11,-3
720575940618373962,right,T4a,705,1,1,-1,2
720575940617718758,right,T4a,707,-2,25,14,11
720575940621353392,right,T4a,708,-4,-25,-9,-16
720575940627346186,right,T4a,709,-2,-24,-10,-14
720575940618802000,right,T4a,710,4,-25,-17,-8
720575940616518612,right,T4a,711,-1,19,10,9
720575940629120732,right,T4a,712,-7,12,13,-1
720575940606539465,right,T4a,713,-6,16,14,2
720575940633963181,right,T4a,714,5,12,1,11
720575940622478972,right,T4a,715,4,10,1,9
720575940625113597,right,T4a,716,4,-6,-7,1
720575940637959770,right,T4a,717,2,-22,-13,-9
720575940619793997,right,T4a,718,-5,24,17,7
720575940632799059,right,T4a,719,1,27,12,15
720575940627505277,right,T4a,720,-5,21,15,6
720575940622191830,right,T4a,721,5,13,1,12
720575940612900466,right,T4a,722,6,-15,-14,-1
720575940631767436,right,T4a,723,-2,-11,-4,-7
720575940640757200,right,T4a,724,4,2,-3,5
720575940616577653,right,T4a,725,-3,-24,-9,-15
720575940627772037,right,T4a,726,2,-28,-16,-12
720575940600547529,right,T4a,727,7,6,-4,10
720575940625678862,right,T4a,728,7,12,-1,13
720575940624002604,right,T4a,729,-3,29,17,12
720575940613619090,right,T4a,730,7,0,-7,7
720575940626723870,right,T4a,731,-6,9,10,-1
720575940614835131,right,T4a,732,-3,6,6,0
720575940639197247,right,T4a,733,-5,-17,-4,-13
720575940629338011,right,T4a,734,2,0,-2,2
720575940635149151,right,T4a,735,1,-23,-13,-10
720575940624009827,right,T4a,736,-8,1,8,-7
720575940612741799,right,T4a,737,0,19,9,10
720575940613711254,right,T4a,738,-3,13,9,4
720575940625407690,right,T4a,739,-7,2,8,-6
720575940612437966,right,T4a,740,2,-8,-6,-2
720575940630280508,right,T4a,741,-2,-14,-5,-9
720575940638474584,right,T4a,742,-4,11,9,2
720575940617220281,right,T4a,743,6,-19,-16,-3
720575940628026641,right,T4a,744,-4,25,16,9
720575940626446869,right,T4a,745,0,13,6,7
720575940637784127,right,T4a,746,-3,3,4,-1
720575940633618272,right,T4a,747,0,2,1,1
720575940614722198,right,T4a,748,-4,20,14,6
720575940616130955,right,T4a,749,-2,1,2,-1
720575940611991219,right,T4a,750,4,-24,-16,-8
720575940614547879,right,T4a,751,1,6,2,4
720575940608781579,right,T4a,752,-2,7,5,2
720575940619146910,right,T4a,753,-3,24,15,9
720575940621150561,right,T4a,754,-1,-13,-6,-7
720575940628632080,right,T4a,755,4,19,5,14
720575940631508803,right,T4a,756,5,20,5,15
720575940637689434,right,T4a,757,0,-6,-3,-3
720575940608288523,right,T4a,758,5,-1,-6,5
720575940630457335,right,T4a,759,7,14,0,14
720575940607197826,right,T4a,760,0,17,8,9
720575940621810902,right,T4a,761,-4,-18,-5,-13
720575940613693677,right,T4a,762,0,14,7,7
720575940627266054,right,T4a,763,-5,14,12,2
720575940635100572,right,T4a,765,-3,9,7,2
720575940628033042,right,T4a,766,2,-4,-4,0
720575940614276271,right,T4a,767,1,28,13,15
720575940622994982,right,T4a,768,3,5,-1,6
720575940615720350,right,T4a,770,5,4,-3,7
720575940628027665,right,T4a,772,1,12,5,7
720575940633520927,right,T4a,773,5,-19,-15,-4
720575940616440251,right,T4a,775,5,22,6,16
720575940630086138,right,T4a,776,5,21,5,16
720575940615088894,right,T4a,778,4,25,8,17
720575940628675846,right,T4a,779,5,24,7,17
720575940623897129,right,T4a,780,-6,25,18,7
720575940638586787,right,T4a,782,-5,27,18,9
720575940610367556,right,T4a,783,-4,28,18,10
720575940630147781,right,T4a,785,-3,30,18,12
720575940611084566,right,T4a,786,-2,30,17,13
720575940627645973,right,T4a,787,3,28,11,17
720575940633268525,right,T4a,788,3,27,10,17
720575940619007867,right,T4a,790,-2,-27,-12,-15
720575940644935447,right,T4a,791,-1,-28,-13,-15
720575940621527841,right,T4a,792,8,2,-7,9
720575940640155789,right,T4a,793,8,-6,-11,5
720575940630800762,right,T4a,794,5,-26,-18,-8
720575940636315022,right,T4a,796,4,26,9,17
720575940634086295,right,T4b,1,-6,13,12,1
720575940630507116,right,T4b,2,-8,2,9,-7
720575940627958471,right,T4b,3,6,-12,-12,0
720575940632903085,right,T4b,5,-1,16,9,7
720575940629503319,right,T4b,6,-2,-4,0,-4
720575940629782469,right,T4b,7,-6,-6,3,-9
720575940645145891,right,T4b,8,-4,26,17,9
720575940617034077,right,T4b,9,4,9,0,9
720575940609008853,right,T4b,10,5,-15,-13,-2
720575940612235586,right,T4b,11,7,-14,-14,0
720575940621824282,right,T4b,12,-7,9,11,-2
720575940635223397,right,T4b,13,-1,-26,-12,-14
720575940622268748,right,T4b,14,0,-27,-14,-13
720575940631725452,right,T4b,15,2,-3,-4,1
720575940624742548,right,T4b,16,-2,-16,-6,-10
720575940638725773,right,T4b,17,1,-5,-4,-1
720575940612271786,right,T4b,18,5,-16,-13,-3
720575940630437228,right,T4b,19,-7,17,15,2
720575940622591220,right,T4b,20,3,-11,-9,-2
720575940632483532,right,T4b,21,-2,19,11,8
720575940605453001,right,T4b,22,-1,3,2,1
720575940631241002,right,T4b,23,-3,-16,-5,-11
720575940635240333,right,T4b,24,-1,-10,-4,-6
720575940613036525,right,T4b,25,-9,3,10,-7
720575940620416586,right,T4b,26,1,-3,-3,0
720575940628640774,right,T4b,27,0,-25,-13,-12
720575940639494232,right,T4b,28,5,6,-2,8
720575940612125170,right,T4b,29,-1,-3,-1,-2
720575940626767618,right,T4b,30,6,16,2,14
720575940622111058,right,T4b,31,0,16,8,8
720575940626461186,right,T4b,32,0,12,6,6
720575940611860698,right,T4b,33,3,18,6,12
720575940621354991,right,T4b,34,6,18,3,15
720575940624788798,right,T4b,35,1,-24,-13,-11
720575940629660919,right,T4b,36,6,8,-2,10
720575940630949647,right,T4b,37,1,5,1,4
720575940623202634,right,T4b,38,0,-2,-1,-1
720575940642699976,right,T4b,39,0,20,10,10
720575940621488566,right,T4b,40,-2,-6,-1,-5
720575940623987244,right,T4b,41,-3,28,17,11
720575940632858707,right,T4b,42,-1,14,8,6
720575940632675117,right,T4b,43,-5,18,14,4
720575940605135532,right,T4b,44,5,-10,-10,0
720575940619087307,right,T4b,45,-5,-1,4,-5
720575940634027932,right,T4b,46,-5,15,12,3
720575940631112668,right,T4b,47,-9,-1,8,-9
720575940610623089,right,T4b,48,-4,-22,-7,-15
720575940615103830,right,T4b,49,4,-4,-6,2
720575940624939865,right,T4b,50,-2,21,12,9
720575940622497476,right,T4b,51,0,-19,-10,-9
720575940612696728,right,T4b,52,-1,-22,-10,-12
720575940626782151,right,T4b,53,5,14,2,12
720575940633641919,right,T4b,54,-4,3,5,-2
720575940626881673,right,T4b,55,-4,-11,-2,-9
720575940607987395,right,T4b,56,1,-13,-8,-5
720575940631861048,right,T4b,57,6,-11,-12,1
720575940624380652,right,T4b,58,3,12,3,9
720575940622420189,right,T4b,60,-8,8,12,-4
720575940629856556,right,T4b,61,-4,-4,2,-6
720575940623936253,right,T4b,63,4,12,2,10
720575940612718322,right,T4b,64,4,-23,-16,-7
720575940637242286,right,T4b,65,-1,28,15,13
720575940620410304,right,T4b,66,2,15,5,10
720575940617161531,right,T4b,67,-2,-13,-5,-8
720575940628169115,right,T4b,68,3,16,5,11
720575940626512581,right,T4b,69,1,8,3,5
720575940621791237,right,T4b,70,-4,21,14,7
720575940620354726,right,T4b,71,-2,-3,0,-3
720575940628019985,right,T4b,72,0,-28,-14,-14
720575940640032088,right,T4b,73,2,2,-1,3
720575940637557645,right,T4b,74,-1,-9,-4,-5
720575940652193014,right,T4b,75,-6,14,13,1
720575940610396718,right,T4b,76,-3,-4,1,-5
720575940624379792,right,T4b,77,2,-5,-5,0
720575940622855935,right,T4b,79,2,1,-2,3
720575940604818092,right,T4b,80,4,13,2,11
720575940634753983,right,T4b,81,6,-2,-7,5
720575940605398048,right,T4b,82,-7,7,10,-3
720575940611842936,right,T4b,83,2,-21,-13,-8
720575940636574174,right,T4b,84,-2,12,8,4
720575940637841805,right,T4b,85,4,-22,-15,-7
720575940644741412,right,T4b,86,-5,-7,1,-8
720575940632672851,right,T4b,87,1,11,4,7
720575940615598267,right,T4b,88,7,4,-5,9
720575940648454009,right,T4b,89,1,-19,-11,-8
720575940631378986,right,T4b,90,-4,5,6,-1
720575940625958444,right,T4b,91,-1,6,4,2
720575940626511557,right,T4b,92,0,9,4,5
720575940650521209,right,T4b,93,-6,3,7,-4
720575940619701077,right,T4b,94,5,18,4,14
720575940620714479,right,T4b,95,4,-21,-15,-6
720575940621749492,right,T4b,96,1,-10,-6,-4
720575940610637688,right,T4b,97,-5,2,6,-4
720575940608352690,right,T4b,98,-1,-12,-5,-7
720575940619336753,right,T4b,99,4,15,3,12
720575940629075279,right,T4b,100,2,-10,-7,-3
720575940619925696,right,T4b,101,-7,6,10,-4
720575940624412820,right,T4b,102,3,13,3,10
720575940622555094,right,T4b,104,-1,-27,-13,-14
720575940619717257,right,T4b,105,3,22,8,14
720575940637863401,right,T4b,106,-7,11,12,-1
720575940626510232,right,T4b,108,-3,-12,-3,-9
720575940638864256,right,T4b,109,4,-5,-7,2
720575940628651014,right,T4b,110,-7,0,7,-7
720575940621250403,right,T4b,111,2,-24,-14,-10
720575940617174758,right,T4b,112,-6,1,6,-5
720575940642858804,right,T4b,113,-2,4,4,0
720575940620553921,right,T4b,114,2,-13,-9,-4
720575940625974572,right,T4b,115,-4,2,5,-3
720575940617845277,right,T4b,116,-1,-8,-3,-5
720575940614952607,right,T4b,117,-8,-2,7,-9
720575940631101999,right,T4b,118,3,1,-3,4
720575940626315397,right,T4b,119,-2,6,5,1
720575940637989978,right,T4b,120,-1,-1,0,-1
720575940614686662,right,T4b,121,-8,4,10,-6
720575940615228482,right,T4b,122,-5,9,9,0
720575940623812622,right,T4b,124,1,-7,-5,-2
720575940631729548,right,T4b,125,5,9,-1,10
720575940621843382,right,T4b,126,3,11,2,9
720575940622372301,right,T4b,127,0,15,7,8
720575940619442159,right,T4b,128,3,-22,-14,-8
720575940639768448,right,T4b,129,0,-13,-7,-6
720575940627266822,right,T4b,130,2,12,4,8
720575940624567271,right,T4b,131,-6,20,16,4
720575940617005383,right,T4b,132,2,4,0,4
720575940625997258,right,T4b,133,-3,20,13,7
720575940630905807,right,T4b,134,-5,-18,-4,-14
720575940631567687,right,T4b,135,-3,-22,-8,-14
720575940623417525,right,T4b,136,0,3,1,2
720575940617957149,right,T4b,137,5,-7,-9,2
720575940627150985,right,T4b,138,0,27,13,14
720575940633408869,right,T4b,139,1,-14,-8,-6
720575940615239285,right,T4b,140,3,8,1,7
720575940613898365,right,T4b,142,-2,-18,-7,-11
720575940640595152,right,T4b,143,-4,16,12,4
720575940617665885,right,T4b,144,7,-11,-13,2
720575940615685278,right,T4b,145,0,4,2,2
720575940616110523,right,T4b,146,1,-6,-4,-2
720575940620793406,right,T4b,147,1,21,9,12
720575940630334459,right,T4b,148,-7,-11,1,-12
720575940635503758,right,T4b,149,6,-14,-13,-1
720575940624051348,right,T4b,150,-8,5,10,-5
720575940614931862,right,T4b,151,-3,-14,-4,-10
720575940629970647,right,T4b,152,3,-15,-11,-4
720575940628358068,right,T4b,153,8,0,-8,8
720575940621289221,right,T4b,154,-8,0,8,-8
720575940620059813,right,T4b,155,-8,13,14,-1
720575940608049419,right,T4b,156,-9,1,9,-8
720575940633925739,right,T4b,157,-1,-7,-3,-4
720575940629908418,right,T4b,158,3,-5,-6,1
720575940617786113,right,T4b,160,-2,20,12,8
720575940641037696,right,T4b,161,4,-14,-11,-3
720575940609293660,right,T4b,162,-4,-2,3,-5
720575940616575062,right,T4b,163,-9,7,12,-5
720575940622298637,right,T4b,164,-1,-2,0,-2
720575940615263967,right,T4b,165,4,16,4,12
720575940622110546,right,T4b,166,0,18,9,9
720575940627642645,right,T4b,167,0,-17,-9,-8
720575940638009919,right,T4b,168,-1,17,9,8
720575940631284439,right,T4b,169,0,-18,-9,-9
720575940634935403,right,T4b,170,-5,1,5,-4
720575940625883454,right,T4b,171,6,-20,-16,-4
720575940628077511,right,T4b,172,1,22,10,12
720575940624332012,right,T4b,174,4,-15,-12,-3
720575940617636057,right,T4b,175,-6,-7,2,-9
720575940624411796,right,T4b,176,-2,13,8,5
720575940622739690,right,T4b,177,-2,-1,1,-2
720575940614281122,right,T4b,178,2,11,3,8
720575940618445241,right,T4b,179,-5,-16,-3,-13
720575940628030738,right,T4b,181,1,-4,-3,-1
720575940628861435,right,T4b,182,7,-10,-12,2
720575940625233552,right,T4b,183,-5,-15,-3,-12
720575940613471205,right,T4b,184,-6,-5,3,-8
720575940636088462,right,T4b,185,2,-11,-8,-3
720575940623728522,right,T4b,186,-1,26,14,12
720575940618882427,right,T4b,187,3,21,7,14
720575940625989907,right,T4b,188,-5,17,13,4
720575940609804245,right,T4b,189,6,13,0,13
720575940640113792,right,T4b,190,-3,-5,0,-5
720575940616493115,right,T4b,191,-1,-11,-5,-6
720575940610907654,right,T4b,192,7,10,-2,12
720575940630400374,right,T4b,193,-5,4,7,-3
720575940627731112,right,T4b,194,0,-5,-3,-2
720575940640721141,right,T4b,195,-3,-1,2,-3
720575940605977265,right,T4b,196,-1,8,5,3
720575940631268252,right,T4b,197,0,-20,-10,-10
720575940637612260,right,T4b,198,6,2,-5,7
720575940639501475,right,T4b,199,0,-12,-6,-6
720575940618531585,right,T4b,200,-5,12,11,1
720575940633429726,right,T4b,202,-1,27,14,13
720575940629762426,right,T4b,203,3,-1,-4,3
720575940615171467,right,T4b,204,5,-2,-6,4
720575940638566744,right,T4b,205,5,-6,-8,2
720575940652355574,right,T4b,206,-3,5,5,0
720575940619724937,right,T4b,207,1,29,13,16
720575940621684318,right,T4b,208,5,-21,-16,-5
720575940630605932,right,T4b,209,-3,-8,-1,-7
720575940613288499,right,T4b,210,-6,8,10,-2
720575940631762233,right,T4b,211,-7,-1,6,-7
720575940623499814,right,T4b,212,2,-16,-10,-6
720575940608115418,right,T4b,213,3,-4,-5,1
720575940610585208,right,T4b,214,-5,3,6,-3
720575940630988113,right,T4b,215,6,7,-3,10
720575940631633208,right,T4b,216,2,19,7,12
720575940626512837,right,T4b,218,2,10,3,7
720575940623956221,right,T4b,219,6,-4,-8,4
720575940609972578,right,T4b,220,2,-6,-5,-1
720575940621234927,right,T4b,221,-7,3,8,-5
720575940627864337,right,T4b,222,-3,26,16,10
720575940634111167,right,T4b,223,-2,26,15,11
720575940624846823,right,T4b,224,0,5,2,3
720575940630105106,right,T4b,226,5,19,4,15
720575940639210062,right,T4b,227,-7,5,9,-4
720575940624056061,right,T4b,228,-7,1,7,-6
720575940626298243,right,T4b,229,5,2,-4,6
720575940620137408,right,T4b,230,2,9,2,7
720575940639524515,right,T4b,231,4,-12,-10,-2
720575940627147308,right,T4b,232,-4,13,10,3
720575940607039618,right,T4b,233,4,-13,-11,-2
720575940622355788,right,T4b,234,1,3,0,3
720575940611466389,right,T4b,235,4,11,1,10
720575940628894402,right,T4b,236,-1,4,3,1
720575940634246881,right,T4b,237,-2,27,15,12
720575940628409674,right,T4b,238,-8,-3,6,-9
720575940637991401,right,T4b,239,-6,6,9,-3
720575940625759525,right,T4b,240,-4,-3,2,-5
720575940613222115,right,T4b,241,2,-17,-11,-6
720575940625419312,right,T4b,242,-4,6,7,-1
720575940610983634,right,T4b,243,-1,-21,-10,-11
720575940639221949,right,T4b,244,-4,-12,-2,-10
720575940633497826,right,T4b,245,-5,-3,3,-6
720575940620606061,right,T4b,246,-4,15,11,4
720575940599457990,right,T4b,247,-4,-15,-4,-11
720575940627479016,right,T4b,248,-6,0,6,-6
720575940627407887,right,T4b,249,2,-12,-8,-4
720575940631752877,right,T4b,250,-1,1,1,0
720575940627456811,right,T4b,251,-1,-14,-6,-8
720575940632280903,right,T4b,252,3,23,8,15
720575940624668092,right,T4b,253,5,16,3,13
720575940645498734,right,T4b,254,3,-24,-15,-9
720575940614413218,right,T4b,255,-6,-13,-1,-12
720575940636843120,right,T4b,256,5,-20,-15,-5
720575940620773217,right,T4b,257,2,21,8,13
720575940627448122,right,T4b,258,-4,-17,-5,-12
720575940620921771,right,T4b,259,-7,-5,4,-9
720575940632826797,right,T4b,260,-3,19,12,7
720575940616575761,right,T4b,261,-1,13,7,6
720575940625917228,right,T4b,263,-3,4,5,-1
720575940616390913,right,T4b,264,-1,-6,-2,-4
720575940601672201,right,T4b,265,-6,-1,5,-6
720575940631872569,right,T4b,266,-1,-25,-12,-13
720575940625052233,right,T4b,267,-6,2,7,-5
720575940609810013,right,T4b,268,7,-6,-10,4
720575940629624058,right,T4b,269,2,-19,-12,-7
720575940631685480,right,T4b,270,1,-8,-5,-3
720575940640715096,right,T4b,271,4,6,-1,7
720575940631370932,right,T4b,272,3,-2,-4,2
720575940628764203,right,T4b,273,-6,23,17,6
720575940632116388,right,T4b,274,6,4,-4,8
720575940629575921,right,T4b,275,-8,-1,7,-8
720575940639505240,right,T4b,276,2,3,-1,4
720575940611333841,right,T4b,277,7,-3,-9,6
720575940641400795,right,T4b,278,-5,10,10,0
720575940625171533,right,T4b,279,-4,8,8,0
720575940646496547,right,T4b,280,-6,-14,-1,-13
720575940626239020,right,T4b,282,0,26,13,13
720575940646707764,right,T4b,283,-4,4,6,-2
720575940619764873,right,T4b,284,0,25,12,13
720575940634922906,right,T4b,285,6,-18,-15,-3
720575940609499000,right,T4b,286,0,-24,-12,-12
720575940634430048,right,T4b,287,-5,13,11,2
720575940633429470,right,T4b,288,-1,30,16,14
720575940628688745,right,T4b,289,-1,11,6,5
720575940622779775,right,T4b,290,5,-24,-17,-7
720575940623618999,right,T4b,291,7,2,-6,8
720575940631138322,right,T4b,292,-4,18,13,5
720575940615625026,right,T4b,293,4,-17,-13,-4
720575940634428255,right,T4b,294,1,-20,-11,-9
720575940626241580,right,T4b,295,-2,29,16,13
720575940613305640,right,T4b,296,1,-18,-10,-8
720575940626791293,right,T4b,298,-5,5,7,-2
720575940610816881,right,T4b,299,-4,12,10,2
720575940610773602,right,T4b,300,4,-18,-13,-5
720575940630996754,right,T4b,301,-5,16,13,3
720575940621676817,right,T4b,302,2,17,6,11
720575940626791468,right,T4b,303,-5,22,16,6
720575940623075819,right,T4b,304,6,5,-4,9
720575940627469564,right,T4b,305,-7,4,9,-5
720575940614414539,right,T4b,306,3,7,0,7
720575940617598109,right,T4b,308,-5,8,9,-1
720575940627247620,right,T4b,309,-6,12,12,0
720575940630521923,right,T4b,310,2,22,9,13
720575940621044340,right,T4b,311,-7,15,14,1
720575940603498869,right,T4b,312,4,-7,-8,1
720575940644506135,right,T4b,313,7,3,-6,9
720575940626177176,right,T4b,314,-9,5,11,-6
720575940615620876,right,T4b,315,-3,-6,0,-6
720575940634922647,right,T4b,316,5,-4,-7,3
720575940623227283,right,T4b,317,-5,-4,3,-7
720575940635544973,right,T4b,318,4,-19,-14,-5
720575940638086461,right,T4b,319,-2,5,4,1
720575940625815070,right,T4b,320,-2,-5,-1,-4
720575940649378681,right,T4b,321,8,4,-6,10
720575940630658041,right,T4b,322,2,26,11,15
720575940627006750,right,T4b,323,-7,-13,0,-13
720575940618630720,right,T4b,324,3,24,9,15
720575940623166090,right,T4b,325,5,1,-5,6
720575940630800747,right,T4b,326,2,16,6,10
720575940623271914,right,T4b,327,5,3,-4,7
720575940627736326,right,T4b,328,5,-9,-10,1
720575940623993673,right,T4b,329,0,24,12,12
720575940637931354,right,T4b,330,3,3,-2,5
720575940633591397,right,T4b,331,1,-15,-9,-6
720575940621908360,right,T4b,332,4,-26,-17,-9
720575940616452182,right,T4b,333,0,-21,-11,-10
720575940608920075,right,T4b,334,1,-26,-14,-12
720575940621129569,right,T4b,335,2,8,2,6
720575940630818135,right,T4b,336,0,23,11,12
720575940617747037,right,T4b,337,-5,-6,2,-8
720575940612200371,right,T4b,338,-1,0,1,-1
720575940632433000,right,T4b,339,6,11,-1,12
720575940630260188,right,T4b,340,-4,17,12,5
720575940615803954,right,T4b,341,6,-17,-15,-2
720575940627398675,right,T4b,342,2,-15,-10,-5
720575940618264404,right,T4b,343,-3,27,16,11
720575940610493560,right,T4b,344,-2,-15,-6,-9
720575940623338876,right,T4b,345,3,-12,-9,-3
720575940630054219,right,T4b,346,-7,-9,2,-11
720575940623714765,right,T4b,347,-5,-13,-2,-11
720575940604805566,right,T4b,348,3,14,4,10
720575940621449686,right,T4b,350,1,15,6,9
720575940604699120,right,T4b,351,-1,-17,-8,-9
720575940626220588,right,T4b,352,-2,28,16,12
720575940637429605,right,T4b,353,2,24,10,14
720575940632509552,right,T4b,354,-2,-26,-11,-15
720575940637903076,right,T4b,355,-7,-6,4,-10
720575940601206499,right,T4b,356,0,22,11,11
720575940628906747,right,T4b,357,4,17,4,13
720575940611773906,right,T4b,358,-3,17,11,6
720575940619752329,right,T4b,359,2,23,9,14
720575940622215779,right,T4b,360,-5,19,14,5
720575940631966009,right,T4b,361,0,-7,-4,-3
720575940636648590,right,T4b,362,2,-20,-12,-8
720575940630766647,right,T4b,363,7,-4,-9,5
720575940614121425,right,T4b,364,4,4,-2,6
720575940610539250,right,T4b,365,4,7,-1,8
720575940631601227,right,T4b,366,-5,-20,-5,-15
720575940611829141,right,T4b,367,-6,-15,-2,-13
720575940628793243,right,T4b,368,-4,-20,-6,-14
720575940607361545,right,T4b,369,5,-5,-8,3
720575940628258289,right,T4b,370,-3,21,13,8
720575940630420730,right,T4b,371,6,-5,-9,4
720575940638547508,right,T4b,372,1,-2,-2,0
720575940623597704,right,T4b,373,1,-21,-12,-9
720575940632374867,right,T4b,374,2,13,4,9
720575940623502119,right,T4b,375,-6,7,9,-2
720575940622082184,right,T4b,377,0,7,3,4
720575940635448312,right,T4b,378,-3,18,12,6
720575940629222915,right,T4b,380,-1,29,15,14
720575940617443677,right,T4b,381,-8,-9,3,-12
720575940619615568,right,T4b,382,3,-6,-6,0
720575940628453787,right,T4b,383,-6,11,11,0
720575940615332246,right,T4b,384,-6,-2,5,-7
720575940610514274,right,T4b,385,-3,-18,-6,-12
720575940628456091,right,T4b,386,-6,19,15,4
720575940612985775,right,T4b,387,-1,-15,-7,-8
720575940629445498,right,T4b,388,3,19,6,13
720575940620727361,right,T4b,389,-6,-16,-2,-14
720575940646864948,right,T4b,390,-6,-9,1,-10
720575940642029019,right,T4b,391,4,-3,-6,3
720575940644397092,right,T4b,392,-4,7,7,0
720575940613406114,right,T4b,393,-1,22,12,10
720575940617961245,right,T4b,394,-7,-8,3,-11
720575940616894681,right,T4b,395,0,-22,-11,-11
720575940632661412,right,T4b,396,-1,10,6,4
720575940626946300,right,T4b,397,-3,-19,-7,-12
720575940614473414,right,T4b,398,-3,22,14,8
720575940613292798,right,T4b,399,-4,-24,-8,-16
720575940633245907,right,T4b,400,1,-29,-16,-13
720575940618366528,right,T4b,401,-2,-19,-8,-11
720575940631321797,right,T4b,402,3,26,10,16
720575940623010345,right,T4b,403,-2,-12,-4,-8
720575940632841773,right,T4b,404,-1,20,11,9
720575940631046999,right,T4b,405,3,10,2,8
720575940634999231,right,T4b,406,1,-25,-14,-11
720575940611755286,right,T4b,407,-5,-10,0,-10
720575940626727848,right,T4b,408,-6,-4,4,-8
720575940631668072,right,T4b,409,0,-3,-2,-1
720575940638641990,right,T4b,410,-2,-2,1,-3
720575940620033872,right,T4b,411,-5,-19,-5,-14
720575940614421922,right,T4b,412,-6,21,16,5
720575940613810227,right,T4b,413,-2,-7,-2,-5
720575940622437334,right,T4b,414,4,21,6,15
720575940628921162,right,T4b,415,6,12,0,12
720575940614586124,right,T4b,416,3,-8,-7,-1
720575940626665128,right,T4b,417,-6,-10,1,-11
720575940635430904,right,T4b,418,-2,15,9,6
720575940626967055,right,T4b,419,-3,-11,-3,-8
720575940616147573,right,T4b,420,6,-3,-8,5
720575940614747554,right,T4b,421,-1,12,7,5
720575940606527922,right,T4b,422,-7,-4,5,-9
720575940608278537,right,T4b,423,3,-18,-12,-6
720575940624653035,right,T4b,424,-3,-2,2,-4
720575940620640594,right,T4b,425,3,20,7,13
720575940642945844,right,T4b,426,-3,0,3,-3
720575940619631158,right,T4b,427,5,-18,-14,-4
720575940621602625,right,T4b,428,-2,23,13,10
720575940630706683,right,T4b,429,-2,14,9,5
720575940625774205,right,T4b,430,-3,-7,-1,-6
720575940644347940,right,T4b,431,-2,-10,-3,-7
720575940619656789,right,T4b,432,-5,7,8,-1
720575940627762179,right,T4b,433,0,-8,-4,-4
720575940659001473,right,T4b,434,-3,7,6,1
720575940627518468,right,T4b,436,0,-15,-8,-7
720575940613710511,right,T4b,437,-3,12,9,3
720575940633648153,right,T4b,439,-3,-9,-2,-7
720575940613922966,right,T4b,440,1,23,10,13
720575940638335302,right,T4b,441,3,-16,-11,-5
720575940625523545,right,T4b,442,-5,25,17,8
720575940637441758,right,T4b,443,-6,4,8,-4
720575940630764793,right,T4b,444,4,-10,-9,-1
720575940620732525,right,T4b,445,-2,8,6,2
720575940642052749,right,T4b,446,2,-14,-9,-5
720575940611521945,right,T4b,447,-1,2,2,0
720575940627232286,right,T4b,448,0,30,15,15
720575940633454305,right,T4b,449,6,-16,-14,-2
720575940637289956,right,T4b,450,2,-9,-7,-2
720575940624483410,right,T4b,451,4,20,6,14
720575940621557744,right,T4b,452,1,-9,-6,-3
720575940619779465,right,T4b,453,3,25,9,16
720575940632736101,right,T4b,454,5,-12,-11,-1
720575940627887356,right,T4b,455,7,-7,-11,4
720575940611988698,right,T4b,456,0,21,10,11
720575940621636173,right,T4b,457,-2,17,10,7
720575940639644531,right,T4b,458,5,0,-5,5
720575940626812553,right,T4b,459,5,-3,-7,4
720575940618827318,right,T4b,460,-3,-20,-7,-13
720575940618136859,right,T4b,461,7,-5,-10,5
720575940621571149,right,T4b,462,-1,18,10,8
720575940631215609,right,T4b,463,5,17,3,14
720575940615602107,right,T4b,464,4,0,-4,4
720575940622461516,right,T4b,465,3,0,-3,3
720575940617969937,right,T4b,466,1,14,6,8
720575940618366021,right,T4b,467,-2,-20,-8,-12
720575940631167535,right,T4b,468,-3,11,8,3
720575940614122207,right,T4b,469,-7,13,13,0
720575940609799778,right,T4b,470,4,-9,-9,0
720575940635192474,right,T4b,471,3,-26,-16,-10
720575940629365776,right,T4b,472,1,25,11,14
720575940628712448,right,T4b,473,-4,23,15,8
720575940613896829,right,T4b,474,-3,-17,-6,-11
720575940623100906,right,T4b,475,-4,-1,3,-4
720575940629880108,right,T4b,476,-1,15,8,7
720575940643829960,right,T4b,477,-3,2,4,-2
720575940632359566,right,T4b,478,-7,16,15,1
720575940626481964,right,T4b,479,-2,10,7,3
720575940629696727,right,T4b,481,4,-8,-8,0
720575940617305556,right,T4b,482,1,17,7,10
720575940622887523,right,T4b,483,2,-7,-6,-1
720575940620726849,right,T4b,484,3,-9,-8,-1
720575940625315120,right,T4b,485,-3,-3,1,-4
720575940628455038,right,T4b,486,0,1,0,1
720575940620012526,right,T4b,487,1,-1,-2,1
720575940609574468,right,T4b,488,7,5,-5,10
720575940633372129,right,T4b,489,-3,10,8,2
720575940637893609,right,T4b,490,-5,6,8,-2
720575940609907298,right,T4b,491,7,-1,-8,7
720575940616503553,right,T4b,493,-3,23,14,9
720575940628783355,right,T4b,494,0,29,14,15
720575940627923185,right,T4b,495,4,5,-2,7
720575940632665252,right,T4b,496,7,8,-3,11
720575940612520470,right,T4b,497,6,1,-6,7
720575940625703975,right,T4b,498,6,10,-1,11
720575940635220148,right,T4b,499,5,10,0,10
720575940624385772,right,T4b,500,7,-8,-11,3
720575940628468552,right,T4b,501,1,2,0,2
720575940614971550,right,T4b,502,5,8,-1,9
720575940624039885,right,T4b,503,3,17,5,12
720575940641139085,right,T4b,504,-2,9,6,3
720575940647838852,right,T4b,505,6,-22,-17,-5
720575940633860703,right,T4b,506,1,-12,-7,-5
720575940623022889,right,T4b,507,-5,-12,-1,-11
720575940614800908,right,T4b,508,-5,11,10,1
720575940628402682,right,T4b,509,-4,10,9,1
720575940611136435,right,T4b,510,-2,11,7,4
720575940636510053,right,T4b,511,5,-11,-11,0
720575940644405796,right,T4b,512,6,0,-6,6
720575940632889645,right,T4b,513,-4,-13,-3,-10
720575940635913840,right,T4b,514,-4,-10,-1,-9
720575940635870772,right,T4b,517,6,3,-5,8
720575940624648679,right,T4b,518,-4,22,15,7
720575940627154313,right,T4b,519,-5,-5,2,-7
720575940612381335,right,T4b,520,-2,-22,-9,-13
720575940623970231,right,T4b,521,6,-9,-11,2
720575940612740501,right,T4b,522,-4,0,4,-4
720575940631622712,right,T4b,523,2,14,5,9
720575940635630989,right,T4b,524,4,-20,-14,-6
720575940622638691,right,T4b,525,-1,-20,-9,-11
720575940633529555,right,T4b,526,0,-10,-5,-5
720575940605547552,right,T4b,527,-4,-8,0,-8
720575940612405477,right,T4b,528,2,7,1,6
720575940619472344,right,T4b,529,2,-2,-3,1
720575940614796509,right,T4b,530,-3,-13,-4,-9
720575940623362634,right,T4b,531,1,0,-1,1
720575940631888524,right,T4b,532,-8,7,11,-4
720575940621828488,right,T4b,533,0,-16,-8,-8
720575940633058733,right,T4b,534,3,2,-2,4
720575940632079540,right,T4b,535,8,-4,-10,6
720575940641658164,right,T4b,536,3,4,-1,5
720575940631164316,right,T4b,537,0,-23,-12,-11
720575940630766610,right,T4b,538,-4,1,4,-3
720575940642126221,right,T4b,539,-6,15,13,2
720575940637542797,right,T4b,540,-2,-9,-3,-6
720575940619060673,right,T4b,541,-4,14,11,3
720575940636678884,right,T4b,542,6,-13,-13,0
720575940621377029,right,T4b,543,-1,-4,-1,-3
720575940631088591,right,T4b,544,3,-13,-10,-3
720575940624631224,right,T4b,545,5,11,0,11
720575940614746847,right,T4b,546,3,6,0,6
720575940630258135,right,T4b,547,-1,21,11,10
720575940611795861,right,T4b,548,1,-16,-9,-7
720575940621642118,right,T4b,549,0,-9,-5,-4
720575940619636395,right,T4b,550,-2,3,3,0
720575940634207644,right,T4b,551,-4,-9,-1,-8
720575940623667383,right,T4b,552,4,-1,-5,4
720575940612651030,right,T4b,553,-3,16,11,5
720575940618984315,right,T4b,555,-4,9,8,1
720575940630192640,right,T4b,556,0,10,5,5
720575940604435061,right,T4b,557,6,-10,-11,1
720575940645426286,right,T4b,558,-4,-21,-7,-14
720575940613153689,right,T4b,559,-6,22,17,5
720575940633664281,right,T4b,560,-7,14,14,0
720575940616203166,right,T4b,561,5,7,-2,9
720575940627541736,right,T4b,562,-5,-2,4,-6
720575940620690768,right,T4b,563,5,-13,-12,-1
720575940654921633,right,T4b,564,3,-23,-15,-8
720575940612669849,right,T4b,565,0,-26,-13,-13
720575940623214483,right,T4b,566,5,-8,-9,1
720575940619774811,right,T4b,567,-2,22,13,9
720575940644383432,right,T4b,568,-6,-8,2,-10
720575940635491982,right,T4b,569,6,6,-3,9
720575940618010942,right,T4b,570,2,25,10,15
720575940620561279,right,T4b,571,0,-14,-7,-7
720575940626760211,right,T4b,572,-8,3,9,-6
720575940623674893,right,T4b,573,4,14,3,11
720575940647120163,right,T4b,575,6,9,-2,11
720575940633432798,right,T4b,576,0,28,14,14
720575940627027731,right,T4b,577,5,-14,-12,-2
720575940606947529,right,T4b,578,4,-11,-10,-1
720575940624815079,right,T4b,579,-3,-10,-2,-8
720575940636017527,right,T4b,580,-2,-23,-10,-13
720575940616890897,right,T4b,581,3,9,1,8
720575940622936811,right,T4b,582,-1,23,12,11
720575940646184995,right,T4b,583,3,-25,-16,-9
720575940647826052,right,T4b,584,4,23,7,16
720575940629933762,right,T4b,585,-1,-23,-11,-12
720575940617999680,right,T4b,586,2,18,7,11
720575940611982802,right,T4b,587,4,22,7,15
720575940626397778,right,T4b,588,1,4,1,3
720575940637204877,right,T4b,589,-1,-5,-2,-3
720575940626446789,right,T4b,590,1,9,3,6
720575940636377207,right,T4b,591,3,-3,-5,2
720575940639355251,right,T4b,593,3,-14,-10,-4
720575940611415362,right,T4b,595,7,-12,-13,1
720575940630619510,right,T4b,596,-4,-16,-4,-12
720575940611861427,right,T4b,597,4,1,-4,5
720575940627847428,right,T4b,598,2,-18,-11,-7
720575940616343953,right,T4b,599,-1,9,5,4
720575940634591851,right,T4b,600,3,-10,-8,-2
720575940629913655,right,T4b,601,1,16,7,9
720575940631516852,right,T4b,602,4,-2,-5,3
720575940608650507,right,T4b,603,-3,-23,-9,-14
720575940643997220,right,T4b,604,-6,-17,-3,-14
720575940617285588,right,T4b,605,3,15,4,11
720575940610725218,right,T4b,606,-1,-19,-9,-10
720575940621797726,right,T4b,607,1,18,8,10
720575940626510789,right,T4b,608,1,10,4,6
720575940625824899,right,T4b,609,-2,0,2,-2
720575940605833062,right,T4b,610,2,-23,-14,-9
720575940625929609,right,T4b,611,-1,-18,-8,-10
720575940632300345,right,T4b,612,-3,-26,-10,-16
720575940645622051,right,T4b,613,-8,-4,6,-10
720575940627958546,right,T4b,614,-2,-8,-2,-6
720575940641577101,right,T4b,615,-7,-7,3,-10
720575940640231296,right,T4b,616,-3,15,10,5
720575940631637048,right,T4b,617,-2,-17,-7,-10
720575940625085671,right,T4b,618,-1,24,13,11
720575940626094794,right,T4b,619,-4,-19,-6,-13
720575940639304563,right,T4b,620,7,1,-7,8
720575940623652074,right,T4b,621,1,24,11,13
720575940628585987,right,T4b,622,-5,20,15,5
720575940616525073,right,T4b,623,1,13,5,8
720575940610776162,right,T4b,624,1,-17,-10,-7
720575940630420444,right,T4b,625,-2,24,14,10
720575940617358009,right,T4b,626,-5,-8,1,-9
720575940623362122,right,T4b,627,0,-1,-1,0
720575940631755746,right,T4b,628,0,0,0,0
720575940658428033,right,T4b,629,4,24,8,16
720575940630532183,right,T4b,630,4,8,0,8
720575940623871276,right,T4b,631,1,26,12,14
720575940622771592,right,T4b,632,3,-20,-13,-7
720575940612894771,right,T4b,633,-1,-24,-11,-13
720575940617070405,right,T4b,634,-3,-15,-5,-10
720575940625364557,right,T4b,635,6,-6,-9,3
720575940632860499,right,T4b,636,0,6,3,3
720575940628692329,right,T4b,638,-1,7,4,3
720575940631110475,right,T4b,639,-4,19,13,6
720575940609721186,right,T4b,640,-1,-16,-7,-9
720575940640501467,right,T4b,641,-8,-5,5,-10
720575940619332475,right,T4b,642,-5,-11,-1,-10
720575940613645487,right,T4b,643,6,14,1,13
720575940622788195,right,T4b,644,-6,18,15,3
720575940624377096,right,T4b,645,-4,27,17,10
720575940629905255,right,T4b,646,6,17,2,15
720575940626736808,right,T4b,647,-4,-7,0,-7
720575940626452421,right,T4b,648,1,7,2,5
720575940632328403,right,T4b,649,-1,5,3,2
720575940620035408,right,T4b,650,-3,-25,-10,-15
720575940620831341,right,T4b,651,-4,-5,1,-6
720575940620117895,right,T4b,652,-6,-11,0,-11
720575940630151996,right,T4b,653,-6,-12,0,-12
720575940644164718,right,T4b,654,-3,8,7,1
720575940620346305,right,T4b,655,6,-1,-7,6
720575940612068594,right,T4b,656,0,-11,-6,-5
720575940633423586,right,T4b,657,-2,-25,-11,-14
720575940643774368,right,T4b,659,-4,-6,1,-7
720575940626381356,right,T4b,661,-3,14,10,4
720575940629010432,right,T4b,662,2,-1,-3,2
720575940627010685,right,T4b,663,0,8,4,4
720575940615229346,right,T4b,665,7,-2,-8,6
720575940627103588,right,T4b,667,1,-28,-15,-13
720575940625790748,right,T4b,668,1,19,8,11
720575940644608036,right,T4b,669,4,-16,-12,-4
720575940641634100,right,T4b,670,5,5,-3,8
720575940604180140,right,T4b,671,-4,-23,-8,-15
720575940627021612,right,T4b,672,-8,11,13,-2
720575940625952589,right,T4b,673,2,5,0,5
720575940618056005,right,T4b,674,-4,-14,-3,-11
720575940631072527,right,T4b,675,-7,19,16,3
720575940639564147,right,T4b,676,-3,-21,-8,-13
720575940622415044,right,T4b,677,0,11,5,6
720575940626787614,right,T4b,678,3,-7,-7,0
720575940630891883,right,T4b,679,4,18,5,13
720575940633724767,right,T4b,680,-1,25,13,12
720575940626290276,right,T4b,681,-2,-21,-9,-12
720575940615017951,right,T4b,682,6,-8,-10,2
720575940612773338,right,T4b,683,2,6,1,5
720575940620395759,right,T4b,684,-6,17,14,3
720575940621188161,right,T4b,685,-5,-9,0,-9
720575940607353801,right,T4b,686,5,-22,-16,-6
720575940630418263,right,T4b,687,-6,-3,4,-7
720575940640169277,right,T4b,688,-7,10,12,-2
720575940613323262,right,T4b,689,-2,18,11,7
720575940608756693,right,T4b,690,-7,-3,5,-8
720575940628088582,right,T4b,691,-9,4,11,-7
720575940619062693,right,T4b,692,-4,24,16,8
720575940629600359,right,T4b,693,-3,25,15,10
720575940641647668,right,T4b,694,4,3,-3,6
720575940615220639,right,T4b,695,-6,10,11,-1
720575940625929872,right,T4b,696,-2,16,10,6
720575940638601030,right,T4b,697,1,-22,-12,-10
720575940615779807,right,T4b,698,6,-7,-10,3
720575940630378583,right,T4b,699,-5,0,5,-5
720575940615708266,right,T4b,700,5,15,2,13
720575940616052054,right,T4b,701,0,-4,-2,-2
720575940634893534,right,T4b,702,-5,23,16,7
720575940609762094,right,T4b,703,-3,1,3,-2
720575940624718862,right,T4b,704,-7,8,11,-3
720575940623289162,right,T4b,705,1,1,-1,2
720575940626050490,right,T4b,706,-7,-12,1,-13
720575940639501621,right,T4b,707,-2,25,14,11
720575940630153324,right,T4b,708,-4,-25,-9,-16
720575940608694795,right,T4b,709,-2,-24,-10,-14
720575940620148596,right,T4b,710,4,-25,-17,-8
720575940621674367,right,T4b,711,-1,19,10,9
720575940639067470,right,T4b,712,-7,12,13,-1
720575940641410011,right,T4b,713,-6,16,14,2
720575940631758562,right,T4b,714,5,12,1,11
720575940609062665,right,T4b,715,4,10,1,9
720575940612702105,right,T4b,716,4,-6,-7,1
720575940610086264,right,T4b,717,2,-22,-13,-9
720575940644146030,right,T4b,718,-5,24,17,7
720575940612621285,right,T4b,719,1,27,12,15
720575940620908969,right,T4b,720,-5,21,15,6
720575940639564870,right,T4b,721,5,13,1,12
720575940622107312,right,T4b,722,6,-15,-14,-1
720575940635234189,right,T4b,723,-2,-11,-4,-7
720575940621398399,right,T4b,724,4,2,-3,5
720575940641829851,right,T4b,725,-3,-24,-9,-15
720575940616949977,right,T4b,727,7,6,-4,10
720575940616770610,right,T4b,728,7,12,-1,13
720575940620355917,right,T4b,729,-3,29,17,12
720575940614241439,right,T4b,730,7,0,-7,7
720575940624388756,right,T4b,731,-6,9,10,-1
720575940643696676,right,T4b,732,-3,6,6,0
720575940623089348,right,T4b,733,-5,-17,-4,-13
720575940630700684,right,T4b,734,2,0,-2,2
720575940623153961,right,T4b,735,1,-23,-13,-10
720575940641435099,right,T4b,736,-8,1,8,-7
720575940617811929,right,T4b,737,0,19,9,10
720575940610582392,right,T4b,738,-3,13,9,4
720575940630754635,right,T4b,739,-7,2,8,-6
720575940640183936,right,T4b,740,2,-8,-6,-2
720575940608173916,right,T4b,741,-2,-14,-5,-9
720575940626458412,right,T4b,742,-4,11,9,2
720575940631894238,right,T4b,744,-4,25,16,9
720575940626955274,right,T4b,745,0,13,6,7
720575940619244112,right,T4b,746,-3,3,4,-1
720575940633946731,right,T4b,747,0,2,1,1
720575940638894406,right,T4b,748,-4,20,14,6
720575940629872172,right,T4b,749,-2,1,2,-1
720575940616614978,right,T4b,750,4,-24,-16,-8
720575940625672496,right,T4b,751,1,6,2,4
720575940641682128,right,T4b,752,-2,7,5,2
720575940630365689,right,T4b,753,-3,24,15,9
720575940640676925,right,T4b,754,-1,-13,-6,-7
720575940622290252,right,T4b,755,4,19,5,14
720575940622945041,right,T4b,756,5,20,5,15
720575940628876076,right,T4b,757,0,-6,-3,-3
720575940632973357,right,T4b,758,5,-1,-6,5
720575940615711338,right,T4b,759,7,14,0,14
720575940604835756,right,T4b,760,0,17,8,9
720575940635589044,right,T4b,761,-4,-18,-5,-13
720575940629209287,right,T4b,762,0,14,7,7
720575940615630934,right,T4b,763,-5,14,12,2
720575940616928185,right,T4b,764,-8,-6,5,-11
720575940613312423,right,T4b,765,-3,9,7,2
720575940608119770,right,T4b,766,2,-4,-4,0
720575940623811268,right,T4b,767,1,28,13,15
720575940624448492,right,T4b,768,3,5,-1,6
720575940624565006,right,T4b,770,5,4,-3,7
720575940642621344,right,T4b,772,1,12,5,7
720575940645949294,right,T4b,774,-8,6,11,-5
720575940643866568,right,T4b,776,5,21,5,16
720575940643705248,right,T4b,777,6,20,4,16
720575940636349108,right,T4b,780,-6,25,18,7
720575940613292595,right,T4b,781,-5,26,18,8
720575940647818116,right,T4b,782,-5,27,18,9
720575940629266179,right,T4b,783,-4,28,18,10
720575940614821630,right,T4b,784,-4,29,18,11
720575940626251308,right,T4b,785,-3,30,18,12
720575940620804288,right,T4b,786,-2,30,17,13
720575940636288357,right,T4b,788,3,27,10,17
720575940626302138,right,T4b,796,4,26,9,17
720575940641411547,right,T4c,1,-6,13,12,1
720575940619019313,right,T4c,2,-8,2,9,-7
720575940620613409,right,T4c,3,6,-12,-12,0
720575940611143266,right,T4c,4,-5,-21,-6,-15
720575940622126418,right,T4c,5,-1,16,9,7
720575940631222031,right,T4c,6,-2,-4,0,-4
720575940624663560,right,T4c,7,-6,-6,3,-9
720575940623336330,right,T4c,8,-4,26,17,9
720575940643533728,right,T4c,9,4,9,0,9
720575940614902459,right,T4c,10,5,-15,-13,-2
720575940603563893,right,T4c,11,7,-14,-14,0
720575940627102802,right,T4c,12,-7,9,11,-2
720575940615473002,right,T4c,13,-1,-26,-12,-14
720575940630428892,right,T4c,14,0,-27,-14,-13
720575940632269267,right,T4c,15,2,-3,-4,1
720575940627746069,right,T4c,16,-2,-16,-6,-10
720575940624226121,right,T4c,17,1,-5,-4,-1
720575940629887173,right,T4c,18,5,-16,-13,-3
720575940641423056,right,T4c,19,-7,17,15,2
720575940652594422,right,T4c,20,3,-11,-9,-2
720575940637822436,right,T4c,21,-2,19,11,8
720575940632074669,right,T4c,22,-1,3,2,1
720575940622221865,right,T4c,23,-3,-16,-5,-11
720575940640122240,right,T4c,24,-1,-10,-4,-6
720575940616696347,right,T4c,25,-9,3,10,-7
720575940639391184,right,T4c,26,1,-3,-3,0
720575940625052659,right,T4c,27,0,-25,-13,-12
720575940613892094,right,T4c,28,5,6,-2,8
720575940623310333,right,T4c,29,-1,-3,-1,-2
720575940622712609,right,T4c,30,6,16,2,14
720575940622012748,right,T4c,31,0,16,8,8
720575940616556561,right,T4c,32,0,12,6,6
720575940624003581,right,T4c,33,3,18,6,12
720575940631883883,right,T4c,34,6,18,3,15
720575940623813316,right,T4c,35,1,-24,-13,-11
720575940627834311,right,T4c,36,6,8,-2,10
720575940617002311,right,T4c,37,1,5,1,4
720575940613719294,right,T4c,38,0,-2,-1,-1
720575940633790745,right,T4c,39,0,20,10,10
720575940624196169,right,T4c,40,-2,-6,-1,-5
720575940647825540,right,T4c,41,-3,28,17,11
720575940620735691,right,T4c,42,-1,14,8,6
720575940604812204,right,T4c,43,-5,18,14,4
720575940660312449,right,T4c,44,5,-10,-10,0
720575940616616507,right,T4c,45,-5,-1,4,-5
720575940625119053,right,T4c,46,-5,15,12,3
720575940627100618,right,T4c,48,-4,-22,-7,-15
720575940622708429,right,T4c,49,4,-4,-6,2
720575940629767015,right,T4c,50,-2,21,12,9
720575940638331974,right,T4c,51,0,-19,-10,-9
720575940628917147,right,T4c,52,-1,-22,-10,-12
720575940628128842,right,T4c,53,5,14,2,12
720575940634284954,right,T4c,54,-4,3,5,-2
720575940627724456,right,T4c,55,-4,-11,-2,-9
720575940639844925,right,T4c,56,1,-13,-8,-5
720575940621759100,right,T4c,57,6,-11,-12,1
720575940627130442,right,T4c,58,3,12,3,9
720575940619197121,right,T4c,59,-2,2,3,-1
720575940622733097,right,T4c,60,-8,8,12,-4
720575940608085771,right,T4c,61,-4,-4,2,-6
720575940624552172,right,T4c,62,0,-29,-15,-14
720575940621514080,right,T4c,63,4,12,2,10
720575940642395637,right,T4c,64,4,-23,-16,-7
720575940633678734,right,T4c,65,-1,28,15,13
720575940620757926,right,T4c,66,2,15,5,10
720575940615449922,right,T4c,67,-2,-13,-5,-8
720575940617132761,right,T4c,68,3,16,5,11
720575940617780241,right,T4c,69,1,8,3,5
720575940615054815,right,T4c,70,-4,21,14,7
720575940623872492,right,T4c,71,-2,-3,0,-3
720575940632842148,right,T4c,72,0,-28,-14,-14
720575940621201078,right,T4c,73,2,2,-1,3
720575940638177087,right,T4c,74,-1,-9,-4,-5
720575940612971634,right,T4c,75,-6,14,13,1
720575940616961861,right,T4c,76,-3,-4,1,-5
720575940621505404,right,T4c,77,2,-5,-5,0
720575940645255022,right,T4c,78,2,20,8,12
720575940618376522,right,T4c,79,2,1,-2,3
720575940605751008,right,T4c,80,4,13,2,11
720575940629942827,right,T4c,81,6,-2,-7,5
720575940638987061,right,T4c,82,-7,7,10,-3
720575940623245706,right,T4c,83,2,-21,-13,-8
720575940627223634,right,T4c,84,-2,12,8,4
720575940612245454,right,T4c,85,4,-22,-15,-7
720575940612547813,right,T4c,86,-5,-7,1,-8
720575940627978183,right,T4c,87,1,11,4,7
720575940641648436,right,T4c,88,7,4,-5,9
720575940632025036,right,T4c,89,1,-19,-11,-8
720575940619451608,right,T4c,90,-4,5,6,-1
720575940624103861,right,T4c,91,-1,6,4,2
720575940623305620,right,T4c,92,0,9,4,5
720575940630429945,right,T4c,93,-6,3,7,-4
720575940608936284,right,T4c,94,5,18,4,14
720575940620992865,right,T4c,95,4,-21,-15,-6
720575940628574658,right,T4c,96,1,-10,-6,-4
720575940624941924,right,T4c,97,-5,2,6,-4
720575940635371405,right,T4c,98,-1,-12,-5,-7
720575940610759378,right,T4c,99,4,15,3,12
720575940625126635,right,T4c,100,2,-10,-7,-3
720575940643515296,right,T4c,101,-7,6,10,-4
720575940618037990,right,T4c,102,3,13,3,10
720575940605418942,right,T4c,103,7,9,-3,12
720575940626483600,right,T4c,104,-1,-27,-13,-14
720575940620672609,right,T4c,105,3,22,8,14
720575940632441427,right,T4c,106,-7,11,12,-1
720575940620935444,right,T4c,107,8,-2,-9,7
720575940636273294,right,T4c,108,-3,-12,-3,-9
720575940604636021,right,T4c,109,4,-5,-7,2
720575940628994203,right,T4c,110,-7,0,7,-7
720575940646845236,right,T4c,111,2,-24,-14,-10
720575940619415089,right,T4c,112,-6,1,6,-5
720575940635021247,right,T4c,113,-2,4,4,0
720575940620766817,right,T4c,114,2,-13,-9,-4
720575940613623848,right,T4c,115,-4,2,5,-3
720575940620306853,right,T4c,116,-1,-8,-3,-5
720575940620011503,right,T4c,117,-8,-2,7,-9
720575940631448716,right,T4c,118,3,1,-3,4
720575940630667576,right,T4c,119,-2,6,5,1
720575940619665005,right,T4c,120,-1,-1,0,-1
720575940617111513,right,T4c,122,-5,9,9,0
720575940618536350,right,T4c,123,-8,10,13,-3
720575940639402880,right,T4c,124,1,-7,-5,-2
720575940629814071,right,T4c,125,5,9,-1,10
720575940628456976,right,T4c,126,3,11,2,9
720575940610047698,right,T4c,127,0,15,7,8
720575940619265963,right,T4c,128,3,-22,-14,-8
720575940617017542,right,T4c,129,0,-13,-7,-6
720575940622684966,right,T4c,131,-6,20,16,4
720575940631598863,right,T4c,132,2,4,0,4
720575940613967839,right,T4c,133,-3,20,13,7
720575940624408840,right,T4c,134,-5,-18,-4,-14
720575940633295571,right,T4c,135,-3,-22,-8,-14
720575940628613775,right,T4c,136,0,3,1,2
720575940623118633,right,T4c,137,5,-7,-9,2
720575940625809182,right,T4c,138,0,27,13,14
720575940642763680,right,T4c,139,1,-14,-8,-6
720575940628951814,right,T4c,140,3,8,1,7
720575940628200721,right,T4c,141,5,-23,-17,-6
720575940639627608,right,T4c,142,-2,-18,-7,-11
720575940631345450,right,T4c,143,-4,16,12,4
720575940618368216,right,T4c,144,7,-11,-13,2
720575940637247322,right,T4c,145,0,4,2,2
720575940613591761,right,T4c,146,1,-6,-4,-2
720575940630829419,right,T4c,147,1,21,9,12
720575940622955363,right,T4c,148,-7,-11,1,-12
720575940649980537,right,T4c,149,6,-14,-13,-1
720575940638302067,right,T4c,150,-8,5,10,-5
720575940622006218,right,T4c,151,-3,-14,-4,-10
720575940635745648,right,T4c,152,3,-15,-11,-4
720575940605139116,right,T4c,153,8,0,-8,8
720575940612246258,right,T4c,154,-8,0,8,-8
720575940612237285,right,T4c,155,-8,13,14,-1
720575940633364388,right,T4c,156,-9,1,9,-8
720575940634346135,right,T4c,157,-1,-7,-3,-4
720575940611173474,right,T4c,158,3,-5,-6,1
720575940634385945,right,T4c,159,7,7,-4,11
720575940605470310,right,T4c,160,-2,20,12,8
720575940640475856,right,T4c,161,4,-14,-11,-3
720575940626800403,right,T4c,162,-4,-2,3,-5
720575940636538286,right,T4c,163,-9,7,12,-5
720575940631339700,right,T4c,164,-1,-2,0,-2
720575940630587855,right,T4c,165,4,16,4,12
720575940620637266,right,T4c,166,0,18,9,9
720575940619368128,right,T4c,167,0,-17,-9,-8
720575940630067164,right,T4c,168,-1,17,9,8
720575940614540199,right,T4c,169,0,-18,-9,-9
720575940621180912,right,T4c,170,-5,1,5,-4
720575940635951727,right,T4c,171,6,-20,-16,-4
720575940642045147,right,T4c,172,1,22,10,12
720575940633387233,right,T4c,173,2,-25,-15,-10
720575940628546682,right,T4c,174,4,-15,-12,-3
720575940632310328,right,T4c,175,-6,-7,2,-9
720575940621475293,right,T4c,176,-2,13,8,5
720575940620012782,right,T4c,177,-2,-1,1,-2
720575940633392083,right,T4c,178,2,11,3,8
720575940624322196,right,T4c,179,-5,-16,-3,-13
720575940631030603,right,T4c,180,2,-27,-16,-11
720575940605180844,right,T4c,181,1,-4,-3,-1
720575940622057989,right,T4c,182,7,-10,-12,2
720575940621689613,right,T4c,183,-5,-15,-3,-12
720575940626859804,right,T4c,184,-6,-5,3,-8
720575940631615993,right,T4c,185,2,-11,-8,-3
720575940630925942,right,T4c,186,-1,26,14,12
720575940620644434,right,T4c,187,3,21,7,14
720575940612049777,right,T4c,188,-5,17,13,4
720575940645597719,right,T4c,189,6,13,0,13
720575940615070687,right,T4c,190,-3,-5,0,-5
720575940620760029,right,T4c,191,-1,-11,-5,-6
720575940628488811,right,T4c,192,7,10,-2,12
720575940636228782,right,T4c,193,-5,4,7,-3
720575940630426947,right,T4c,194,0,-5,-3,-2
720575940627454407,right,T4c,195,-3,-1,2,-3
720575940610845333,right,T4c,196,-1,8,5,3
720575940624201805,right,T4c,197,0,-20,-10,-10
720575940613190125,right,T4c,198,6,2,-5,7
720575940626370691,right,T4c,199,0,-12,-6,-6
720575940637084991,right,T4c,200,-5,12,11,1
720575940628620547,right,T4c,201,-8,9,12,-3
720575940604983398,right,T4c,202,-1,27,14,13
720575940600850441,right,T4c,203,3,-1,-4,3
720575940640571088,right,T4c,204,5,-2,-6,4
720575940604636789,right,T4c,205,5,-6,-8,2
720575940623014185,right,T4c,206,-3,5,5,0
720575940609042955,right,T4c,207,1,29,13,16
720575940626104457,right,T4c,208,5,-21,-16,-5
720575940627002626,right,T4c,209,-3,-8,-1,-7
720575940631885964,right,T4c,210,-6,8,10,-2
720575940610585646,right,T4c,211,-7,-1,6,-7
720575940633597285,right,T4c,212,2,-16,-10,-6
720575940627562250,right,T4c,213,3,-4,-5,1
720575940608519689,right,T4c,214,-5,3,6,-3
720575940628099130,right,T4c,215,6,7,-3,10
720575940619716961,right,T4c,216,2,19,7,12
720575940625540185,right,T4c,217,6,15,1,14
720575940628347774,right,T4c,219,6,-4,-8,4
720575940610508334,right,T4c,220,2,-6,-5,-1
720575940606521545,right,T4c,221,-7,3,8,-5
720575940630793943,right,T4c,222,-3,26,16,10
720575940629322395,right,T4c,223,-2,26,15,11
720575940638747251,right,T4c,225,2,-26,-15,-11
720575940630086394,right,T4c,226,5,19,4,15
720575940612289689,right,T4c,227,-7,5,9,-4
720575940615610930,right,T4c,228,-7,1,7,-6
720575940619734987,right,T4c,229,5,2,-4,6
720575940634830699,right,T4c,230,2,9,2,7
720575940636906893,right,T4c,231,4,-12,-10,-2
720575940611212238,right,T4c,232,-4,13,10,3
720575940612960661,right,T4c,233,4,-13,-11,-2
720575940620314246,right,T4c,234,1,3,0,3
720575940621522272,right,T4c,235,4,11,1,10
720575940629063106,right,T4c,236,-1,4,3,1
720575940620913798,right,T4c,237,-2,27,15,12
720575940646004003,right,T4c,238,-8,-3,6,-9
720575940618517794,right,T4c,239,-6,6,9,-3
720575940632591897,right,T4c,240,-4,-3,2,-5
720575940630809448,right,T4c,241,2,-17,-11,-6
720575940617180305,right,T4c,242,-4,6,7,-1
720575940631270556,right,T4c,243,-1,-21,-10,-11
720575940620117669,right,T4c,244,-4,-12,-2,-10
720575940623820873,right,T4c,245,-5,-3,3,-6
720575940614431378,right,T4c,246,-4,15,11,4
720575940644787479,right,T4c,247,-4,-15,-4,-11
720575940631438696,right,T4c,248,-6,0,6,-6
720575940633943708,right,T4c,249,2,-12,-8,-4
720575940618344571,right,T4c,250,-1,1,1,0
720575940628223570,right,T4c,251,-1,-14,-6,-8
720575940618773840,right,T4c,253,5,16,3,13
720575940627825051,right,T4c,254,3,-24,-15,-9
720575940616191861,right,T4c,255,-6,-13,-1,-12
720575940610303790,right,T4c,256,5,-20,-15,-5
720575940605432422,right,T4c,257,2,21,8,13
720575940614101043,right,T4c,258,-4,-17,-5,-12
720575940631406587,right,T4c,259,-7,-5,4,-9
720575940617781661,right,T4c,260,-3,19,12,7
720575940617643705,right,T4c,261,-1,13,7,6
720575940619580245,right,T4c,262,1,-11,-7,-4
720575940620017829,right,T4c,263,-3,4,5,-1
720575940627288580,right,T4c,264,-1,-6,-2,-4
720575940658822785,right,T4c,265,-6,-1,5,-6
720575940620922748,right,T4c,266,-1,-25,-12,-13
720575940629557803,right,T4c,267,-6,2,7,-5
720575940612221669,right,T4c,268,7,-6,-10,4
720575940639032910,right,T4c,269,2,-19,-12,-7
720575940630739705,right,T4c,270,1,-8,-5,-3
720575940622199105,right,T4c,271,4,6,-1,7
720575940619889729,right,T4c,272,3,-2,-4,2
720575940607131570,right,T4c,273,-6,23,17,6
720575940627306261,right,T4c,274,6,4,-4,8
720575940620697520,right,T4c,275,-8,-1,7,-8
720575940641656116,right,T4c,276,2,3,-1,4
720575940631610472,right,T4c,277,7,-3,-9,6
720575940620608365,right,T4c,278,-5,10,10,0
720575940612874803,right,T4c,279,-4,8,8,0
720575940612176090,right,T4c,280,-6,-14,-1,-13
720575940614174098,right,T4c,281,-9,2,10,-8
720575940635454827,right,T4c,282,0,26,13,13
720575940627110226,right,T4c,283,-4,4,6,-2
720575940629766247,right,T4c,284,0,25,12,13
720575940617098681,right,T4c,285,6,-18,-15,-3
720575940614854034,right,T4c,286,0,-24,-12,-12
720575940638284622,right,T4c,287,-5,13,11,2
720575940632931294,right,T4c,288,-1,30,16,14
720575940621651694,right,T4c,289,-1,11,6,5
720575940635683695,right,T4c,290,5,-24,-17,-7
720575940621454719,right,T4c,291,7,2,-6,8
720575940612755314,right,T4c,292,-4,18,13,5
720575940617771803,right,T4c,293,4,-17,-13,-4
720575940620519173,right,T4c,294,1,-20,-11,-9
720575940621651366,right,T4c,295,-2,29,16,13
720575940638533208,right,T4c,296,1,-18,-10,-8
720575940649627257,right,T4c,297,7,-9,-12,3
720575940631514179,right,T4c,298,-5,5,7,-2
720575940608394249,right,T4c,299,-4,12,10,2
720575940609843298,right,T4c,300,4,-18,-13,-5
720575940626174210,right,T4c,301,-5,16,13,3
720575940635446264,right,T4c,302,2,17,6,11
720575940631054649,right,T4c,303,-5,22,16,6
720575940617194937,right,T4c,304,6,5,-4,9
720575940612316313,right,T4c,305,-7,4,9,-5
720575940607784405,right,T4c,306,3,7,0,7
720575940617227449,right,T4c,307,5,-25,-18,-7
720575940640240117,right,T4c,308,-5,8,9,-1
720575940634914411,right,T4c,309,-6,12,12,0
720575940620260998,right,T4c,310,2,22,9,13
720575940623997931,right,T4c,312,4,-7,-8,1
720575940628105488,right,T4c,313,7,3,-6,9
720575940653493750,right,T4c,314,-9,5,11,-6
720575940620228212,right,T4c,315,-3,-6,0,-6
720575940617449250,right,T4c,316,5,-4,-7,3
720575940624609511,right,T4c,317,-5,-4,3,-7
720575940630945551,right,T4c,318,4,-19,-14,-5
720575940624478608,right,T4c,319,-2,5,4,1
720575940625653228,right,T4c,320,-2,-5,-1,-4
720575940638250054,right,T4c,321,8,4,-6,10
720575940628112456,right,T4c,322,2,26,11,15
720575940617967773,right,T4c,323,-7,-13,0,-13
720575940617699998,right,T4c,325,5,1,-5,6
720575940604898662,right,T4c,326,2,16,6,10
720575940616517749,right,T4c,327,5,3,-4,7
720575940604622453,right,T4c,328,5,-9,-10,1
720575940620476436,right,T4c,329,0,24,12,12
720575940624499947,right,T4c,330,3,3,-2,5
720575940614559894,right,T4c,331,1,-15,-9,-6
720575940623910397,right,T4c,332,4,-26,-17,-9
720575940633978649,right,T4c,333,0,-21,-11,-10
720575940628195527,right,T4c,334,1,-26,-14,-12
720575940630723671,right,T4c,335,2,8,2,6
720575940634767711,right,T4c,336,0,23,11,12
720575940620243591,right,T4c,337,-5,-6,2,-8
720575940628694121,right,T4c,338,-1,0,1,-1
720575940629486891,right,T4c,339,6,11,-1,12
720575940633380192,right,T4c,340,-4,17,12,5
720575940611795320,right,T4c,341,6,-17,-15,-2
720575940636612324,right,T4c,342,2,-15,-10,-5
720575940626876291,right,T4c,343,-3,27,16,11
720575940635633588,right,T4c,345,3,-12,-9,-3
720575940632389201,right,T4c,346,-7,-9,2,-11
720575940637645790,right,T4c,347,-5,-13,-2,-11
720575940626555589,right,T4c,348,3,14,4,10
720575940614102579,right,T4c,349,-5,-14,-2,-12
720575940619647808,right,T4c,350,1,15,6,9
720575940603904496,right,T4c,351,-1,-17,-8,-9
720575940617578201,right,T4c,352,-2,28,16,12
720575940630251884,right,T4c,353,2,24,10,14
720575940618258845,right,T4c,354,-2,-26,-11,-15
720575940626349242,right,T4c,355,-7,-6,4,-10
720575940632685004,right,T4c,356,0,22,11,11
720575940620394257,right,T4c,357,4,17,4,13
720575940631736680,right,T4c,358,-3,17,11,6
720575940623312874,right,T4c,359,2,23,9,14
720575940634874975,right,T4c,360,-5,19,14,5
720575940630043727,right,T4c,361,0,-7,-4,-3
720575940607955723,right,T4c,362,2,-20,-12,-8
720575940603797420,right,T4c,363,7,-4,-9,5
720575940627442831,right,T4c,364,4,4,-2,6
720575940630268780,right,T4c,365,4,7,-1,8
720575940626070714,right,T4c,366,-5,-20,-5,-15
720575940624685204,right,T4c,367,-6,-15,-2,-13
720575940622342012,right,T4c,368,-4,-20,-6,-14
720575940630182364,right,T4c,369,5,-5,-8,3
720575940610835922,right,T4c,370,-3,21,13,8
720575940628657914,right,T4c,371,6,-5,-9,4
720575940631286343,right,T4c,372,1,-2,-2,0
720575940617193428,right,T4c,373,1,-21,-12,-9
720575940654504353,right,T4c,374,2,13,4,9
720575940635700335,right,T4c,375,-6,7,9,-2
720575940636059503,right,T4c,376,-7,-10,2,-12
720575940617514241,right,T4c,377,0,7,3,4
720575940626721688,right,T4c,378,-3,18,12,6
720575940603391712,right,T4c,379,3,-17,-12,-5
720575940626702026,right,T4c,380,-1,29,15,14
720575940628806782,right,T4c,381,-8,-9,3,-12
720575940637610597,right,T4c,382,3,-6,-6,0
720575940631935116,right,T4c,383,-6,11,11,0
720575940648649860,right,T4c,384,-6,-2,5,-7
720575940618757430,right,T4c,385,-3,-18,-6,-12
720575940612415146,right,T4c,386,-6,19,15,4
720575940632760933,right,T4c,387,-1,-15,-7,-8
720575940637627749,right,T4c,388,3,19,6,13
720575940631961657,right,T4c,389,-6,-16,-2,-14
720575940640150912,right,T4c,390,-6,-9,1,-10
720575940627131910,right,T4c,391,4,-3,-6,3
720575940627113994,right,T4c,392,-4,7,7,0
720575940627410793,right,T4c,393,-1,22,12,10
720575940629023494,right,T4c,394,-7,-8,3,-11
720575940632813357,right,T4c,395,0,-22,-11,-11
720575940634067612,right,T4c,396,-1,10,6,4
720575940632712275,right,T4c,397,-3,-19,-7,-12
720575940631971346,right,T4c,398,-3,22,14,8
720575940634193008,right,T4c,399,-4,-24,-8,-16
720575940627179401,right,T4c,400,1,-29,-16,-13
720575940653694881,right,T4c,401,-2,-19,-8,-11
720575940645362542,right,T4c,402,3,26,10,16
720575940634182937,right,T4c,403,-2,-12,-4,-8
720575940616931101,right,T4c,404,-1,20,11,9
720575940612694755,right,T4c,405,3,10,2,8
720575940628180617,right,T4c,406,1,-25,-14,-11
720575940646191236,right,T4c,407,-5,-10,0,-10
720575940615255446,right,T4c,408,-6,-4,4,-8
720575940615803807,right,T4c,409,0,-3,-2,-1
720575940615068895,right,T4c,410,-2,-2,1,-3
720575940630315052,right,T4c,411,-5,-19,-5,-14
720575940626857260,right,T4c,412,-6,21,16,5
720575940612761458,right,T4c,413,-2,-7,-2,-5
720575940620397841,right,T4c,414,4,21,6,15
720575940628122186,right,T4c,415,6,12,0,12
720575940620506862,right,T4c,416,3,-8,-7,-1
720575940618910228,right,T4c,417,-6,-10,1,-11
720575940628591619,right,T4c,418,-2,15,9,6
720575940644958487,right,T4c,419,-3,-11,-3,-8
720575940626976180,right,T4c,420,6,-3,-8,5
720575940605671625,right,T4c,421,-1,12,7,5
720575940623653098,right,T4c,422,-7,-4,5,-9
720575940638872765,right,T4c,423,3,-18,-12,-6
720575940621229552,right,T4c,424,-3,-2,2,-4
720575940630381007,right,T4c,426,-3,0,3,-3
720575940629435130,right,T4c,427,5,-18,-14,-4
720575940620894854,right,T4c,428,-2,23,13,10
720575940614218655,right,T4c,429,-2,14,9,5
720575940624748327,right,T4c,430,-3,-7,-1,-6
720575940612579763,right,T4c,431,-2,-10,-3,-7
720575940623167172,right,T4c,432,-5,7,8,-1
720575940623748277,right,T4c,433,0,-8,-4,-4
720575940620625067,right,T4c,434,-3,7,6,1
720575940638350406,right,T4c,435,5,-17,-14,-3
720575940632168612,right,T4c,436,0,-15,-8,-7
720575940627116298,right,T4c,437,-3,12,9,3
720575940635313562,right,T4c,438,2,27,11,16
720575940617397433,right,T4c,439,-3,-9,-2,-7
720575940630219479,right,T4c,440,1,23,10,13
720575940628097768,right,T4c,441,3,-16,-11,-5
720575940624710379,right,T4c,442,-5,25,17,8
720575940606521801,right,T4c,443,-6,4,8,-4
720575940659976065,right,T4c,444,4,-10,-9,-1
720575940624007176,right,T4c,445,-2,8,6,2
720575940616643618,right,T4c,446,2,-14,-9,-5
720575940644174958,right,T4c,447,-1,2,2,0
720575940624582985,right,T4c,448,0,30,15,15
720575940640356952,right,T4c,449,6,-16,-14,-2
720575940619962612,right,T4c,450,2,-9,-7,-2
720575940619979313,right,T4c,451,4,20,6,14
720575940637555853,right,T4c,452,1,-9,-6,-3
720575940640066382,right,T4c,454,5,-12,-11,-1
720575940642090400,right,T4c,455,7,-7,-11,4
720575940630801605,right,T4c,456,0,21,10,11
720575940607702876,right,T4c,457,-2,17,10,7
720575940632007860,right,T4c,458,5,0,-5,5
720575940646592564,right,T4c,459,5,-3,-7,4
720575940610732130,right,T4c,460,-3,-20,-7,-13
720575940639535438,right,T4c,461,7,-5,-10,5
720575940621674061,right,T4c,462,-1,18,10,8
720575940620771937,right,T4c,463,5,17,3,14
720575940620953724,right,T4c,464,4,0,-4,4
720575940628233744,right,T4c,465,3,0,-3,3
720575940638681934,right,T4c,466,1,14,6,8
720575940608362076,right,T4c,467,-2,-20,-8,-12
720575940621024124,right,T4c,468,-3,11,8,3
720575940629428350,right,T4c,469,-7,13,13,0
720575940646585140,right,T4c,470,4,-9,-9,0
720575940627753810,right,T4c,471,3,-26,-16,-10
720575940605980337,right,T4c,472,1,25,11,14
720575940623208376,right,T4c,473,-4,23,15,8
720575940628364806,right,T4c,474,-3,-17,-6,-11
720575940623133075,right,T4c,475,-4,-1,3,-4
720575940616524305,right,T4c,476,-1,15,8,7
720575940635330484,right,T4c,477,-3,2,4,-2
720575940619278552,right,T4c,478,-7,16,15,1
720575940630126391,right,T4c,479,-2,10,7,3
720575940618665595,right,T4c,480,3,-19,-13,-6
720575940621429492,right,T4c,481,4,-8,-8,0
720575940622319498,right,T4c,482,1,17,7,10
720575940633641442,right,T4c,483,2,-7,-6,-1
720575940621124980,right,T4c,484,3,-9,-8,-1
720575940626402712,right,T4c,485,-3,-3,1,-4
720575940628369418,right,T4c,486,0,1,0,1
720575940632861779,right,T4c,487,1,-1,-2,1
720575940623000614,right,T4c,488,7,5,-5,10
720575940622177712,right,T4c,489,-3,10,8,2
720575940622787683,right,T4c,490,-5,6,8,-2
720575940621555821,right,T4c,491,7,-1,-8,7
720575940632817069,right,T4c,492,-7,-2,6,-8
720575940616452950,right,T4c,493,-3,23,14,9
720575940621824577,right,T4c,494,0,29,14,15
720575940623074598,right,T4c,495,4,5,-2,7
720575940616516865,right,T4c,496,7,8,-3,11
720575940637610468,right,T4c,497,6,1,-6,7
720575940638675034,right,T4c,498,6,10,-1,11
720575940636338789,right,T4c,499,5,10,0,10
720575940627259155,right,T4c,500,7,-8,-11,3
720575940617646265,right,T4c,501,1,2,0,2
720575940621468352,right,T4c,502,5,8,-1,9
720575940632588430,right,T4c,504,-2,9,6,3
720575940644664855,right,T4c,505,6,-22,-17,-5
720575940615160991,right,T4c,506,1,-12,-7,-5
720575940619119006,right,T4c,507,-5,-12,-1,-11
720575940619372736,right,T4c,508,-5,11,10,1
720575940625731002,right,T4c,509,-4,10,9,1
720575940637809124,right,T4c,510,-2,11,7,4
720575940604142453,right,T4c,511,5,-11,-11,0
720575940638396724,right,T4c,512,6,0,-6,6
720575940614678237,right,T4c,513,-4,-13,-3,-10
720575940621781261,right,T4c,514,-4,-10,-1,-9
720575940630675756,right,T4c,515,-8,-7,4,-11
720575940618114082,right,T4c,516,7,-18,-16,-2
720575940647192708,right,T4c,517,6,3,-5,8
720575940626534914,right,T4c,518,-4,22,15,7
720575940632332333,right,T4c,519,-5,-5,2,-7
720575940624671636,right,T4c,520,-2,-22,-9,-13
720575940631725880,right,T4c,521,6,-9,-11,2
720575940620878836,right,T4c,522,-4,0,4,-4
720575940615741145,right,T4c,523,2,14,5,9
720575940632301523,right,T4c,524,4,-20,-14,-6
720575940625460099,right,T4c,525,-1,-20,-9,-11
720575940639743310,right,T4c,526,0,-10,-5,-5
720575940629558906,right,T4c,527,-4,-8,0,-8
720575940632190092,right,T4c,528,2,7,1,6
720575940616714068,right,T4c,529,2,-2,-3,1
720575940614822621,right,T4c,530,-3,-13,-4,-9
720575940616788573,right,T4c,531,1,0,-1,1
720575940612622102,right,T4c,532,-8,7,11,-4
720575940623296147,right,T4c,533,0,-16,-8,-8
720575940623011096,right,T4c,534,3,2,-2,4
720575940619097560,right,T4c,535,8,-4,-10,6
720575940619198110,right,T4c,536,3,4,-1,5
720575940615215170,right,T4c,537,0,-23,-12,-11
720575940623288260,right,T4c,538,-4,1,4,-3
720575940627453995,right,T4c,539,-6,15,13,2
720575940618485312,right,T4c,540,-2,-9,-3,-6
720575940631307212,right,T4c,541,-4,14,11,3
720575940633695201,right,T4c,542,6,-13,-13,0
720575940614239338,right,T4c,543,-1,-4,-1,-3
720575940633372627,right,T4c,544,3,-13,-10,-3
720575940608947413,right,T4c,545,5,11,0,11
720575940626633615,right,T4c,546,3,6,0,6
720575940621477458,right,T4c,547,-1,21,11,10
720575940622320861,right,T4c,548,1,-16,-9,-7
720575940614347774,right,T4c,549,0,-9,-5,-4
720575940626926991,right,T4c,550,-2,3,3,0
720575940622218876,right,T4c,551,-4,-9,-1,-8
720575940623151240,right,T4c,552,4,-1,-5,4
720575940623323530,right,T4c,553,-3,16,11,5
720575940604804798,right,T4c,555,-4,9,8,1
720575940615512482,right,T4c,556,0,10,5,5
720575940630186556,right,T4c,557,6,-10,-11,1
720575940627027733,right,T4c,558,-4,-21,-7,-14
720575940613972451,right,T4c,559,-6,22,17,5
720575940634089116,right,T4c,560,-7,14,14,0
720575940630989899,right,T4c,561,5,7,-2,9
720575940609832387,right,T4c,562,-5,-2,4,-6
720575940608317362,right,T4c,563,5,-13,-12,-1
720575940621111381,right,T4c,564,3,-23,-15,-8
720575940627115038,right,T4c,565,0,-26,-13,-13
720575940603498613,right,T4c,566,5,-8,-9,1
720575940619956045,right,T4c,567,-2,22,13,9
720575940630675415,right,T4c,568,-6,-8,2,-10
720575940624018675,right,T4c,569,6,6,-3,9
720575940627179539,right,T4c,570,2,25,10,15
720575940631944775,right,T4c,571,0,-14,-7,-7
720575940638730805,right,T4c,572,-8,3,9,-6
720575940618381981,right,T4c,573,4,14,3,11
720575940629808940,right,T4c,574,-6,5,8,-3
720575940639565126,right,T4c,575,6,9,-2,11
720575940632439400,right,T4c,576,0,28,14,14
720575940623706549,right,T4c,577,5,-14,-12,-2
720575940628418639,right,T4c,578,4,-11,-10,-1
720575940607194290,right,T4c,579,-3,-10,-2,-8
720575940605762406,right,T4c,580,-2,-23,-10,-13
720575940628876647,right,T4c,581,3,9,1,8
720575940628463977,right,T4c,582,-1,23,12,11
720575940613032600,right,T4c,583,3,-25,-16,-9
720575940626579784,right,T4c,584,4,23,7,16
720575940630625654,right,T4c,585,-1,-23,-11,-12
720575940619572053,right,T4c,586,2,18,7,11
720575940602928608,right,T4c,587,4,22,7,15
720575940659518849,right,T4c,588,1,4,1,3
720575940639273535,right,T4c,589,-1,-5,-2,-3
720575940638379136,right,T4c,590,1,9,3,6
720575940622094377,right,T4c,591,3,-3,-5,2
720575940623449284,right,T4c,592,3,-28,-17,-11
720575940637701005,right,T4c,593,3,-14,-10,-4
720575940623705599,right,T4c,594,7,-16,-15,-1
720575940641272309,right,T4c,595,7,-12,-13,1
720575940624331047,right,T4c,596,-4,-16,-4,-12
720575940622128161,right,T4c,597,4,1,-4,5
720575940646458500,right,T4c,598,2,-18,-11,-7
720575940641138829,right,T4c,599,-1,9,5,4
720575940631784808,right,T4c,600,3,-10,-8,-2
720575940632280680,right,T4c,601,1,16,7,9
720575940621727493,right,T4c,602,4,-2,-5,3
720575940619459126,right,T4c,603,-3,-23,-9,-14
720575940620603519,right,T4c,604,-6,-17,-3,-14
720575940631557699,right,T4c,605,3,15,4,11
720575940622586467,right,T4c,606,-1,-19,-9,-10
720575940620515857,right,T4c,607,1,18,8,10
720575940621507568,right,T4c,608,1,10,4,6
720575940618700504,right,T4c,609,-2,0,2,-2
720575940618925947,right,T4c,610,2,-23,-14,-9
720575940623460292,right,T4c,611,-1,-18,-8,-10
720575940625653543,right,T4c,612,-3,-26,-10,-16
720575940631671889,right,T4c,613,-8,-4,6,-10
720575940619274118,right,T4c,614,-2,-8,-2,-6
720575940644133924,right,T4c,615,-7,-7,3,-10
720575940631009810,right,T4c,616,-3,15,10,5
720575940629263098,right,T4c,617,-2,-17,-7,-10
720575940628861244,right,T4c,618,-1,24,13,11
720575940624296265,right,T4c,619,-4,-19,-6,-13
720575940637741801,right,T4c,620,7,1,-7,8
720575940620693999,right,T4c,621,1,24,11,13
720575940616015803,right,T4c,622,-5,20,15,5
720575940617760670,right,T4c,623,1,13,5,8
720575940616872331,right,T4c,624,1,-17,-10,-7
720575940632032360,right,T4c,625,-2,24,14,10
720575940618750006,right,T4c,626,-5,-8,1,-9
720575940615035699,right,T4c,627,0,-1,-1,0
720575940631122489,right,T4c,628,0,0,0,0
720575940612318065,right,T4c,629,4,24,8,16
720575940627446549,right,T4c,630,4,8,0,8
720575940618468692,right,T4c,631,1,26,12,14
720575940617216441,right,T4c,632,3,-20,-13,-7
720575940624248319,right,T4c,633,-1,-24,-11,-13
720575940639387856,right,T4c,634,-3,-15,-5,-10
720575940604635253,right,T4c,635,6,-6,-9,3
720575940608697412,right,T4c,636,0,6,3,3
720575940633103772,right,T4c,637,3,-21,-14,-7
720575940629969936,right,T4c,638,-1,7,4,3
720575940623123494,right,T4c,639,-4,19,13,6
720575940630086876,right,T4c,640,-1,-16,-7,-9
720575940617832788,right,T4c,641,-8,-5,5,-10
720575940605840514,right,T4c,642,-5,-11,-1,-10
720575940624660231,right,T4c,643,6,14,1,13
720575940604521952,right,T4c,644,-6,18,15,3
720575940635219903,right,T4c,645,-4,27,17,10
720575940618074205,right,T4c,646,6,17,2,15
720575940636449678,right,T4c,647,-4,-7,0,-7
720575940613903978,right,T4c,648,1,7,2,5
720575940622892493,right,T4c,649,-1,5,3,2
720575940627216259,right,T4c,650,-3,-25,-10,-15
720575940627082633,right,T4c,651,-4,-5,1,-6
720575940617241437,right,T4c,652,-6,-11,0,-11
720575940622953059,right,T4c,653,-6,-12,0,-12
720575940632576910,right,T4c,654,-3,8,7,1
720575940621130849,right,T4c,655,6,-1,-7,6
720575940623410163,right,T4c,656,0,-11,-6,-5
720575940638174953,right,T4c,657,-2,-25,-11,-14
720575940628303857,right,T4c,658,1,20,9,11
720575940624598771,right,T4c,659,-4,-6,1,-7
720575940619531502,right,T4c,660,2,28,12,16
720575940632825261,right,T4c,661,-3,14,10,4
720575940618489115,right,T4c,662,2,-1,-3,2
720575940644622628,right,T4c,663,0,8,4,4
720575940625374541,right,T4c,664,1,-27,-15,-12
720575940608408282,right,T4c,665,7,-2,-8,6
720575940626256421,right,T4c,666,7,-13,-14,1
720575940616794930,right,T4c,667,1,-28,-15,-13
720575940622944525,right,T4c,668,1,19,8,11
720575940620213268,right,T4c,669,4,-16,-12,-4
720575940620384848,right,T4c,670,5,5,-3,8
720575940632169356,right,T4c,671,-4,-23,-8,-15
720575940616530006,right,T4c,672,-8,11,13,-2
720575940608760843,right,T4c,673,2,5,0,5
720575940617342169,right,T4c,674,-4,-14,-3,-11
720575940609108316,right,T4c,675,-7,19,16,3
720575940614905759,right,T4c,676,-3,-21,-8,-13
720575940634302560,right,T4c,678,3,-7,-7,0
720575940640238499,right,T4c,679,4,18,5,13
720575940626210860,right,T4c,680,-1,25,13,12
720575940618270877,right,T4c,681,-2,-21,-9,-12
720575940613712109,right,T4c,682,6,-8,-10,2
720575940617348582,right,T4c,683,2,6,1,5
720575940623447530,right,T4c,684,-6,17,14,3
720575940631369925,right,T4c,685,-5,-9,0,-9
720575940614926954,right,T4c,687,-6,-3,4,-7
720575940639642968,right,T4c,688,-7,10,12,-2
720575940612207589,right,T4c,689,-2,18,11,7
720575940632950684,right,T4c,690,-7,-3,5,-8
720575940616748249,right,T4c,691,-9,4,11,-7
720575940624703979,right,T4c,692,-4,24,16,8
720575940616238521,right,T4c,693,-3,25,15,10
720575940623237267,right,T4c,694,4,3,-3,6
720575940632629551,right,T4c,695,-6,10,11,-1
720575940612584173,right,T4c,696,-2,16,10,6
720575940624379721,right,T4c,697,1,-22,-12,-10
720575940627193481,right,T4c,698,6,-7,-10,3
720575940619185099,right,T4c,699,-5,0,5,-5
720575940628405064,right,T4c,700,5,15,2,13
720575940620887535,right,T4c,701,0,-4,-2,-2
720575940622648344,right,T4c,702,-5,23,16,7
720575940629580414,right,T4c,703,-3,1,3,-2
720575940612319658,right,T4c,704,-7,8,11,-3
720575940626840775,right,T4c,705,1,1,-1,2
720575940624985095,right,T4c,706,-7,-12,1,-13
720575940627702534,right,T4c,707,-2,25,14,11
720575940621086299,right,T4c,708,-4,-25,-9,-16
720575940613117206,right,T4c,709,-2,-24,-10,-14
720575940624269036,right,T4c,710,4,-25,-17,-8
720575940624822503,right,T4c,711,-1,19,10,9
720575940633297377,right,T4c,712,-7,12,13,-1
720575940633583187,right,T4c,713,-6,16,14,2
720575940624490829,right,T4c,714,5,12,1,11
720575940636903024,right,T4c,715,4,10,1,9
720575940619182507,right,T4c,716,4,-6,-7,1
720575940611806357,right,T4c,717,2,-22,-13,-9
720575940605880497,right,T4c,718,-5,24,17,7
720575940629528080,right,T4c,719,1,27,12,15
720575940635075038,right,T4c,720,-5,21,15,6
720575940638392390,right,T4c,721,5,13,1,12
720575940630978391,right,T4c,722,6,-15,-14,-1
720575940627732904,right,T4c,723,-2,-11,-4,-7
720575940638729048,right,T4c,724,4,2,-3,5
720575940623736617,right,T4c,725,-3,-24,-9,-15
720575940636459877,right,T4c,726,2,-28,-16,-12
720575940611250040,right,T4c,727,7,6,-4,10
720575940607632306,right,T4c,728,7,12,-1,13
720575940633678478,right,T4c,729,-3,29,17,12
720575940610633682,right,T4c,730,7,0,-7,7
720575940622804237,right,T4c,731,-6,9,10,-1
720575940631521484,right,T4c,732,-3,6,6,0
720575940622975211,right,T4c,733,-5,-17,-4,-13
720575940617644171,right,T4c,734,2,0,-2,2
720575940637797609,right,T4c,735,1,-23,-13,-10
720575940617474561,right,T4c,736,-8,1,8,-7
720575940617809809,right,T4c,737,0,19,9,10
720575940624247629,right,T4c,738,-3,13,9,4
720575940622738445,right,T4c,739,-7,2,8,-6
720575940624951335,right,T4c,740,2,-8,-6,-2
720575940635350520,right,T4c,741,-2,-14,-5,-9
720575940622475263,right,T4c,742,-4,11,9,2
720575940633179949,right,T4c,743,6,-19,-16,-3
720575940627110385,right,T4c,744,-4,25,16,9
720575940616664337,right,T4c,745,0,13,6,7
720575940618340416,right,T4c,746,-3,3,4,-1
720575940624166837,right,T4c,747,0,2,1,1
720575940603394272,right,T4c,748,-4,20,14,6
720575940625276990,right,T4c,749,-2,1,2,-1
720575940630066908,right,T4c,750,4,-24,-16,-8
720575940619608405,right,T4c,751,1,6,2,4
720575940634333852,right,T4c,752,-2,7,5,2
720575940627772815,right,T4c,753,-3,24,15,9
720575940635927151,right,T4c,754,-1,-13,-6,-7
720575940627327034,right,T4c,755,4,19,5,14
720575940613498262,right,T4c,756,5,20,5,15
720575940627657749,right,T4c,757,0,-6,-3,-3
720575940639963224,right,T4c,758,5,-1,-6,5
720575940630304894,right,T4c,759,7,14,0,14
720575940630988625,right,T4c,760,0,17,8,9
720575940619784033,right,T4c,761,-4,-18,-5,-13
720575940613262573,right,T4c,762,0,14,7,7
720575940621044084,right,T4c,763,-5,14,12,2
720575940627478147,right,T4c,764,-8,-6,5,-11
720575940619765670,right,T4c,765,-3,9,7,2
720575940637958207,right,T4c,766,2,-4,-4,0
720575940660102273,right,T4c,767,1,28,13,15
720575940618782599,right,T4c,768,3,5,-1,6
720575940614208664,right,T4c,769,4,-27,-18,-9
720575940616224414,right,T4c,770,5,4,-3,7
720575940622958412,right,T4c,771,3,-27,-17,-10
720575940626852373,right,T4c,772,1,12,5,7
720575940606480073,right,T4c,773,5,-19,-15,-4
720575940619675989,right,T4c,774,-8,6,11,-5
720575940630868165,right,T4c,775,5,22,6,16
720575940647362436,right,T4c,777,6,20,4,16
720575940630610046,right,T4c,778,4,25,8,17
720575940625859879,right,T4c,780,-6,25,18,7
720575940615221758,right,T4c,781,-5,26,18,8
720575940624124716,right,T4c,782,-5,27,18,9
720575940618265172,right,T4c,783,-4,28,18,10
720575940610050499,right,T4c,784,-4,29,18,11
720575940627963525,right,T4c,785,-3,30,18,12
720575940615408757,right,T4c,786,-2,30,17,13
720575940620696229,right,T4c,788,3,27,10,17
720575940622713724,right,T4c,789,-3,-27,-11,-16
720575940608585993,right,T4c,790,-2,-27,-12,-15
720575940622536030,right,T4c,791,-1,-28,-13,-15
720575940633181410,right,T4c,792,8,2,-7,9
720575940620901870,right,T4c,793,8,-6,-11,5
720575940639204927,right,T4c,794,5,-26,-18,-8
720575940623228637,right,T4c,795,6,-21,-17,-4
720575940624694823,right,T4d,1,-6,13,12,1
720575940626358617,right,T4d,2,-8,2,9,-7
720575940635562347,right,T4d,3,6,-12,-12,0
720575940623235622,right,T4d,4,-5,-21,-6,-15
720575940630444396,right,T4d,5,-1,16,9,7
720575940622468940,right,T4d,6,-2,-4,0,-4
720575940617361206,right,T4d,7,-6,-6,3,-9
720575940625856039,right,T4d,8,-4,26,17,9
720575940619181739,right,T4d,9,4,9,0,9
720575940633805267,right,T4d,10,5,-15,-13,-2
720575940659863937,right,T4d,11,7,-14,-14,0
720575940629826007,right,T4d,12,-7,9,11,-2
720575940622196001,right,T4d,13,-1,-26,-12,-14
720575940640338229,right,T4d,15,2,-3,-4,1
720575940639522163,right,T4d,16,-2,-16,-6,-10
720575940620431013,right,T4d,17,1,-5,-4,-1
720575940644663831,right,T4d,18,5,-16,-13,-3
720575940637836634,right,T4d,19,-7,17,15,2
720575940625529362,right,T4d,20,3,-11,-9,-2
720575940615954282,right,T4d,21,-2,19,11,8
720575940613905514,right,T4d,22,-1,3,2,1
720575940622739981,right,T4d,23,-3,-16,-5,-11
720575940635252109,right,T4d,24,-1,-10,-4,-6
720575940620992773,right,T4d,26,1,-3,-3,0
720575940614248866,right,T4d,27,0,-25,-13,-12
720575940623374591,right,T4d,28,5,6,-2,8
720575940638695220,right,T4d,29,-1,-3,-1,-2
720575940614299047,right,T4d,30,6,16,2,14
720575940617971217,right,T4d,31,0,16,8,8
720575940616680587,right,T4d,32,0,12,6,6
720575940622108442,right,T4d,33,3,18,6,12
720575940630086906,right,T4d,34,6,18,3,15
720575940605241516,right,T4d,35,1,-24,-13,-11
720575940616008350,right,T4d,36,6,8,-2,10
720575940629457786,right,T4d,37,1,5,1,4
720575940641440397,right,T4d,38,0,-2,-1,-1
720575940630465910,right,T4d,39,0,20,10,10
720575940627709672,right,T4d,40,-2,-6,-1,-5
720575940647286068,right,T4d,41,-3,28,17,11
720575940615263298,right,T4d,42,-1,14,8,6
720575940638480755,right,T4d,43,-5,18,14,4
720575940624519876,right,T4d,44,5,-10,-10,0
720575940605528166,right,T4d,45,-5,-1,4,-5
720575940607063730,right,T4d,46,-5,15,12,3
720575940632072722,right,T4d,48,-4,-22,-7,-15
720575940625123879,right,T4d,49,4,-4,-6,2
720575940616368667,right,T4d,50,-2,21,12,9
720575940623481226,right,T4d,51,0,-19,-10,-9
720575940622987400,right,T4d,52,-1,-22,-10,-12
720575940628126449,right,T4d,53,5,14,2,12
720575940627396881,right,T4d,54,-4,3,5,-2
720575940636768090,right,T4d,55,-4,-11,-2,-9
720575940615782962,right,T4d,56,1,-13,-8,-5
720575940630738775,right,T4d,57,6,-11,-12,1
720575940649890425,right,T4d,58,3,12,3,9
720575940621344169,right,T4d,59,-2,2,3,-1
720575940634947167,right,T4d,61,-4,-4,2,-6
720575940621520736,right,T4d,63,4,12,2,10
720575940623052326,right,T4d,64,4,-23,-16,-7
720575940622935832,right,T4d,65,-1,28,15,13
720575940658882945,right,T4d,66,2,15,5,10
720575940622246090,right,T4d,67,-2,-13,-5,-8
720575940620961718,right,T4d,68,3,16,5,11
720575940638179561,right,T4d,69,1,8,3,5
720575940613462579,right,T4d,70,-4,21,14,7
720575940620894630,right,T4d,71,-2,-3,0,-3
720575940616946805,right,T4d,72,0,-28,-14,-14
720575940636650382,right,T4d,73,2,2,-1,3
720575940627435791,right,T4d,74,-1,-9,-4,-5
720575940652673526,right,T4d,75,-6,14,13,1
720575940611180005,right,T4d,76,-3,-4,1,-5
720575940628377618,right,T4d,77,2,-5,-5,0
720575940627420162,right,T4d,78,2,20,8,12
720575940626580879,right,T4d,79,2,1,-2,3
720575940631107359,right,T4d,80,4,13,2,11
720575940631846324,right,T4d,81,6,-2,-7,5
720575940620843644,right,T4d,82,-7,7,10,-3
720575940603842476,right,T4d,83,2,-21,-13,-8
720575940621380566,right,T4d,84,-2,12,8,4
720575940635537037,right,T4d,85,4,-22,-15,-7
720575940635560895,right,T4d,86,-5,-7,1,-8
720575940609899844,right,T4d,87,1,11,4,7
720575940621004148,right,T4d,88,7,4,-5,9
720575940628310546,right,T4d,89,1,-19,-11,-8
720575940616369013,right,T4d,90,-4,5,6,-1
720575940619184461,right,T4d,91,-1,6,4,2
720575940610585976,right,T4d,92,0,9,4,5
720575940623087498,right,T4d,93,-6,3,7,-4
720575940622882045,right,T4d,94,5,18,4,14
720575940635913071,right,T4d,95,4,-21,-15,-6
720575940646818868,right,T4d,96,1,-10,-6,-4
720575940620568966,right,T4d,97,-5,2,6,-4
720575940635252877,right,T4d,98,-1,-12,-5,-7
720575940637373918,right,T4d,99,4,15,3,12
720575940620704773,right,T4d,100,2,-10,-7,-3
720575940634825567,right,T4d,101,-7,6,10,-4
720575940614947039,right,T4d,102,3,13,3,10
720575940647120419,right,T4d,103,7,9,-3,12
720575940631031855,right,T4d,104,-1,-27,-13,-14
720575940632313764,right,T4d,105,3,22,8,14
720575940632057425,right,T4d,106,-7,11,12,-1
720575940625310029,right,T4d,108,-3,-12,-3,-9
720575940604637045,right,T4d,109,4,-5,-7,2
720575940626358361,right,T4d,110,-7,0,7,-7
720575940621041005,right,T4d,111,2,-24,-14,-10
720575940620671367,right,T4d,112,-6,1,6,-5
720575940652343030,right,T4d,113,-2,4,4,0
720575940620637935,right,T4d,114,2,-13,-9,-4
720575940614358695,right,T4d,115,-4,2,5,-3
720575940615688770,right,T4d,116,-1,-8,-3,-5
720575940619792202,right,T4d,118,3,1,-3,4
720575940623322918,right,T4d,119,-2,6,5,1
720575940624033831,right,T4d,120,-1,-1,0,-1
720575940627111250,right,T4d,121,-8,4,10,-6
720575940616677154,right,T4d,122,-5,9,9,0
720575940612508851,right,T4d,123,-8,10,13,-3
720575940633875808,right,T4d,124,1,-7,-5,-2
720575940621730584,right,T4d,125,5,9,-1,10
720575940605674417,right,T4d,126,3,11,2,9
720575940637380062,right,T4d,127,0,15,7,8
720575940606991817,right,T4d,128,3,-22,-14,-8
720575940607047810,right,T4d,129,0,-13,-7,-6
720575940621654305,right,T4d,130,2,12,4,8
720575940627157745,right,T4d,131,-6,20,16,4
720575940615339743,right,T4d,132,2,4,0,4
720575940619565003,right,T4d,133,-3,20,13,7
720575940613551510,right,T4d,134,-5,-18,-4,-14
720575940606934473,right,T4d,135,-3,-22,-8,-14
720575940631219500,right,T4d,136,0,3,1,2
720575940634538135,right,T4d,137,5,-7,-9,2
720575940634182355,right,T4d,138,0,27,13,14
720575940629672318,right,T4d,139,1,-14,-8,-6
720575940632810285,right,T4d,140,3,8,1,7
720575940630331095,right,T4d,141,5,-23,-17,-6
720575940604436720,right,T4d,142,-2,-18,-7,-11
720575940627116042,right,T4d,143,-4,16,12,4
720575940622964957,right,T4d,144,7,-11,-13,2
720575940622504191,right,T4d,145,0,4,2,2
720575940613534614,right,T4d,146,1,-6,-4,-2
720575940608846019,right,T4d,147,1,21,9,12
720575940629933561,right,T4d,148,-7,-11,1,-12
720575940621609989,right,T4d,149,6,-14,-13,-1
720575940626794250,right,T4d,150,-8,5,10,-5
720575940606014898,right,T4d,151,-3,-14,-4,-10
720575940630343030,right,T4d,152,3,-15,-11,-4
720575940646594356,right,T4d,153,8,0,-8,8
720575940630809400,right,T4d,154,-8,0,8,-8
720575940630368343,right,T4d,156,-9,1,9,-8
720575940612066802,right,T4d,157,-1,-7,-3,-4
720575940615758130,right,T4d,158,3,-5,-6,1
720575940624529703,right,T4d,159,7,7,-4,11
720575940611903962,right,T4d,160,-2,20,12,8
720575940630645356,right,T4d,161,4,-14,-11,-3
720575940633643490,right,T4d,162,-4,-2,3,-5
720575940622086614,right,T4d,164,-1,-2,0,-2
720575940614030559,right,T4d,165,4,16,4,12
720575940647837572,right,T4d,166,0,18,9,9
720575940628121874,right,T4d,167,0,-17,-9,-8
720575940624804178,right,T4d,168,-1,17,9,8
720575940626676057,right,T4d,169,0,-18,-9,-9
720575940614929002,right,T4d,170,-5,1,5,-4
720575940636042607,right,T4d,171,6,-20,-16,-4
720575940627717288,right,T4d,172,1,22,10,12
720575940620855206,right,T4d,173,2,-25,-15,-10
720575940627399445,right,T4d,174,4,-15,-12,-3
720575940621271974,right,T4d,175,-6,-7,2,-9
720575940622234662,right,T4d,176,-2,13,8,5
720575940625923203,right,T4d,177,-2,-1,1,-2
720575940631561784,right,T4d,178,2,11,3,8
720575940634573408,right,T4d,179,-5,-16,-3,-13
720575940630185342,right,T4d,180,2,-27,-16,-11
720575940634388064,right,T4d,181,1,-4,-3,-1
720575940638660678,right,T4d,182,7,-10,-12,2
720575940632413544,right,T4d,183,-5,-15,-3,-12
720575940626206352,right,T4d,184,-6,-5,3,-8
720575940643411912,right,T4d,185,2,-11,-8,-3
720575940616297689,right,T4d,186,-1,26,14,12
720575940627473683,right,T4d,187,3,21,7,14
720575940612617881,right,T4d,188,-5,17,13,4
720575940630454263,right,T4d,189,6,13,0,13
720575940628559403,right,T4d,190,-3,-5,0,-5
720575940617904541,right,T4d,191,-1,-11,-5,-6
720575940612879795,right,T4d,192,7,10,-2,12
720575940627595012,right,T4d,193,-5,4,7,-3
720575940617888157,right,T4d,194,0,-5,-3,-2
720575940620980390,right,T4d,195,-3,-1,2,-3
720575940621945880,right,T4d,196,-1,8,5,3
720575940616686225,right,T4d,197,0,-20,-10,-10
720575940624279444,right,T4d,198,6,2,-5,7
720575940613810483,right,T4d,199,0,-12,-6,-6
720575940614273022,right,T4d,200,-5,12,11,1
720575940637790298,right,T4d,201,-8,9,12,-3
720575940625284396,right,T4d,202,-1,27,14,13
720575940600934665,right,T4d,203,3,-1,-4,3
720575940631937460,right,T4d,204,5,-2,-6,4
720575940637405150,right,T4d,205,5,-6,-8,2
720575940625947692,right,T4d,206,-3,5,5,0
720575940623383788,right,T4d,208,5,-21,-16,-5
720575940617557649,right,T4d,209,-3,-8,-1,-7
720575940606569417,right,T4d,210,-6,8,10,-2
720575940639224381,right,T4d,211,-7,-1,6,-7
720575940646506019,right,T4d,212,2,-16,-10,-6
720575940622951571,right,T4d,213,3,-4,-5,1
720575940618475422,right,T4d,214,-5,3,6,-3
720575940631687471,right,T4d,215,6,7,-3,10
720575940608708309,right,T4d,216,2,19,7,12
720575940621351151,right,T4d,217,6,15,1,14
720575940632220719,right,T4d,218,2,10,3,7
720575940603498357,right,T4d,219,6,-4,-8,4
720575940637257869,right,T4d,220,2,-6,-5,-1
720575940632353453,right,T4d,221,-7,3,8,-5
720575940624248772,right,T4d,222,-3,26,16,10
720575940629163536,right,T4d,223,-2,26,15,11
720575940619454379,right,T4d,224,0,5,2,3
720575940660346497,right,T4d,225,2,-26,-15,-11
720575940621130356,right,T4d,226,5,19,4,15
720575940621194501,right,T4d,227,-7,5,9,-4
720575940624619022,right,T4d,228,-7,1,7,-6
720575940611049678,right,T4d,229,5,2,-4,6
720575940627671061,right,T4d,230,2,9,2,7
720575940637818857,right,T4d,231,4,-12,-10,-2
720575940633696666,right,T4d,232,-4,13,10,3
720575940626305554,right,T4d,233,4,-13,-11,-2
720575940634788703,right,T4d,234,1,3,0,3
720575940629254594,right,T4d,235,4,11,1,10
720575940631680312,right,T4d,236,-1,4,3,1
720575940632920030,right,T4d,237,-2,27,15,12
720575940627414184,right,T4d,238,-8,-3,6,-9
720575940622089181,right,T4d,239,-6,6,9,-3
720575940619972998,right,T4d,240,-4,-3,2,-5
720575940630265339,right,T4d,241,2,-17,-11,-6
720575940616934203,right,T4d,242,-4,6,7,-1
720575940639523187,right,T4d,243,-1,-21,-10,-11
720575940633973529,right,T4d,244,-4,-12,-2,-10
720575940618432413,right,T4d,245,-5,-3,3,-6
720575940610861717,right,T4d,246,-4,15,11,4
720575940638039268,right,T4d,247,-4,-15,-4,-11
720575940645627927,right,T4d,248,-6,0,6,-6
720575940625926448,right,T4d,249,2,-12,-8,-4
720575940632222381,right,T4d,250,-1,1,1,0
720575940622776200,right,T4d,251,-1,-14,-6,-8
720575940625612848,right,T4d,252,3,23,8,15
720575940639110222,right,T4d,253,5,16,3,13
720575940620718575,right,T4d,254,3,-24,-15,-9
720575940623541898,right,T4d,255,-6,-13,-1,-12
720575940619849069,right,T4d,256,5,-20,-15,-5
720575940646143267,right,T4d,257,2,21,8,13
720575940612391661,right,T4d,258,-4,-17,-5,-12
720575940621833096,right,T4d,259,-7,-5,4,-9
720575940626565178,right,T4d,260,-3,19,12,7
720575940626554713,right,T4d,261,-1,13,7,6
720575940646146083,right,T4d,262,1,-11,-7,-4
720575940619410737,right,T4d,263,-3,4,5,-1
720575940624320951,right,T4d,264,-1,-6,-2,-4
720575940630511557,right,T4d,265,-6,-1,5,-6
720575940622826493,right,T4d,266,-1,-25,-12,-13
720575940624854798,right,T4d,267,-6,2,7,-5
720575940603556981,right,T4d,268,7,-6,-10,4
720575940620593323,right,T4d,269,2,-19,-12,-7
720575940627932232,right,T4d,270,1,-8,-5,-3
720575940622479228,right,T4d,271,4,6,-1,7
720575940660286337,right,T4d,272,3,-2,-4,2
720575940636817806,right,T4d,273,-6,23,17,6
720575940623034308,right,T4d,274,6,4,-4,8
720575940615643442,right,T4d,275,-8,-1,7,-8
720575940622929688,right,T4d,276,2,3,-1,4
720575940630526009,right,T4d,277,7,-3,-9,6
720575940626680506,right,T4d,278,-5,10,10,0
720575940620316865,right,T4d,279,-4,8,8,0
720575940639708531,right,T4d,280,-6,-14,-1,-13
720575940625235331,right,T4d,282,0,26,13,13
720575940623469034,right,T4d,283,-4,4,6,-2
720575940622149887,right,T4d,284,0,25,12,13
720575940617495867,right,T4d,286,0,-24,-12,-12
720575940638064061,right,T4d,287,-5,13,11,2
720575940628864247,right,T4d,289,-1,11,6,5
720575940618183569,right,T4d,290,5,-24,-17,-7
720575940620348144,right,T4d,291,7,2,-6,8
720575940613984943,right,T4d,292,-4,18,13,5
720575940627828241,right,T4d,293,4,-17,-13,-4
720575940620480134,right,T4d,294,1,-20,-11,-9
720575940633683086,right,T4d,295,-2,29,16,13
720575940612105690,right,T4d,296,1,-18,-10,-8
720575940623229737,right,T4d,297,7,-9,-12,3
720575940624648124,right,T4d,298,-5,5,7,-2
720575940627023047,right,T4d,299,-4,12,10,2
720575940625890878,right,T4d,300,4,-18,-13,-5
720575940614269351,right,T4d,301,-5,16,13,3
720575940636141943,right,T4d,302,2,17,6,11
720575940620747553,right,T4d,303,-5,22,16,6
720575940613670963,right,T4d,304,6,5,-4,9
720575940626080356,right,T4d,305,-7,4,9,-5
720575940627776143,right,T4d,306,3,7,0,7
720575940632613262,right,T4d,308,-5,8,9,-1
720575940628835015,right,T4d,309,-6,12,12,0
720575940622189436,right,T4d,310,2,22,9,13
720575940626592664,right,T4d,311,-7,15,14,1
720575940608792026,right,T4d,312,4,-7,-8,1
720575940620903856,right,T4d,313,7,3,-6,9
720575940622821133,right,T4d,314,-9,5,11,-6
720575940631879480,right,T4d,315,-3,-6,0,-6
720575940612549490,right,T4d,316,5,-4,-7,3
720575940604902921,right,T4d,317,-5,-4,3,-7
720575940620235867,right,T4d,318,4,-19,-14,-5
720575940619436709,right,T4d,319,-2,5,4,1
720575940616594037,right,T4d,320,-2,-5,-1,-4
720575940639814051,right,T4d,322,2,26,11,15
720575940628236999,right,T4d,323,-7,-13,0,-13
720575940607961283,right,T4d,324,3,24,9,15
720575940635789620,right,T4d,325,5,1,-5,6
720575940615686486,right,T4d,326,2,16,6,10
720575940616439330,right,T4d,327,5,3,-4,7
720575940646180228,right,T4d,328,5,-9,-10,1
720575940620786624,right,T4d,329,0,24,12,12
720575940621299677,right,T4d,330,3,3,-2,5
720575940628135698,right,T4d,331,1,-15,-9,-6
720575940622228997,right,T4d,332,4,-26,-17,-9
720575940623855367,right,T4d,333,0,-21,-11,-10
720575940618778914,right,T4d,334,1,-26,-14,-12
720575940610562424,right,T4d,335,2,8,2,6
720575940614245329,right,T4d,336,0,23,11,12
720575940625986441,right,T4d,337,-5,-6,2,-8
720575940604946720,right,T4d,338,-1,0,1,-1
720575940638125646,right,T4d,339,6,11,-1,12
720575940613711279,right,T4d,340,-4,17,12,5
720575940652151798,right,T4d,341,6,-17,-15,-2
720575940621480575,right,T4d,342,2,-15,-10,-5
720575940627479326,right,T4d,343,-3,27,16,11
720575940604679664,right,T4d,344,-2,-15,-6,-9
720575940632009007,right,T4d,345,3,-12,-9,-3
720575940610690709,right,T4d,347,-5,-13,-2,-11
720575940630588111,right,T4d,348,3,14,4,10
720575940615489858,right,T4d,350,1,15,6,9
720575940612234725,right,T4d,351,-1,-17,-8,-9
720575940646791715,right,T4d,352,-2,28,16,12
720575940619763849,right,T4d,353,2,24,10,14
720575940603356896,right,T4d,354,-2,-26,-11,-15
720575940635824751,right,T4d,355,-7,-6,4,-10
720575940620782318,right,T4d,356,0,22,11,11
720575940619353211,right,T4d,357,4,17,4,13
720575940626505226,right,T4d,358,-3,17,11,6
720575940643737367,right,T4d,359,2,23,9,14
720575940624704491,right,T4d,360,-5,19,14,5
720575940634716570,right,T4d,361,0,-7,-4,-3
720575940612365464,right,T4d,362,2,-20,-12,-8
720575940614118142,right,T4d,363,7,-4,-9,5
720575940616306078,right,T4d,364,4,4,-2,6
720575940615481019,right,T4d,365,4,7,-1,8
720575940634542191,right,T4d,366,-5,-20,-5,-15
720575940628620535,right,T4d,367,-6,-15,-2,-13
720575940639917171,right,T4d,368,-4,-20,-6,-14
720575940609352387,right,T4d,369,5,-5,-8,3
720575940641994741,right,T4d,370,-3,21,13,8
720575940623191757,right,T4d,371,6,-5,-9,4
720575940641610804,right,T4d,372,1,-2,-2,0
720575940621339574,right,T4d,373,1,-21,-12,-9
720575940628525073,right,T4d,374,2,13,4,9
720575940619723911,right,T4d,375,-6,7,9,-2
720575940627756968,right,T4d,376,-7,-10,2,-12
720575940630968773,right,T4d,377,0,7,3,4
720575940632402892,right,T4d,378,-3,18,12,6
720575940639508387,right,T4d,379,3,-17,-12,-5
720575940623274760,right,T4d,380,-1,29,15,14
720575940628549754,right,T4d,382,3,-6,-6,0
720575940640240373,right,T4d,383,-6,11,11,0
720575940630469881,right,T4d,384,-6,-2,5,-7
720575940620332308,right,T4d,385,-3,-18,-6,-12
720575940620746849,right,T4d,386,-6,19,15,4
720575940618502841,right,T4d,387,-1,-15,-7,-8
720575940610876258,right,T4d,388,3,19,6,13
720575940628816683,right,T4d,390,-6,-9,1,-10
720575940617092957,right,T4d,391,4,-3,-6,3
720575940626771528,right,T4d,392,-4,7,7,0
720575940640632528,right,T4d,393,-1,22,12,10
720575940639038798,right,T4d,394,-7,-8,3,-11
720575940625396238,right,T4d,395,0,-22,-11,-11
720575940610793365,right,T4d,396,-1,10,6,4
720575940622498184,right,T4d,397,-3,-19,-7,-12
720575940630269500,right,T4d,398,-3,22,14,8
720575940623096004,right,T4d,401,-2,-19,-8,-11
720575940616947573,right,T4d,402,3,26,10,16
720575940620553069,right,T4d,403,-2,-12,-4,-8
720575940626507036,right,T4d,404,-1,20,11,9
720575940630108204,right,T4d,405,3,10,2,8
720575940624187389,right,T4d,406,1,-25,-14,-11
720575940626019465,right,T4d,407,-5,-10,0,-10
720575940625020820,right,T4d,408,-6,-4,4,-8
720575940627263400,right,T4d,409,0,-3,-2,-1
720575940639659648,right,T4d,410,-2,-2,1,-3
720575940611121506,right,T4d,411,-5,-19,-5,-14
720575940632442828,right,T4d,412,-6,21,16,5
720575940608999363,right,T4d,413,-2,-7,-2,-5
720575940623148936,right,T4d,414,4,21,6,15
720575940632429416,right,T4d,415,6,12,0,12
720575940626053936,right,T4d,416,3,-8,-7,-1
720575940620464832,right,T4d,417,-6,-10,1,-11
720575940610345426,right,T4d,418,-2,15,9,6
720575940623021897,right,T4d,419,-3,-11,-3,-8
720575940625066483,right,T4d,420,6,-3,-8,5
720575940632861267,right,T4d,421,-1,12,7,5
720575940623289187,right,T4d,422,-7,-4,5,-9
720575940605446590,right,T4d,423,3,-18,-12,-6
720575940621380890,right,T4d,424,-3,-2,2,-4
720575940620313873,right,T4d,425,3,20,7,13
720575940612082090,right,T4d,426,-3,0,3,-3
720575940617936197,right,T4d,427,5,-18,-14,-4
720575940621236918,right,T4d,428,-2,23,13,10
720575940615524806,right,T4d,429,-2,14,9,5
720575940619376331,right,T4d,430,-3,-7,-1,-6
720575940631251543,right,T4d,431,-2,-10,-3,-7
720575940627471633,right,T4d,432,-5,7,8,-1
720575940620222811,right,T4d,433,0,-8,-4,-4
720575940627988123,right,T4d,434,-3,7,6,1
720575940609078723,right,T4d,435,5,-17,-14,-3
720575940637934682,right,T4d,436,0,-15,-8,-7
720575940630774376,right,T4d,437,-3,12,9,3
720575940626235180,right,T4d,438,2,27,11,16
720575940636936282,right,T4d,439,-3,-9,-2,-7
720575940619676269,right,T4d,440,1,23,10,13
720575940620957643,right,T4d,441,3,-16,-11,-5
720575940610364228,right,T4d,442,-5,25,17,8
720575940629600812,right,T4d,443,-6,4,8,-4
720575940623788012,right,T4d,444,4,-10,-9,-1
720575940643696420,right,T4d,445,-2,8,6,2
720575940624883495,right,T4d,446,2,-14,-9,-5
720575940638025550,right,T4d,447,-1,2,2,0
720575940624683838,right,T4d,448,0,30,15,15
720575940628997531,right,T4d,450,2,-9,-7,-2
720575940621478738,right,T4d,451,4,20,6,14
720575940612065522,right,T4d,452,1,-9,-6,-3
720575940636307823,right,T4d,453,3,25,9,16
720575940623949565,right,T4d,454,5,-12,-11,-1
720575940659978625,right,T4d,455,7,-7,-11,4
720575940617306324,right,T4d,456,0,21,10,11
720575940629885696,right,T4d,457,-2,17,10,7
720575940632009908,right,T4d,458,5,0,-5,5
720575940638107956,right,T4d,459,5,-3,-7,4
720575940624630252,right,T4d,460,-3,-20,-7,-13
720575940639363491,right,T4d,461,7,-5,-10,5
720575940623345077,right,T4d,462,-1,18,10,8
720575940634237791,right,T4d,463,5,17,3,14
720575940637247845,right,T4d,464,4,0,-4,4
720575940631244306,right,T4d,465,3,0,-3,3
720575940625995274,right,T4d,466,1,14,6,8
720575940615363295,right,T4d,467,-2,-20,-8,-12
720575940625956652,right,T4d,468,-3,11,8,3
720575940621626094,right,T4d,469,-7,13,13,0
720575940621231269,right,T4d,470,4,-9,-9,0
720575940610492484,right,T4d,471,3,-26,-16,-10
720575940636022903,right,T4d,472,1,25,11,14
720575940631897362,right,T4d,473,-4,23,15,8
720575940623255254,right,T4d,475,-4,-1,3,-4
720575940630070007,right,T4d,476,-1,15,8,7
720575940625952258,right,T4d,477,-3,2,4,-2
720575940627230750,right,T4d,478,-7,16,15,1
720575940625956140,right,T4d,479,-2,10,7,3
720575940639230067,right,T4d,480,3,-19,-13,-6
720575940619944363,right,T4d,481,4,-8,-8,0
720575940631010578,right,T4d,482,1,17,7,10
720575940632114191,right,T4d,484,3,-9,-8,-1
720575940623999157,right,T4d,485,-3,-3,1,-4
720575940619295983,right,T4d,486,0,1,0,1
720575940621776645,right,T4d,487,1,-1,-2,1
720575940628017482,right,T4d,488,7,5,-5,10
720575940627698947,right,T4d,489,-3,10,8,2
720575940630469699,right,T4d,490,-5,6,8,-2
720575940630020171,right,T4d,491,7,-1,-8,7
720575940632816813,right,T4d,492,-7,-2,6,-8
720575940646760739,right,T4d,493,-3,23,14,9
720575940626869804,right,T4d,494,0,29,14,15
720575940616303774,right,T4d,495,4,5,-2,7
720575940616236446,right,T4d,496,7,8,-3,11
720575940623237011,right,T4d,497,6,1,-6,7
720575940641259995,right,T4d,498,6,10,-1,11
720575940624203534,right,T4d,499,5,10,0,10
720575940624858126,right,T4d,500,7,-8,-11,3
720575940625439560,right,T4d,501,1,2,0,2
720575940626662686,right,T4d,502,5,8,-1,9
720575940631887464,right,T4d,503,3,17,5,12
720575940619166029,right,T4d,504,-2,9,6,3
720575940618283961,right,T4d,505,6,-22,-17,-5
720575940610532501,right,T4d,506,1,-12,-7,-5
720575940622218620,right,T4d,507,-5,-12,-1,-11
720575940634195819,right,T4d,508,-5,11,10,1
720575940608253379,right,T4d,509,-4,10,9,1
720575940630566113,right,T4d,510,-2,11,7,4
720575940606071217,right,T4d,511,5,-11,-11,0
720575940631830083,right,T4d,512,6,0,-6,6
720575940610735458,right,T4d,513,-4,-13,-3,-10
720575940631444299,right,T4d,514,-4,-10,-1,-9
720575940647839108,right,T4d,515,-8,-7,4,-11
720575940617488641,right,T4d,517,6,3,-5,8
720575940606319206,right,T4d,518,-4,22,15,7
720575940616664833,right,T4d,519,-5,-5,2,-7
720575940617488852,right,T4d,520,-2,-22,-9,-13
720575940632922835,right,T4d,521,6,-9,-11,2
720575940622877453,right,T4d,522,-4,0,4,-4
720575940634358196,right,T4d,523,2,14,5,9
720575940609896459,right,T4d,524,4,-20,-14,-6
720575940617783809,right,T4d,525,-1,-20,-9,-11
720575940619883073,right,T4d,526,0,-10,-5,-5
720575940622318174,right,T4d,527,-4,-8,0,-8
720575940624334333,right,T4d,528,2,7,1,6
720575940631027397,right,T4d,529,2,-2,-3,1
720575940623329279,right,T4d,530,-3,-13,-4,-9
720575940610814328,right,T4d,531,1,0,-1,1
720575940618720926,right,T4d,532,-8,7,11,-4
720575940610637266,right,T4d,533,0,-16,-8,-8
720575940639144125,right,T4d,534,3,2,-2,4
720575940616658549,right,T4d,535,8,-4,-10,6
720575940625668878,right,T4d,536,3,4,-1,5
720575940628523207,right,T4d,537,0,-23,-12,-11
720575940632922067,right,T4d,538,-4,1,4,-3
720575940640961269,right,T4d,539,-6,15,13,2
720575940629315995,right,T4d,540,-2,-9,-3,-6
720575940635186839,right,T4d,541,-4,14,11,3
720575940615132738,right,T4d,542,6,-13,-13,0
720575940641672333,right,T4d,543,-1,-4,-1,-3
720575940604567486,right,T4d,544,3,-13,-10,-3
720575940610428099,right,T4d,546,3,6,0,6
720575940637060238,right,T4d,547,-1,21,11,10
720575940621317814,right,T4d,548,1,-16,-9,-7
720575940624067145,right,T4d,549,0,-9,-5,-4
720575940625075749,right,T4d,550,-2,3,3,0
720575940619984469,right,T4d,551,-4,-9,-1,-8
720575940616649145,right,T4d,552,4,-1,-5,4
720575940621494256,right,T4d,553,-3,16,11,5
720575940626277434,right,T4d,555,-4,9,8,1
720575940623722510,right,T4d,556,0,10,5,5
720575940612696854,right,T4d,557,6,-10,-11,1
720575940647797892,right,T4d,558,-4,-21,-7,-14
720575940624463764,right,T4d,559,-6,22,17,5
720575940633293599,right,T4d,560,-7,14,14,0
720575940616420438,right,T4d,561,5,7,-2,9
720575940618979402,right,T4d,562,-5,-2,4,-6
720575940610481528,right,T4d,563,5,-13,-12,-1
720575940639846645,right,T4d,564,3,-23,-15,-8
720575940644426184,right,T4d,565,0,-26,-13,-13
720575940619885110,right,T4d,566,5,-8,-9,1
720575940614514444,right,T4d,567,-2,22,13,9
720575940638632538,right,T4d,568,-6,-8,2,-10
720575940627702012,right,T4d,569,6,6,-3,9
720575940622588893,right,T4d,570,2,25,10,15
720575940622364492,right,T4d,571,0,-14,-7,-7
720575940636153486,right,T4d,572,-8,3,9,-6
720575940618727291,right,T4d,573,4,14,3,11
720575940638352755,right,T4d,574,-6,5,8,-3
720575940622681215,right,T4d,575,6,9,-2,11
720575940636603640,right,T4d,577,5,-14,-12,-2
720575940622200090,right,T4d,578,4,-11,-10,-1
720575940612401381,right,T4d,579,-3,-10,-2,-8
720575940628621047,right,T4d,580,-2,-23,-10,-13
720575940616424209,right,T4d,581,3,9,1,8
720575940630298615,right,T4d,582,-1,23,12,11
720575940613665432,right,T4d,583,3,-25,-16,-9
720575940613113511,right,T4d,584,4,23,7,16
720575940618251333,right,T4d,585,-1,-23,-11,-12
720575940654702753,right,T4d,586,2,18,7,11
720575940627747144,right,T4d,587,4,22,7,15
720575940621347964,right,T4d,588,1,4,1,3
720575940638006244,right,T4d,589,-1,-5,-2,-3
720575940628630889,right,T4d,590,1,9,3,6
720575940631656877,right,T4d,591,3,-3,-5,2
720575940622725756,right,T4d,592,3,-28,-17,-11
720575940622910744,right,T4d,593,3,-14,-10,-4
720575940620069712,right,T4d,595,7,-12,-13,1
720575940628942183,right,T4d,596,-4,-16,-4,-12
720575940617483094,right,T4d,597,4,1,-4,5
720575940612702515,right,T4d,598,2,-18,-11,-7
720575940627930011,right,T4d,599,-1,9,5,4
720575940620736704,right,T4d,600,3,-10,-8,-2
720575940630026770,right,T4d,601,1,16,7,9
720575940637442630,right,T4d,602,4,-2,-5,3
720575940635193195,right,T4d,603,-3,-23,-9,-14
720575940630936284,right,T4d,605,3,15,4,11
720575940604699825,right,T4d,606,-1,-19,-9,-10
720575940621114188,right,T4d,607,1,18,8,10
720575940623261162,right,T4d,608,1,10,4,6
720575940649653113,right,T4d,609,-2,0,2,-2
720575940629435497,right,T4d,610,2,-23,-14,-9
720575940626694599,right,T4d,611,-1,-18,-8,-10
720575940634093675,right,T4d,612,-3,-26,-10,-16
720575940627334500,right,T4d,613,-8,-4,6,-10
720575940606786761,right,T4d,614,-2,-8,-2,-6
720575940630911596,right,T4d,615,-7,-7,3,-10
720575940639408243,right,T4d,616,-3,15,10,5
720575940628802320,right,T4d,617,-2,-17,-7,-10
720575940612561381,right,T4d,619,-4,-19,-6,-13
720575940632299212,right,T4d,620,7,1,-7,8
720575940613975091,right,T4d,621,1,24,11,13
720575940634862490,right,T4d,622,-5,20,15,5
720575940626429637,right,T4d,623,1,13,5,8
720575940639683443,right,T4d,624,1,-17,-10,-7
720575940618703941,right,T4d,625,-2,24,14,10
720575940620369323,right,T4d,626,-5,-8,1,-9
720575940622838525,right,T4d,627,0,-1,-1,0
720575940628943810,right,T4d,628,0,0,0,0
720575940632393529,right,T4d,629,4,24,8,16
720575940627024069,right,T4d,630,4,8,0,8
720575940624673003,right,T4d,631,1,26,12,14
720575940613218046,right,T4d,632,3,-20,-13,-7
720575940631732536,right,T4d,633,-1,-24,-11,-13
720575940623830857,right,T4d,634,-3,-15,-5,-10
720575940632394916,right,T4d,635,6,-6,-9,3
720575940604738737,right,T4d,636,0,6,3,3
720575940620958959,right,T4d,637,3,-21,-14,-7
720575940637466846,right,T4d,638,-1,7,4,3
720575940619043413,right,T4d,639,-4,19,13,6
720575940637841897,right,T4d,640,-1,-16,-7,-9
720575940628033788,right,T4d,642,-5,-11,-1,-10
720575940617378833,right,T4d,643,6,14,1,13
720575940629707628,right,T4d,644,-6,18,15,3
720575940647824004,right,T4d,645,-4,27,17,10
720575940635931243,right,T4d,646,6,17,2,15
720575940629508347,right,T4d,647,-4,-7,0,-7
720575940628676651,right,T4d,648,1,7,2,5
720575940641537677,right,T4d,649,-1,5,3,2
720575940627541400,right,T4d,650,-3,-25,-10,-15
720575940624945456,right,T4d,651,-4,-5,1,-6
720575940629624407,right,T4d,652,-6,-11,0,-11
720575940604652512,right,T4d,653,-6,-12,0,-12
720575940629775311,right,T4d,654,-3,8,7,1
720575940635790644,right,T4d,655,6,-1,-7,6
720575940627423759,right,T4d,656,0,-11,-6,-5
720575940634279160,right,T4d,657,-2,-25,-11,-14
720575940622232402,right,T4d,658,1,20,9,11
720575940638498877,right,T4d,659,-4,-6,1,-7
720575940634357343,right,T4d,660,2,28,12,16
720575940642372493,right,T4d,661,-3,14,10,4
720575940637625434,right,T4d,662,2,-1,-3,2
720575940628668559,right,T4d,664,1,-27,-15,-12
720575940640894883,right,T4d,665,7,-2,-8,6
720575940630713081,right,T4d,666,7,-13,-14,1
720575940632049804,right,T4d,668,1,19,8,11
720575940634480023,right,T4d,669,4,-16,-12,-4
720575940618069721,right,T4d,670,5,5,-3,8
720575940621210795,right,T4d,671,-4,-23,-8,-15
720575940649531513,right,T4d,672,-8,11,13,-2
720575940620255471,right,T4d,673,2,5,0,5
720575940622079434,right,T4d,674,-4,-14,-3,-11
720575940629766759,right,T4d,677,0,11,5,6
720575940615918348,right,T4d,678,3,-7,-7,0
720575940618657403,right,T4d,679,4,18,5,13
720575940632818910,right,T4d,680,-1,25,13,12
720575940629380222,right,T4d,681,-2,-21,-9,-12
720575940611805589,right,T4d,682,6,-8,-10,2
720575940638575549,right,T4d,683,2,6,1,5
720575940631012370,right,T4d,684,-6,17,14,3
720575940621272230,right,T4d,685,-5,-9,0,-9
720575940615809211,right,T4d,686,5,-22,-16,-6
720575940620371371,right,T4d,687,-6,-3,4,-7
720575940641399259,right,T4d,689,-2,18,11,7
720575940635373919,right,T4d,690,-7,-3,5,-8
720575940628082025,right,T4d,691,-9,4,11,-7
720575940612993650,right,T4d,692,-4,24,16,8
720575940626449098,right,T4d,693,-3,25,15,10
720575940619810982,right,T4d,694,4,3,-3,6
720575940619671125,right,T4d,695,-6,10,11,-1
720575940605181152,right,T4d,696,-2,16,10,6
720575940612249442,right,T4d,697,1,-22,-12,-10
720575940607662037,right,T4d,698,6,-7,-10,3
720575940627511528,right,T4d,699,-5,0,5,-5
720575940623345043,right,T4d,700,5,15,2,13
720575940613965231,right,T4d,701,0,-4,-2,-2
720575940636945264,right,T4d,702,-5,23,16,7
720575940626581672,right,T4d,703,-3,1,3,-2
720575940622380509,right,T4d,704,-7,8,11,-3
720575940627476742,right,T4d,705,1,1,-1,2
720575940612796330,right,T4d,707,-2,25,14,11
720575940633196591,right,T4d,708,-4,-25,-9,-16
720575940617955073,right,T4d,709,-2,-24,-10,-14
720575940609652548,right,T4d,710,4,-25,-17,-8
720575940622943314,right,T4d,711,-1,19,10,9
720575940633665049,right,T4d,712,-7,12,13,-1
720575940633071827,right,T4d,713,-6,16,14,2
720575940611938856,right,T4d,714,5,12,1,11
720575940622527446,right,T4d,715,4,10,1,9
720575940619966087,right,T4d,716,4,-6,-7,1
720575940629671294,right,T4d,717,2,-22,-13,-9
720575940630029131,right,T4d,718,-5,24,17,7
720575940612719090,right,T4d,719,1,27,12,15
720575940620178256,right,T4d,720,-5,21,15,6
720575940628142086,right,T4d,721,5,13,1,12
720575940625137934,right,T4d,722,6,-15,-14,-1
720575940638119613,right,T4d,723,-2,-11,-4,-7
720575940627188241,right,T4d,724,4,2,-3,5
720575940627343997,right,T4d,725,-3,-24,-9,-15
720575940638252358,right,T4d,727,7,6,-4,10
720575940638526948,right,T4d,728,7,12,-1,13
720575940633170207,right,T4d,729,-3,29,17,12
720575940624663303,right,T4d,730,7,0,-7,7
720575940623382506,right,T4d,731,-6,9,10,-1
720575940634957931,right,T4d,732,-3,6,6,0
720575940611540174,right,T4d,733,-5,-17,-4,-13
720575940631481012,right,T4d,734,2,0,-2,2
720575940617148219,right,T4d,735,1,-23,-13,-10
720575940640275920,right,T4d,736,-8,1,8,-7
720575940629598846,right,T4d,737,0,19,9,10
720575940615798923,right,T4d,738,-3,13,9,4
720575940621600892,right,T4d,739,-7,2,8,-6
720575940632623943,right,T4d,740,2,-8,-6,-2
720575940617721172,right,T4d,741,-2,-14,-5,-9
720575940627211353,right,T4d,742,-4,11,9,2
720575940627766268,right,T4d,743,6,-19,-16,-3
720575940646791971,right,T4d,744,-4,25,16,9
720575940615419442,right,T4d,745,0,13,6,7
720575940637837658,right,T4d,746,-3,3,4,-1
720575940636091822,right,T4d,747,0,2,1,1
720575940624109547,right,T4d,748,-4,20,14,6
720575940624172220,right,T4d,749,-2,1,2,-1
720575940620857453,right,T4d,751,1,6,2,4
720575940623022005,right,T4d,752,-2,7,5,2
720575940646795299,right,T4d,753,-3,24,15,9
720575940630778981,right,T4d,754,-1,-13,-6,-7
720575940641548685,right,T4d,755,4,19,5,14
720575940616695579,right,T4d,756,5,20,5,15
720575940628929079,right,T4d,757,0,-6,-3,-3
720575940640995573,right,T4d,758,5,-1,-6,5
720575940627443728,right,T4d,759,7,14,0,14
720575940621792606,right,T4d,760,0,17,8,9
720575940624229631,right,T4d,761,-4,-18,-5,-13
720575940619453611,right,T4d,762,0,14,7,7
720575940606642121,right,T4d,763,-5,14,12,2
720575940632576654,right,T4d,765,-3,9,7,2
720575940629334427,right,T4d,766,2,-4,-4,0
720575940635180695,right,T4d,767,1,28,13,15
720575940606942130,right,T4d,768,3,5,-1,6
720575940639681341,right,T4d,770,5,4,-3,7
720575940632591683,right,T4d,771,3,-27,-17,-10
720575940610863150,right,T4d,772,1,12,5,7
720575940618714235,right,T4d,773,5,-19,-15,-4
720575940617890132,right,T4d,775,5,22,6,16
720575940631215353,right,T4d,776,5,21,5,16
720575940618704453,right,T4d,778,4,25,8,17
720575940627582525,right,T4d,780,-6,25,18,7
720575940645280023,right,T4d,781,-5,26,18,8
720575940633644174,right,T4d,782,-5,27,18,9
720575940625277740,right,T4d,783,-4,28,18,10
720575940647285812,right,T4d,784,-4,29,18,11
720575940612847018,right,T4d,785,-3,30,18,12
720575940615402914,right,T4d,786,-2,30,17,13
720575940626219564,right,T4d,787,3,28,11,17
720575940614623430,right,T4d,788,3,27,10,17
720575940638559295,right,T4d,790,-2,-27,-12,-15
720575940635888180,right,T4d,792,8,2,-7,9
720575940637657486,right,T4d,794,5,-26,-18,-8
720575940646769187,right,T4d,795,6,-21,-17,-4
720575940606236337,right,T4d,796,4,26,9,17
720575940627648847,right,T5a,1,-6,13,12,1
720575940637988329,right,T5a,2,-8,2,9,-7
720575940615415263,right,T5a,3,6,-12,-12,0
720575940619977045,right,T5a,4,-5,-21,-6,-15
720575940621841185,right,T5a,5,-1,16,9,7
720575940622671629,right,T5a,6,-2,-4,0,-4
720575940626912275,right,T5a,7,-6,-6,3,-9
720575940647817092,right,T5a,8,-4,26,17,9
720575940620279131,right,T5a,9,4,9,0,9
720575940624909811,right,T5a,10,5,-15,-13,-2
720575940627960060,right,T5a,11,7,-14,-14,0
720575940629467262,right,T5a,12,-7,9,11,-2
720575940615408962,right,T5a,13,-1,-26,-12,-14
720575940631883320,right,T5a,14,0,-27,-14,-13
720575940628008041,right,T5a,15,2,-3,-4,1
720575940610730082,right,T5a,16,-2,-16,-6,-10
720575940633952869,right,T5a,17,1,-5,-4,-1
720575940620336475,right,T5a,19,-7,17,15,2
720575940614270673,right,T5a,20,3,-11,-9,-2
720575940629519486,right,T5a,21,-2,19,11,8
720575940626484361,right,T5a,22,-1,3,2,1
720575940629365612,right,T5a,23,-3,-16,-5,-11
720575940621651658,right,T5a,24,-1,-10,-4,-6
720575940627889095,right,T5a,25,-9,3,10,-7
720575940627203977,right,T5a,26,1,-3,-3,0
720575940640540891,right,T5a,27,0,-25,-13,-12
720575940617516985,right,T5a,28,5,6,-2,8
720575940624436750,right,T5a,29,-1,-3,-1,-2
720575940626993427,right,T5a,30,6,16,2,14
720575940643399584,right,T5a,31,0,16,8,8
720575940634622059,right,T5a,32,0,12,6,6
720575940627479825,right,T5a,33,3,18,6,12
720575940630756712,right,T5a,34,6,18,3,15
720575940620734061,right,T5a,35,1,-24,-13,-11
720575940641368309,right,T5a,36,6,8,-2,10
720575940640486133,right,T5a,37,1,5,1,4
720575940626642698,right,T5a,38,0,-2,-1,-1
720575940626322988,right,T5a,39,0,20,10,10
720575940621582794,right,T5a,40,-2,-6,-1,-5
720575940627861521,right,T5a,41,-3,28,17,11
720575940636885823,right,T5a,42,-1,14,8,6
720575940621404144,right,T5a,43,-5,18,14,4
720575940636478063,right,T5a,44,5,-10,-10,0
720575940605374910,right,T5a,45,-5,-1,4,-5
720575940624454743,right,T5a,46,-5,15,12,3
720575940602737598,right,T5a,48,-4,-22,-7,-15
720575940636191845,right,T5a,49,4,-4,-6,2
720575940635302580,right,T5a,50,-2,21,12,9
720575940631671400,right,T5a,51,0,-19,-10,-9
720575940621708570,right,T5a,53,5,14,2,12
720575940631163904,right,T5a,54,-4,3,5,-2
720575940628007015,right,T5a,55,-4,-11,-2,-9
720575940645651252,right,T5a,56,1,-13,-8,-5
720575940627330063,right,T5a,57,6,-11,-12,1
720575940621597445,right,T5a,58,3,12,3,9
720575940630262735,right,T5a,59,-2,2,3,-1
720575940625659066,right,T5a,61,-4,-4,2,-6
720575940630805096,right,T5a,62,0,-29,-15,-14
720575940625507161,right,T5a,63,4,12,2,10
720575940625272909,right,T5a,64,4,-23,-16,-7
720575940622409875,right,T5a,65,-1,28,15,13
720575940641424091,right,T5a,66,2,15,5,10
720575940623124938,right,T5a,67,-2,-13,-5,-8
720575940620068628,right,T5a,68,3,16,5,11
720575940612353450,right,T5a,69,1,8,3,5
720575940619988359,right,T5a,70,-4,21,14,7
720575940629833472,right,T5a,71,-2,-3,0,-3
720575940605886338,right,T5a,72,0,-28,-14,-14
720575940626039068,right,T5a,73,2,2,-1,3
720575940629838080,right,T5a,74,-1,-9,-4,-5
720575940629424758,right,T5a,75,-6,14,13,1
720575940625645242,right,T5a,76,-3,-4,1,-5
720575940614192790,right,T5a,77,2,-5,-5,0
720575940635736943,right,T5a,79,2,1,-2,3
720575940628852891,right,T5a,80,4,13,2,11
720575940632375379,right,T5a,81,6,-2,-7,5
720575940624700344,right,T5a,82,-7,7,10,-3
720575940616188021,right,T5a,83,2,-21,-13,-8
720575940624135688,right,T5a,84,-2,12,8,4
720575940620577360,right,T5a,85,4,-22,-15,-7
720575940608895427,right,T5a,86,-5,-7,1,-8
720575940619558791,right,T5a,87,1,11,4,7
720575940612577685,right,T5a,88,7,4,-5,9
720575940611985331,right,T5a,89,1,-19,-11,-8
720575940623484679,right,T5a,90,-4,5,6,-1
720575940627676934,right,T5a,91,-1,6,4,2
720575940613351917,right,T5a,92,0,9,4,5
720575940633160674,right,T5a,93,-6,3,7,-4
720575940617284130,right,T5a,94,5,18,4,14
720575940632395859,right,T5a,96,1,-10,-6,-4
720575940617141204,right,T5a,97,-5,2,6,-4
720575940621852874,right,T5a,98,-1,-12,-5,-7
720575940639159118,right,T5a,99,4,15,3,12
720575940628299563,right,T5a,100,2,-10,-7,-3
720575940627951815,right,T5a,102,3,13,3,10
720575940655100577,right,T5a,103,7,9,-3,12
720575940604544358,right,T5a,104,-1,-27,-13,-14
720575940626589768,right,T5a,105,3,22,8,14
720575940627032197,right,T5a,106,-7,11,12,-1
720575940633415137,right,T5a,107,8,-2,-9,7
720575940632899501,right,T5a,108,-3,-12,-3,-9
720575940614599234,right,T5a,109,4,-5,-7,2
720575940627289109,right,T5a,110,-7,0,7,-7
720575940621891964,right,T5a,111,2,-24,-14,-10
720575940620079808,right,T5a,112,-6,1,6,-5
720575940639447101,right,T5a,113,-2,4,4,0
720575940638280006,right,T5a,114,2,-13,-9,-4
720575940624683708,right,T5a,115,-4,2,5,-3
720575940623867115,right,T5a,116,-1,-8,-3,-5
720575940626004170,right,T5a,117,-8,-2,7,-9
720575940619937812,right,T5a,118,3,1,-3,4
720575940633482777,right,T5a,119,-2,6,5,1
720575940630653515,right,T5a,120,-1,-1,0,-1
720575940630651991,right,T5a,122,-5,9,9,0
720575940638036806,right,T5a,124,1,-7,-5,-2
720575940631550250,right,T5a,125,5,9,-1,10
720575940624141803,right,T5a,126,3,11,2,9
720575940609798130,right,T5a,127,0,15,7,8
720575940599729862,right,T5a,129,0,-13,-7,-6
720575940616527633,right,T5a,130,2,12,4,8
720575940628608003,right,T5a,131,-6,20,16,4
720575940629369722,right,T5a,132,2,4,0,4
720575940622137164,right,T5a,133,-3,20,13,7
720575940624715557,right,T5a,135,-3,-22,-8,-14
720575940619450701,right,T5a,136,0,3,1,2
720575940633801573,right,T5a,137,5,-7,-9,2
720575940627464220,right,T5a,138,0,27,13,14
720575940622276106,right,T5a,139,1,-14,-8,-6
720575940622675753,right,T5a,140,3,8,1,7
720575940622498952,right,T5a,142,-2,-18,-7,-11
720575940614829718,right,T5a,143,-4,16,12,4
720575940627364623,right,T5a,144,7,-11,-13,2
720575940627354696,right,T5a,145,0,4,2,2
720575940613976482,right,T5a,146,1,-6,-4,-2
720575940623880119,right,T5a,147,1,21,9,12
720575940636224107,right,T5a,148,-7,-11,1,-12
720575940615147571,right,T5a,149,6,-14,-13,-1
720575940632124975,right,T5a,150,-8,5,10,-5
720575940618752853,right,T5a,151,-3,-14,-4,-10
720575940608386827,right,T5a,152,3,-15,-11,-4
720575940631130655,right,T5a,153,8,0,-8,8
720575940619916564,right,T5a,154,-8,0,8,-8
720575940634103777,right,T5a,156,-9,1,9,-8
720575940617196759,right,T5a,157,-1,-7,-3,-4
720575940621431028,right,T5a,158,3,-5,-6,1
720575940618493509,right,T5a,159,7,7,-4,11
720575940623433772,right,T5a,160,-2,20,12,8
720575940621469052,right,T5a,161,4,-14,-11,-3
720575940615618354,right,T5a,162,-4,-2,3,-5
720575940613543314,right,T5a,164,-1,-2,0,-2
720575940629829687,right,T5a,165,4,16,4,12
720575940616580865,right,T5a,166,0,18,9,9
720575940622363341,right,T5a,167,0,-17,-9,-8
720575940629107984,right,T5a,168,-1,17,9,8
720575940628569538,right,T5a,169,0,-18,-9,-9
720575940646090787,right,T5a,170,-5,1,5,-4
720575940621438964,right,T5a,171,6,-20,-16,-4
720575940622389430,right,T5a,172,1,22,10,12
720575940627075721,right,T5a,173,2,-25,-15,-10
720575940634733722,right,T5a,174,4,-15,-12,-3
720575940603373916,right,T5a,175,-6,-7,2,-9
720575940636935390,right,T5a,176,-2,13,8,5
720575940630145500,right,T5a,177,-2,-1,1,-2
720575940628977018,right,T5a,178,2,11,3,8
720575940627621909,right,T5a,179,-5,-16,-3,-13
720575940623025944,right,T5a,180,2,-27,-16,-11
720575940625076880,right,T5a,181,1,-4,-3,-1
720575940612051825,right,T5a,182,7,-10,-12,2
720575940626520540,right,T5a,183,-5,-15,-3,-12
720575940612761523,right,T5a,184,-6,-5,3,-8
720575940627159685,right,T5a,185,2,-11,-8,-3
720575940612621530,right,T5a,186,-1,26,14,12
720575940623669036,right,T5a,187,3,21,7,14
720575940625571465,right,T5a,188,-5,17,13,4
720575940638088026,right,T5a,189,6,13,0,13
720575940621608481,right,T5a,190,-3,-5,0,-5
720575940618069077,right,T5a,191,-1,-11,-5,-6
720575940631101215,right,T5a,192,7,10,-2,12
720575940625779898,right,T5a,193,-5,4,7,-3
720575940624362988,right,T5a,194,0,-5,-3,-2
720575940617462502,right,T5a,195,-3,-1,2,-3
720575940624719818,right,T5a,196,-1,8,5,3
720575940640909520,right,T5a,198,6,2,-5,7
720575940614223010,right,T5a,199,0,-12,-6,-6
720575940635282868,right,T5a,200,-5,12,11,1
720575940630306767,right,T5a,202,-1,27,14,13
720575940626813577,right,T5a,203,3,-1,-4,3
720575940624267338,right,T5a,204,5,-2,-6,4
720575940639634083,right,T5a,205,5,-6,-8,2
720575940642568608,right,T5a,206,-3,5,5,0
720575940628282170,right,T5a,207,1,29,13,16
720575940631650664,right,T5a,208,5,-21,-16,-5
720575940623864759,right,T5a,209,-3,-8,-1,-7
720575940606417609,right,T5a,210,-6,8,10,-2
720575940628653415,right,T5a,211,-7,-1,6,-7
720575940620550004,right,T5a,212,2,-16,-10,-6
720575940630363387,right,T5a,213,3,-4,-5,1
720575940627478760,right,T5a,214,-5,3,6,-3
720575940620544096,right,T5a,215,6,7,-3,10
720575940629759788,right,T5a,216,2,19,7,12
720575940612337893,right,T5a,217,6,15,1,14
720575940623943403,right,T5a,218,2,10,3,7
720575940605413129,right,T5a,219,6,-4,-8,4
720575940627250436,right,T5a,220,2,-6,-5,-1
720575940621307887,right,T5a,221,-7,3,8,-5
720575940631705807,right,T5a,222,-3,26,16,10
720575940640749520,right,T5a,223,-2,26,15,11
720575940606864514,right,T5a,224,0,5,2,3
720575940613545768,right,T5a,225,2,-26,-15,-11
720575940623194406,right,T5a,226,5,19,4,15
720575940626805129,right,T5a,227,-7,5,9,-4
720575940619923476,right,T5a,228,-7,1,7,-6
720575940634736535,right,T5a,229,5,2,-4,6
720575940631227434,right,T5a,230,2,9,2,7
720575940631781736,right,T5a,231,4,-12,-10,-2
720575940630387318,right,T5a,232,-4,13,10,3
720575940644394400,right,T5a,233,4,-13,-11,-2
720575940623952381,right,T5a,234,1,3,0,3
720575940621236556,right,T5a,235,4,11,1,10
720575940611937266,right,T5a,236,-1,4,3,1
720575940636087732,right,T5a,237,-2,27,15,12
720575940642209421,right,T5a,238,-8,-3,6,-9
720575940603761836,right,T5a,239,-6,6,9,-3
720575940623118374,right,T5a,240,-4,-3,2,-5
720575940620611009,right,T5a,241,2,-17,-11,-6
720575940634759066,right,T5a,242,-4,6,7,-1
720575940621005421,right,T5a,243,-1,-21,-10,-11
720575940614660829,right,T5a,244,-4,-12,-2,-10
720575940624229384,right,T5a,245,-5,-3,3,-6
720575940608667605,right,T5a,246,-4,15,11,4
720575940616024866,right,T5a,247,-4,-15,-4,-11
720575940631947079,right,T5a,249,2,-12,-8,-4
720575940627483335,right,T5a,250,-1,1,1,0
720575940620179137,right,T5a,251,-1,-14,-6,-8
720575940615451551,right,T5a,252,3,23,8,15
720575940616649617,right,T5a,253,5,16,3,13
720575940614743505,right,T5a,254,3,-24,-15,-9
720575940606534601,right,T5a,255,-6,-13,-1,-12
720575940646172963,right,T5a,256,5,-20,-15,-5
720575940625782116,right,T5a,257,2,21,8,13
720575940632600680,right,T5a,258,-4,-17,-5,-12
720575940635003799,right,T5a,259,-7,-5,4,-9
720575940620350191,right,T5a,260,-3,19,12,7
720575940615136322,right,T5a,261,-1,13,7,6
720575940630084316,right,T5a,262,1,-11,-7,-4
720575940654245793,right,T5a,263,-3,4,5,-1
720575940615073503,right,T5a,264,-1,-6,-2,-4
720575940630250092,right,T5a,265,-6,-1,5,-6
720575940630578294,right,T5a,266,-1,-25,-12,-13
720575940633656345,right,T5a,267,-6,2,7,-5
720575940620591454,right,T5a,268,7,-6,-10,4
720575940613606013,right,T5a,269,2,-19,-12,-7
720575940637533581,right,T5a,270,1,-8,-5,-3
720575940617304788,right,T5a,271,4,6,-1,7
720575940643436960,right,T5a,272,3,-2,-4,2
720575940623180326,right,T5a,273,-6,23,17,6
720575940626711941,right,T5a,274,6,4,-4,8
720575940630451543,right,T5a,275,-8,-1,7,-8
720575940629060170,right,T5a,276,2,3,-1,4
720575940633410199,right,T5a,277,7,-3,-9,6
720575940620049573,right,T5a,278,-5,10,10,0
720575940631900044,right,T5a,279,-4,8,8,0
720575940639165885,right,T5a,280,-6,-14,-1,-13
720575940628445327,right,T5a,282,0,26,13,13
720575940620421614,right,T5a,283,-4,4,6,-2
720575940625654759,right,T5a,284,0,25,12,13
720575940631632440,right,T5a,286,0,-24,-12,-12
720575940619707842,right,T5a,287,-5,13,11,2
720575940641922805,right,T5a,288,-1,30,16,14
720575940631481593,right,T5a,289,-1,11,6,5
720575940620747355,right,T5a,290,5,-24,-17,-7
720575940631911235,right,T5a,291,7,2,-6,8
720575940624722731,right,T5a,292,-4,18,13,5
720575940619511243,right,T5a,293,4,-17,-13,-4
720575940623627559,right,T5a,294,1,-20,-11,-9
720575940608729097,right,T5a,296,1,-18,-10,-8
720575940639650126,right,T5a,297,7,-9,-12,3
720575940618642998,right,T5a,298,-5,5,7,-2
720575940614403218,right,T5a,299,-4,12,10,2
720575940628076288,right,T5a,300,4,-18,-13,-5
720575940621121462,right,T5a,301,-5,16,13,3
720575940620991329,right,T5a,302,2,17,6,11
720575940616716427,right,T5a,303,-5,22,16,6
720575940609009877,right,T5a,304,6,5,-4,9
720575940627039242,right,T5a,305,-7,4,9,-5
720575940632293580,right,T5a,306,3,7,0,7
720575940619686360,right,T5a,307,5,-25,-18,-7
720575940626263634,right,T5a,308,-5,8,9,-1
720575940636782704,right,T5a,309,-6,12,12,0
720575940619847757,right,T5a,310,2,22,9,13
720575940613709352,right,T5a,311,-7,15,14,1
720575940643519648,right,T5a,312,4,-7,-8,1
720575940627370664,right,T5a,313,7,3,-6,9
720575940627834088,right,T5a,314,-9,5,11,-6
720575940623674807,right,T5a,315,-3,-6,0,-6
720575940630784599,right,T5a,316,5,-4,-7,3
720575940621642010,right,T5a,317,-5,-4,3,-7
720575940621127851,right,T5a,318,4,-19,-14,-5
720575940629860608,right,T5a,319,-2,5,4,1
720575940627768775,right,T5a,320,-2,-5,-1,-4
720575940640074624,right,T5a,321,8,4,-6,10
720575940621183508,right,T5a,322,2,26,11,15
720575940643674312,right,T5a,324,3,24,9,15
720575940600150793,right,T5a,325,5,1,-5,6
720575940622818184,right,T5a,326,2,16,6,10
720575940609226453,right,T5a,327,5,3,-4,7
720575940608724163,right,T5a,328,5,-9,-10,1
720575940626820538,right,T5a,329,0,24,12,12
720575940609896750,right,T5a,330,3,3,-2,5
720575940599704006,right,T5a,331,1,-15,-9,-6
720575940607114882,right,T5a,332,4,-26,-17,-9
720575940613733860,right,T5a,333,0,-21,-11,-10
720575940629950482,right,T5a,334,1,-26,-14,-12
720575940632661452,right,T5a,335,2,8,2,6
720575940626365005,right,T5a,336,0,23,11,12
720575940610555204,right,T5a,337,-5,-6,2,-8
720575940629425602,right,T5a,338,-1,0,1,-1
720575940620447623,right,T5a,339,6,11,-1,12
720575940614260734,right,T5a,340,-4,17,12,5
720575940625124360,right,T5a,341,6,-17,-15,-2
720575940622366218,right,T5a,342,2,-15,-10,-5
720575940627576125,right,T5a,343,-3,27,16,11
720575940632462244,right,T5a,344,-2,-15,-6,-9
720575940625619493,right,T5a,345,3,-12,-9,-3
720575940624525715,right,T5a,346,-7,-9,2,-11
720575940626217093,right,T5a,347,-5,-13,-2,-11
720575940611491555,right,T5a,348,3,14,4,10
720575940632033298,right,T5a,349,-5,-14,-2,-12
720575940649446777,right,T5a,350,1,15,6,9
720575940622029150,right,T5a,351,-1,-17,-8,-9
720575940631750671,right,T5a,352,-2,28,16,12
720575940626951468,right,T5a,353,2,24,10,14
720575940636405349,right,T5a,354,-2,-26,-11,-15
720575940626667928,right,T5a,355,-7,-6,4,-10
720575940616917516,right,T5a,356,0,22,11,11
720575940620961974,right,T5a,357,4,17,4,13
720575940629924924,right,T5a,358,-3,17,11,6
720575940631520056,right,T5a,359,2,23,9,14
720575940647270276,right,T5a,360,-5,19,14,5
720575940637531277,right,T5a,361,0,-7,-4,-3
720575940612371351,right,T5a,362,2,-20,-12,-8
720575940616231641,right,T5a,363,7,-4,-9,5
720575940628016970,right,T5a,364,4,4,-2,6
720575940617180857,right,T5a,365,4,7,-1,8
720575940631139072,right,T5a,367,-6,-15,-2,-13
720575940602577598,right,T5a,368,-4,-20,-6,-14
720575940617572609,right,T5a,369,5,-5,-8,3
720575940646265635,right,T5a,370,-3,21,13,8
720575940620034932,right,T5a,371,6,-5,-9,4
720575940626516757,right,T5a,372,1,-2,-2,0
720575940637976922,right,T5a,373,1,-21,-12,-9
720575940627043736,right,T5a,374,2,13,4,9
720575940618717819,right,T5a,375,-6,7,9,-2
720575940615067067,right,T5a,377,0,7,3,4
720575940631651641,right,T5a,378,-3,18,12,6
720575940613940703,right,T5a,379,3,-17,-12,-5
720575940636090548,right,T5a,380,-1,29,15,14
720575940622493320,right,T5a,382,3,-6,-6,0
720575940638363206,right,T5a,383,-6,11,11,0
720575940627420303,right,T5a,384,-6,-2,5,-7
720575940642008205,right,T5a,385,-3,-18,-6,-12
720575940615301023,right,T5a,386,-6,19,15,4
720575940626099970,right,T5a,387,-1,-15,-7,-8
720575940637721919,right,T5a,388,3,19,6,13
720575940625490234,right,T5a,390,-6,-9,1,-10
720575940622786840,right,T5a,391,4,-3,-6,3
720575940626553177,right,T5a,392,-4,7,7,0
720575940617762049,right,T5a,393,-1,22,12,10
720575940629134844,right,T5a,394,-7,-8,3,-11
720575940628095484,right,T5a,395,0,-22,-11,-11
720575940621909213,right,T5a,396,-1,10,6,4
720575940627535047,right,T5a,397,-3,-19,-7,-12
720575940624669621,right,T5a,398,-3,22,14,8
720575940611397474,right,T5a,400,1,-29,-16,-13
720575940618832720,right,T5a,401,-2,-19,-8,-11
720575940619831117,right,T5a,402,3,26,10,16
720575940625512848,right,T5a,403,-2,-12,-4,-8
720575940617322304,right,T5a,404,-1,20,11,9
720575940629631735,right,T5a,405,3,10,2,8
720575940612379287,right,T5a,406,1,-25,-14,-11
720575940638102640,right,T5a,407,-5,-10,0,-10
720575940628898860,right,T5a,408,-6,-4,4,-8
720575940624561127,right,T5a,409,0,-3,-2,-1
720575940638947150,right,T5a,410,-2,-2,1,-3
720575940644837143,right,T5a,411,-5,-19,-5,-14
720575940626727966,right,T5a,413,-2,-7,-2,-5
720575940618658171,right,T5a,414,4,21,6,15
720575940633685146,right,T5a,415,6,12,0,12
720575940612370069,right,T5a,416,3,-8,-7,-1
720575940621261744,right,T5a,417,-6,-10,1,-11
720575940606727042,right,T5a,418,-2,15,9,6
720575940621971276,right,T5a,419,-3,-11,-3,-8
720575940614283935,right,T5a,420,6,-3,-8,5
720575940654390689,right,T5a,421,-1,12,7,5
720575940615700492,right,T5a,422,-7,-4,5,-9
720575940631561272,right,T5a,423,3,-18,-12,-6
720575940627896326,right,T5a,424,-3,-2,2,-4
720575940624486032,right,T5a,425,3,20,7,13
720575940620869040,right,T5a,426,-3,0,3,-3
720575940616917772,right,T5a,428,-2,23,13,10
720575940611790193,right,T5a,429,-2,14,9,5
720575940622236381,right,T5a,430,-3,-7,-1,-6
720575940629436030,right,T5a,431,-2,-10,-3,-7
720575940630009047,right,T5a,432,-5,7,8,-1
720575940632197407,right,T5a,433,0,-8,-4,-4
720575940612249698,right,T5a,434,-3,7,6,1
720575940634690411,right,T5a,435,5,-17,-14,-3
720575940624079624,right,T5a,436,0,-15,-8,-7
720575940610723026,right,T5a,437,-3,12,9,3
720575940626995998,right,T5a,438,2,27,11,16
720575940648482937,right,T5a,439,-3,-9,-2,-7
720575940629859663,right,T5a,440,1,23,10,13
720575940615327197,right,T5a,441,3,-16,-11,-5
720575940622413055,right,T5a,442,-5,25,17,8
720575940630723685,right,T5a,444,4,-10,-9,-1
720575940615467682,right,T5a,445,-2,8,6,2
720575940621729374,right,T5a,447,-1,2,2,0
720575940643168909,right,T5a,448,0,30,15,15
720575940632628684,right,T5a,449,6,-16,-14,-2
720575940630083706,right,T5a,450,2,-9,-7,-2
720575940629598658,right,T5a,451,4,20,6,14
720575940638331718,right,T5a,452,1,-9,-6,-3
720575940616122674,right,T5a,453,3,25,9,16
720575940614271185,right,T5a,454,5,-12,-11,-1
720575940620881226,right,T5a,455,7,-7,-11,4
720575940638886628,right,T5a,456,0,21,10,11
720575940638442328,right,T5a,457,-2,17,10,7
720575940623372874,right,T5a,458,5,0,-5,5
720575940618009318,right,T5a,459,5,-3,-7,4
720575940624217319,right,T5a,460,-3,-20,-7,-13
720575940634482272,right,T5a,461,7,-5,-10,5
720575940628403194,right,T5a,462,-1,18,10,8
720575940631469931,right,T5a,463,5,17,3,14
720575940621357552,right,T5a,464,4,0,-4,4
720575940621910772,right,T5a,465,3,0,-3,3
720575940654695841,right,T5a,466,1,14,6,8
720575940614663530,right,T5a,467,-2,-20,-8,-12
720575940616568577,right,T5a,468,-3,11,8,3
720575940629886524,right,T5a,469,-7,13,13,0
720575940615355754,right,T5a,470,4,-9,-9,0
720575940636516526,right,T5a,471,3,-26,-16,-10
720575940620734958,right,T5a,472,1,25,11,14
720575940629569218,right,T5a,473,-4,23,15,8
720575940606681278,right,T5a,474,-3,-17,-6,-11
720575940631929647,right,T5a,475,-4,-1,3,-4
720575940627471503,right,T5a,476,-1,15,8,7
720575940614162338,right,T5a,477,-3,2,4,-2
720575940626440025,right,T5a,479,-2,10,7,3
720575940634061419,right,T5a,480,3,-19,-13,-6
720575940622265932,right,T5a,481,4,-8,-8,0
720575940634846815,right,T5a,482,1,17,7,10
720575940621325594,right,T5a,483,2,-7,-6,-1
720575940627159429,right,T5a,484,3,-9,-8,-1
720575940622108584,right,T5a,485,-3,-3,1,-4
720575940620995766,right,T5a,486,0,1,0,1
720575940629534012,right,T5a,487,1,-1,-2,1
720575940632109855,right,T5a,488,7,5,-5,10
720575940612605462,right,T5a,489,-3,10,8,2
720575940631809091,right,T5a,491,7,-1,-8,7
720575940617789524,right,T5a,492,-7,-2,6,-8
720575940620136613,right,T5a,493,-3,23,14,9
720575940643169933,right,T5a,494,0,29,14,15
720575940615730875,right,T5a,496,7,8,-3,11
720575940635121818,right,T5a,497,6,1,-6,7
720575940626447813,right,T5a,498,6,10,-1,11
720575940620767329,right,T5a,499,5,10,0,10
720575940630706302,right,T5a,500,7,-8,-11,3
720575940617365990,right,T5a,501,1,2,0,2
720575940634954009,right,T5a,502,5,8,-1,9
720575940632229540,right,T5a,503,3,17,5,12
720575940635234484,right,T5a,504,-2,9,6,3
720575940609006857,right,T5a,506,1,-12,-7,-5
720575940624609275,right,T5a,507,-5,-12,-1,-11
720575940635561663,right,T5a,508,-5,11,10,1
720575940618161126,right,T5a,509,-4,10,9,1
720575940610235342,right,T5a,510,-2,11,7,4
720575940653602038,right,T5a,511,5,-11,-11,0
720575940606555522,right,T5a,512,6,0,-6,6
720575940649800825,right,T5a,514,-4,-10,-1,-9
720575940632251729,right,T5a,515,-8,-7,4,-11
720575940618493253,right,T5a,517,6,3,-5,8
720575940621445723,right,T5a,518,-4,22,15,7
720575940643614408,right,T5a,519,-5,-5,2,-7
720575940617604820,right,T5a,521,6,-9,-11,2
720575940618154304,right,T5a,522,-4,0,4,-4
720575940642802592,right,T5a,523,2,14,5,9
720575940630757371,right,T5a,524,4,-20,-14,-6
720575940636938586,right,T5a,525,-1,-20,-9,-11
720575940628737323,right,T5a,526,0,-10,-5,-5
720575940614577117,right,T5a,527,-4,-8,0,-8
720575940616769297,right,T5a,528,2,7,1,6
720575940624329546,right,T5a,529,2,-2,-3,1
720575940613118887,right,T5a,530,-3,-13,-4,-9
720575940617743901,right,T5a,531,1,0,-1,1
720575940626282371,right,T5a,532,-8,7,11,-4
720575940617720404,right,T5a,533,0,-16,-8,-8
720575940619757392,right,T5a,534,3,2,-2,4
720575940630322688,right,T5a,535,8,-4,-10,6
720575940611460826,right,T5a,536,3,4,-1,5
720575940617745698,right,T5a,537,0,-23,-12,-11
720575940620195776,right,T5a,538,-4,1,4,-3
720575940634835551,right,T5a,539,-6,15,13,2
720575940622908745,right,T5a,540,-2,-9,-3,-6
720575940606738562,right,T5a,541,-4,14,11,3
720575940618942843,right,T5a,542,6,-13,-13,0
720575940627133457,right,T5a,543,-1,-4,-1,-3
720575940624722702,right,T5a,545,5,11,0,11
720575940617150676,right,T5a,546,3,6,0,6
720575940610639729,right,T5a,547,-1,21,11,10
720575940616274971,right,T5a,548,1,-16,-9,-7
720575940652131574,right,T5a,549,0,-9,-5,-4
720575940631729967,right,T5a,550,-2,3,3,0
720575940627467516,right,T5a,551,-4,-9,-1,-8
720575940607685387,right,T5a,552,4,-1,-5,4
720575940626150402,right,T5a,553,-3,16,11,5
720575940643507104,right,T5a,555,-4,9,8,1
720575940627449340,right,T5a,556,0,10,5,5
720575940618755638,right,T5a,557,6,-10,-11,1
720575940604432864,right,T5a,558,-4,-21,-7,-14
720575940622151756,right,T5a,560,-7,14,14,0
720575940613372979,right,T5a,561,5,7,-2,9
720575940640595875,right,T5a,562,-5,-2,4,-6
720575940624632103,right,T5a,563,5,-13,-12,-1
720575940639784563,right,T5a,564,3,-23,-15,-8
720575940627231498,right,T5a,565,0,-26,-13,-13
720575940626716958,right,T5a,566,5,-8,-9,1
720575940639689379,right,T5a,567,-2,22,13,9
720575940631569256,right,T5a,568,-6,-8,2,-10
720575940627573035,right,T5a,569,6,6,-3,9
720575940660085121,right,T5a,570,2,25,10,15
720575940625766346,right,T5a,571,0,-14,-7,-7
720575940629567358,right,T5a,572,-8,3,9,-6
720575940627562920,right,T5a,573,4,14,3,11
720575940637759295,right,T5a,574,-6,5,8,-3
720575940610984398,right,T5a,575,6,9,-2,11
720575940623276364,right,T5a,576,0,28,14,14
720575940620311791,right,T5a,577,5,-14,-12,-2
720575940652196342,right,T5a,578,4,-11,-10,-1
720575940634115952,right,T5a,580,-2,-23,-10,-13
720575940611490606,right,T5a,581,3,9,1,8
720575940621545920,right,T5a,582,-1,23,12,11
720575940624467082,right,T5a,583,3,-25,-16,-9
720575940619795533,right,T5a,584,4,23,7,16
720575940617252923,right,T5a,585,-1,-23,-11,-12
720575940634835610,right,T5a,586,2,18,7,11
720575940616391797,right,T5a,587,4,22,7,15
720575940637182309,right,T5a,588,1,4,1,3
720575940619544661,right,T5a,589,-1,-5,-2,-3
720575940634345626,right,T5a,590,1,9,3,6
720575940630467269,right,T5a,591,3,-3,-5,2
720575940609160457,right,T5a,592,3,-28,-17,-11
720575940620018523,right,T5a,593,3,-14,-10,-4
720575940624847034,right,T5a,594,7,-16,-15,-1
720575940626944286,right,T5a,595,7,-12,-13,1
720575940635218327,right,T5a,596,-4,-16,-4,-12
720575940646961284,right,T5a,597,4,1,-4,5
720575940633575134,right,T5a,599,-1,9,5,4
720575940632429794,right,T5a,600,3,-10,-8,-2
720575940631306552,right,T5a,601,1,16,7,9
720575940631495348,right,T5a,602,4,-2,-5,3
720575940634033308,right,T5a,603,-3,-23,-9,-14
720575940626662174,right,T5a,605,3,15,4,11
720575940620237702,right,T5a,606,-1,-19,-9,-10
720575940644929828,right,T5a,607,1,18,8,10
720575940629542930,right,T5a,608,1,10,4,6
720575940611449749,right,T5a,609,-2,0,2,-2
720575940631928376,right,T5a,611,-1,-18,-8,-10
720575940617735380,right,T5a,612,-3,-26,-10,-16
720575940610713810,right,T5a,614,-2,-8,-2,-6
720575940624211197,right,T5a,615,-7,-7,3,-10
720575940631498307,right,T5a,616,-3,15,10,5
720575940623023145,right,T5a,617,-2,-17,-7,-10
720575940628513796,right,T5a,618,-1,24,13,11
720575940627705603,right,T5a,619,-4,-19,-6,-13
720575940638288436,right,T5a,620,7,1,-7,8
720575940621106368,right,T5a,621,1,24,11,13
720575940628315197,right,T5a,622,-5,20,15,5
720575940620380654,right,T5a,623,1,13,5,8
720575940614092138,right,T5a,624,1,-17,-10,-7
720575940623311203,right,T5a,625,-2,24,14,10
720575940603365980,right,T5a,626,-5,-8,1,-9
720575940643686935,right,T5a,627,0,-1,-1,0
720575940608668867,right,T5a,628,0,0,0,0
720575940621163892,right,T5a,629,4,24,8,16
720575940636161381,right,T5a,630,4,8,0,8
720575940628061321,right,T5a,631,1,26,12,14
720575940639312949,right,T5a,632,3,-20,-13,-7
720575940629657210,right,T5a,633,-1,-24,-11,-13
720575940623133130,right,T5a,634,-3,-15,-5,-10
720575940625191100,right,T5a,635,6,-6,-9,3
720575940642025357,right,T5a,636,0,6,3,3
720575940626978137,right,T5a,637,3,-21,-14,-7
720575940639972597,right,T5a,638,-1,7,4,3
720575940630688207,right,T5a,639,-4,19,13,6
720575940654576289,right,T5a,640,-1,-16,-7,-9
720575940639720782,right,T5a,641,-8,-5,5,-10
720575940623940154,right,T5a,642,-5,-11,-1,-10
720575940617137937,right,T5a,643,6,14,1,13
720575940626044734,right,T5a,644,-6,18,15,3
720575940627862545,right,T5a,645,-4,27,17,10
720575940637290341,right,T5a,646,6,17,2,15
720575940614715357,right,T5a,647,-4,-7,0,-7
720575940615363122,right,T5a,648,1,7,2,5
720575940613497384,right,T5a,649,-1,5,3,2
720575940614328978,right,T5a,650,-3,-25,-10,-15
720575940615072735,right,T5a,651,-4,-5,1,-6
720575940624608763,right,T5a,652,-6,-11,0,-11
720575940622197530,right,T5a,653,-6,-12,0,-12
720575940622241494,right,T5a,654,-3,8,7,1
720575940623355389,right,T5a,655,6,-1,-7,6
720575940605980262,right,T5a,656,0,-11,-6,-5
720575940647503748,right,T5a,657,-2,-25,-11,-14
720575940623872329,right,T5a,658,1,20,9,11
720575940606624642,right,T5a,659,-4,-6,1,-7
720575940633648782,right,T5a,660,2,28,12,16
720575940629962300,right,T5a,661,-3,14,10,4
720575940623919689,right,T5a,662,2,-1,-3,2
720575940626723091,right,T5a,663,0,8,4,4
720575940620955457,right,T5a,664,1,-27,-15,-12
720575940624306663,right,T5a,665,7,-2,-8,6
720575940629116401,right,T5a,666,7,-13,-14,1
720575940605535177,right,T5a,667,1,-28,-15,-13
720575940631275863,right,T5a,668,1,19,8,11
720575940639471950,right,T5a,669,4,-16,-12,-4
720575940639034739,right,T5a,670,5,5,-3,8
720575940643806880,right,T5a,671,-4,-23,-8,-15
720575940633717855,right,T5a,672,-8,11,13,-2
720575940634429119,right,T5a,673,2,5,0,5
720575940644589591,right,T5a,676,-3,-21,-8,-13
720575940625844666,right,T5a,677,0,11,5,6
720575940615235138,right,T5a,678,3,-7,-7,0
720575940617197140,right,T5a,679,4,18,5,13
720575940616396703,right,T5a,680,-1,25,13,12
720575940621616734,right,T5a,681,-2,-21,-9,-12
720575940626586370,right,T5a,682,6,-8,-10,2
720575940621298949,right,T5a,683,2,6,1,5
720575940634784410,right,T5a,684,-6,17,14,3
720575940622752205,right,T5a,685,-5,-9,0,-9
720575940627946250,right,T5a,686,5,-22,-16,-6
720575940608528341,right,T5a,687,-6,-3,4,-7
720575940639055157,right,T5a,688,-7,10,12,-2
720575940611904218,right,T5a,689,-2,18,11,7
720575940605756844,right,T5a,692,-4,24,16,8
720575940635528440,right,T5a,693,-3,25,15,10
720575940621617391,right,T5a,694,4,3,-3,6
720575940617272020,right,T5a,695,-6,10,11,-1
720575940621009904,right,T5a,696,-2,16,10,6
720575940622593663,right,T5a,697,1,-22,-12,-10
720575940623802859,right,T5a,698,6,-7,-10,3
720575940621602081,right,T5a,699,-5,0,5,-5
720575940631901267,right,T5a,700,5,15,2,13
720575940624351818,right,T5a,701,0,-4,-2,-2
720575940608404235,right,T5a,703,-3,1,3,-2
720575940626953274,right,T5a,704,-7,8,11,-3
720575940635465407,right,T5a,705,1,1,-1,2
720575940644937416,right,T5a,707,-2,25,14,11
720575940618322971,right,T5a,709,-2,-24,-10,-14
720575940603940012,right,T5a,710,4,-25,-17,-8
720575940627153939,right,T5a,711,-1,19,10,9
720575940621999484,right,T5a,712,-7,12,13,-1
720575940631091730,right,T5a,713,-6,16,14,2
720575940617275665,right,T5a,714,5,12,1,11
720575940645691700,right,T5a,715,4,10,1,9
720575940625571858,right,T5a,716,4,-6,-7,1
720575940627004682,right,T5a,717,2,-22,-13,-9
720575940605392160,right,T5a,718,-5,24,17,7
720575940627331856,right,T5a,719,1,27,12,15
720575940628541456,right,T5a,720,-5,21,15,6
720575940624156430,right,T5a,721,5,13,1,12
720575940626071738,right,T5a,722,6,-15,-14,-1
720575940604774572,right,T5a,723,-2,-11,-4,-7
720575940617988097,right,T5a,724,4,2,-3,5
720575940623806459,right,T5a,725,-3,-24,-9,-15
720575940615368498,right,T5a,726,2,-28,-16,-12
720575940629299355,right,T5a,727,7,6,-4,10
720575940621021536,right,T5a,728,7,12,-1,13
720575940628376085,right,T5a,729,-3,29,17,12
720575940624776892,right,T5a,730,7,0,-7,7
720575940622988070,right,T5a,731,-6,9,10,-1
720575940618730107,right,T5a,732,-3,6,6,0
720575940642644788,right,T5a,734,2,0,-2,2
720575940623719980,right,T5a,737,0,19,9,10
720575940633354321,right,T5a,738,-3,13,9,4
720575940636156046,right,T5a,739,-7,2,8,-6
720575940614219670,right,T5a,741,-2,-14,-5,-9
720575940633299808,right,T5a,742,-4,11,9,2
720575940606736830,right,T5a,743,6,-19,-16,-3
720575940613419006,right,T5a,744,-4,25,16,9
720575940616045279,right,T5a,745,0,13,6,7
720575940642937140,right,T5a,746,-3,3,4,-1
720575940633329886,right,T5a,747,0,2,1,1
720575940611002210,right,T5a,748,-4,20,14,6
720575940642939956,right,T5a,749,-2,1,2,-1
720575940614205336,right,T5a,750,4,-24,-16,-8
720575940637671487,right,T5a,751,1,6,2,4
720575940635797134,right,T5a,752,-2,7,5,2
720575940635373560,right,T5a,753,-3,24,15,9
720575940638000061,right,T5a,754,-1,-13,-6,-7
720575940626305892,right,T5a,755,4,19,5,14
720575940633316633,right,T5a,756,5,20,5,15
720575940637529229,right,T5a,757,0,-6,-3,-3
720575940623381578,right,T5a,758,5,-1,-6,5
720575940620994656,right,T5a,759,7,14,0,14
720575940626858748,right,T5a,760,0,17,8,9
720575940626571484,right,T5a,761,-4,-18,-5,-13
720575940617722525,right,T5a,762,0,14,7,7
720575940636375182,right,T5a,763,-5,14,12,2
720575940624012040,right,T5a,765,-3,9,7,2
720575940630449628,right,T5a,766,2,-4,-4,0
720575940635751103,right,T5a,767,1,28,13,15
720575940623826249,right,T5a,768,3,5,-1,6
720575940640545243,right,T5a,769,4,-27,-18,-9
720575940609226709,right,T5a,770,5,4,-3,7
720575940618345729,right,T5a,771,3,-27,-17,-10
720575940618943053,right,T5a,772,1,12,5,7
720575940631814248,right,T5a,773,5,-19,-15,-4
720575940621172033,right,T5a,775,5,22,6,16
720575940626400770,right,T5a,776,5,21,5,16
720575940640062115,right,T5a,778,4,25,8,17
720575940622937323,right,T5a,779,5,24,7,17
720575940622395263,right,T5a,780,-6,25,18,7
720575940623950889,right,T5a,781,-5,26,18,8
720575940627525181,right,T5a,782,-5,27,18,9
720575940638713690,right,T5a,783,-4,28,18,10
720575940633038748,right,T5a,784,-4,29,18,11
720575940630118338,right,T5a,785,-3,30,18,12
720575940634404322,right,T5a,786,-2,30,17,13
720575940630305756,right,T5a,787,3,28,11,17
720575940633615807,right,T5a,790,-2,-27,-12,-15
720575940619871597,right,T5a,792,8,2,-7,9
720575940621291440,right,T5a,793,8,-6,-11,5
720575940621094895,right,T5a,795,6,-21,-17,-4
720575940633655694,right,T5a,796,4,26,9,17
720575940624041451,right,T5b,1,-6,13,12,1
720575940639294323,right,T5b,2,-8,2,9,-7
720575940631192620,right,T5b,3,6,-12,-12,0
720575940626502756,right,T5b,4,-5,-21,-6,-15
720575940620526757,right,T5b,5,-1,16,9,7
720575940625876226,right,T5b,6,-2,-4,0,-4
720575940625371024,right,T5b,7,-6,-6,3,-9
720575940644320200,right,T5b,8,-4,26,17,9
720575940631548714,right,T5b,9,4,9,0,9
720575940633697983,right,T5b,10,5,-15,-13,-2
720575940617634233,right,T5b,11,7,-14,-14,0
720575940628920219,right,T5b,12,-7,9,11,-2
720575940623544712,right,T5b,13,-1,-26,-12,-14
720575940627814410,right,T5b,14,0,-27,-14,-13
720575940613499857,right,T5b,15,2,-3,-4,1
720575940630604047,right,T5b,16,-2,-16,-6,-10
720575940620241755,right,T5b,17,1,-5,-4,-1
720575940619022757,right,T5b,18,5,-16,-13,-3
720575940627814163,right,T5b,19,-7,17,15,2
720575940623926527,right,T5b,20,3,-11,-9,-2
720575940624752316,right,T5b,21,-2,19,11,8
720575940627124746,right,T5b,22,-1,3,2,1
720575940605084774,right,T5b,23,-3,-16,-5,-11
720575940619209664,right,T5b,24,-1,-10,-4,-6
720575940628237041,right,T5b,25,-9,3,10,-7
720575940640254928,right,T5b,26,1,-3,-3,0
720575940634942143,right,T5b,27,0,-25,-13,-12
720575940611041459,right,T5b,28,5,6,-2,8
720575940622385869,right,T5b,29,-1,-3,-1,-2
720575940612342770,right,T5b,30,6,16,2,14
720575940624961328,right,T5b,31,0,16,8,8
720575940610213582,right,T5b,32,0,12,6,6
720575940618240769,right,T5b,33,3,18,6,12
720575940626835545,right,T5b,34,6,18,3,15
720575940612354711,right,T5b,35,1,-24,-13,-11
720575940633499929,right,T5b,36,6,8,-2,10
720575940633548510,right,T5b,37,1,5,1,4
720575940621776901,right,T5b,38,0,-2,-1,-1
720575940605903532,right,T5b,39,0,20,10,10
720575940628431632,right,T5b,40,-2,-6,-1,-5
720575940646797347,right,T5b,41,-3,28,17,11
720575940620387137,right,T5b,42,-1,14,8,6
720575940632416398,right,T5b,43,-5,18,14,4
720575940605793894,right,T5b,44,5,-10,-10,0
720575940649335929,right,T5b,45,-5,-1,4,-5
720575940607035314,right,T5b,46,-5,15,12,3
720575940612145301,right,T5b,47,-9,-1,8,-9
720575940612768405,right,T5b,48,-4,-22,-7,-15
720575940636764078,right,T5b,49,4,-4,-6,2
720575940623053261,right,T5b,50,-2,21,12,9
720575940616904889,right,T5b,51,0,-19,-10,-9
720575940631310351,right,T5b,52,-1,-22,-10,-12
720575940636214903,right,T5b,53,5,14,2,12
720575940637439972,right,T5b,54,-4,3,5,-2
720575940633773919,right,T5b,55,-4,-11,-2,-9
720575940617832758,right,T5b,56,1,-13,-8,-5
720575940629473324,right,T5b,57,6,-11,-12,1
720575940608472797,right,T5b,58,3,12,3,9
720575940621915350,right,T5b,59,-2,2,3,-1
720575940627635972,right,T5b,60,-8,8,12,-4
720575940623164307,right,T5b,61,-4,-4,2,-6
720575940617396497,right,T5b,63,4,12,2,10
720575940624829989,right,T5b,64,4,-23,-16,-7
720575940617821881,right,T5b,65,-1,28,15,13
720575940631256338,right,T5b,66,2,15,5,10
720575940659807361,right,T5b,67,-2,-13,-5,-8
720575940630024779,right,T5b,68,3,16,5,11
720575940619075661,right,T5b,69,1,8,3,5
720575940639237710,right,T5b,70,-4,21,14,7
720575940626740404,right,T5b,71,-2,-3,0,-3
720575940631813391,right,T5b,72,0,-28,-14,-14
720575940621399284,right,T5b,73,2,2,-1,3
720575940621522122,right,T5b,74,-1,-9,-4,-5
720575940635287476,right,T5b,75,-6,14,13,1
720575940621749416,right,T5b,76,-3,-4,1,-5
720575940624335434,right,T5b,77,2,-5,-5,0
720575940616846934,right,T5b,78,2,20,8,12
720575940613674291,right,T5b,79,2,1,-2,3
720575940623126762,right,T5b,80,4,13,2,11
720575940600071689,right,T5b,81,6,-2,-7,5
720575940632734637,right,T5b,82,-7,7,10,-3
720575940620766561,right,T5b,83,2,-21,-13,-8
720575940621890518,right,T5b,84,-2,12,8,4
720575940607583939,right,T5b,85,4,-22,-15,-7
720575940620656598,right,T5b,86,-5,-7,1,-8
720575940621694049,right,T5b,87,1,11,4,7
720575940627431940,right,T5b,88,7,4,-5,9
720575940619165525,right,T5b,89,1,-19,-11,-8
720575940624646076,right,T5b,90,-4,5,6,-1
720575940633235225,right,T5b,91,-1,6,4,2
720575940637557481,right,T5b,92,0,9,4,5
720575940627378965,right,T5b,93,-6,3,7,-4
720575940632213924,right,T5b,94,5,18,4,14
720575940628800006,right,T5b,95,4,-21,-15,-6
720575940624436238,right,T5b,96,1,-10,-6,-4
720575940630382966,right,T5b,97,-5,2,6,-4
720575940633234658,right,T5b,98,-1,-12,-5,-7
720575940622254162,right,T5b,99,4,15,3,12
720575940627058186,right,T5b,100,2,-10,-7,-3
720575940614427542,right,T5b,101,-7,6,10,-4
720575940625968228,right,T5b,102,3,13,3,10
720575940613876370,right,T5b,104,-1,-27,-13,-14
720575940627790076,right,T5b,105,3,22,8,14
720575940635286196,right,T5b,106,-7,11,12,-1
720575940631958097,right,T5b,108,-3,-12,-3,-9
720575940616919109,right,T5b,109,4,-5,-7,2
720575940617100044,right,T5b,110,-7,0,7,-7
720575940619335407,right,T5b,111,2,-24,-14,-10
720575940628532267,right,T5b,112,-6,1,6,-5
720575940630321401,right,T5b,113,-2,4,4,0
720575940624048898,right,T5b,114,2,-13,-9,-4
720575940620190959,right,T5b,115,-4,2,5,-3
720575940646191395,right,T5b,116,-1,-8,-3,-5
720575940604875744,right,T5b,117,-8,-2,7,-9
720575940642648116,right,T5b,118,3,1,-3,4
720575940624011784,right,T5b,119,-2,6,5,1
720575940619167147,right,T5b,120,-1,-1,0,-1
720575940621390975,right,T5b,121,-8,4,10,-6
720575940632577934,right,T5b,122,-5,9,9,0
720575940635171695,right,T5b,123,-8,10,13,-3
720575940614224126,right,T5b,124,1,-7,-5,-2
720575940628304643,right,T5b,125,5,9,-1,10
720575940616929595,right,T5b,126,3,11,2,9
720575940618137165,right,T5b,127,0,15,7,8
720575940618404312,right,T5b,128,3,-22,-14,-8
720575940622283786,right,T5b,129,0,-13,-7,-6
720575940640999309,right,T5b,130,2,12,4,8
720575940609341141,right,T5b,131,-6,20,16,4
720575940622777385,right,T5b,132,2,4,0,4
720575940629318351,right,T5b,133,-3,20,13,7
720575940634202480,right,T5b,134,-5,-18,-4,-14
720575940638036452,right,T5b,135,-3,-22,-8,-14
720575940632397599,right,T5b,136,0,3,1,2
720575940628421105,right,T5b,137,5,-7,-9,2
720575940619867259,right,T5b,138,0,27,13,14
720575940622282762,right,T5b,139,1,-14,-8,-6
720575940628270083,right,T5b,140,3,8,1,7
720575940623036362,right,T5b,142,-2,-18,-7,-11
720575940608162652,right,T5b,143,-4,16,12,4
720575940638608606,right,T5b,144,7,-11,-13,2
720575940626778311,right,T5b,145,0,4,2,2
720575940628842951,right,T5b,146,1,-6,-4,-2
720575940617470609,right,T5b,147,1,21,9,12
720575940636118895,right,T5b,148,-7,-11,1,-12
720575940609043925,right,T5b,149,6,-14,-13,-1
720575940627139410,right,T5b,150,-8,5,10,-5
720575940623207608,right,T5b,151,-3,-14,-4,-10
720575940622756707,right,T5b,155,-8,13,14,-1
720575940625641418,right,T5b,156,-9,1,9,-8
720575940613640421,right,T5b,157,-1,-7,-3,-4
720575940627550120,right,T5b,158,3,-5,-6,1
720575940620528736,right,T5b,159,7,7,-4,11
720575940610557048,right,T5b,160,-2,20,12,8
720575940623280127,right,T5b,161,4,-14,-11,-3
720575940623571383,right,T5b,162,-4,-2,3,-5
720575940634895002,right,T5b,163,-9,7,12,-5
720575940605353905,right,T5b,164,-1,-2,0,-2
720575940614411154,right,T5b,165,4,16,4,12
720575940634834330,right,T5b,166,0,18,9,9
720575940634421099,right,T5b,167,0,-17,-9,-8
720575940623325624,right,T5b,168,-1,17,9,8
720575940628090353,right,T5b,169,0,-18,-9,-9
720575940628187978,right,T5b,170,-5,1,5,-4
720575940633297107,right,T5b,171,6,-20,-16,-4
720575940633395999,right,T5b,172,1,22,10,12
720575940638575192,right,T5b,173,2,-25,-15,-10
720575940628856836,right,T5b,174,4,-15,-12,-3
720575940616396917,right,T5b,175,-6,-7,2,-9
720575940634164702,right,T5b,176,-2,13,8,5
720575940649361785,right,T5b,177,-2,-1,1,-2
720575940623598311,right,T5b,178,2,11,3,8
720575940623296507,right,T5b,179,-5,-16,-3,-13
720575940634034457,right,T5b,180,2,-27,-16,-11
720575940612882669,right,T5b,181,1,-4,-3,-1
720575940623248010,right,T5b,183,-5,-15,-3,-12
720575940630955700,right,T5b,184,-6,-5,3,-8
720575940611608946,right,T5b,185,2,-11,-8,-3
720575940606734002,right,T5b,187,3,21,7,14
720575940629961175,right,T5b,188,-5,17,13,4
720575940646927924,right,T5b,189,6,13,0,13
720575940630375542,right,T5b,190,-3,-5,0,-5
720575940606499017,right,T5b,191,-1,-11,-5,-6
720575940605492670,right,T5b,193,-5,4,7,-3
720575940622043560,right,T5b,194,0,-5,-3,-2
720575940620353518,right,T5b,195,-3,-1,2,-3
720575940610515698,right,T5b,196,-1,8,5,3
720575940636302990,right,T5b,197,0,-20,-10,-10
720575940612751513,right,T5b,198,6,2,-5,7
720575940624430094,right,T5b,199,0,-12,-6,-6
720575940631281706,right,T5b,200,-5,12,11,1
720575940624033515,right,T5b,201,-8,9,12,-3
720575940629156938,right,T5b,202,-1,27,14,13
720575940617301177,right,T5b,203,3,-1,-4,3
720575940609600580,right,T5b,204,5,-2,-6,4
720575940628657451,right,T5b,205,5,-6,-8,2
720575940618112069,right,T5b,206,-3,5,5,0
720575940638971364,right,T5b,207,1,29,13,16
720575940627348841,right,T5b,208,5,-21,-16,-5
720575940604105137,right,T5b,209,-3,-8,-1,-7
720575940613876718,right,T5b,210,-6,8,10,-2
720575940649314169,right,T5b,211,-7,-1,6,-7
720575940622362890,right,T5b,212,2,-16,-10,-6
720575940617110233,right,T5b,213,3,-4,-5,1
720575940629379194,right,T5b,214,-5,3,6,-3
720575940630299127,right,T5b,215,6,7,-3,10
720575940622626985,right,T5b,216,2,19,7,12
720575940617180049,right,T5b,217,6,15,1,14
720575940622441181,right,T5b,218,2,10,3,7
720575940626245890,right,T5b,219,6,-4,-8,4
720575940630619599,right,T5b,220,2,-6,-5,-1
720575940609553476,right,T5b,221,-7,3,8,-5
720575940647822468,right,T5b,222,-3,26,16,10
720575940633486765,right,T5b,223,-2,26,15,11
720575940605096550,right,T5b,224,0,5,2,3
720575940622874385,right,T5b,226,5,19,4,15
720575940632632365,right,T5b,227,-7,5,9,-4
720575940614638442,right,T5b,228,-7,1,7,-6
720575940641634612,right,T5b,229,5,2,-4,6
720575940634970743,right,T5b,230,2,9,2,7
720575940635109983,right,T5b,231,4,-12,-10,-2
720575940623841461,right,T5b,232,-4,13,10,3
720575940614722541,right,T5b,233,4,-13,-11,-2
720575940623004454,right,T5b,234,1,3,0,3
720575940610188494,right,T5b,235,4,11,1,10
720575940628588135,right,T5b,236,-1,4,3,1
720575940631006012,right,T5b,237,-2,27,15,12
720575940633748706,right,T5b,238,-8,-3,6,-9
720575940631829644,right,T5b,239,-6,6,9,-3
720575940615665458,right,T5b,240,-4,-3,2,-5
720575940630067676,right,T5b,241,2,-17,-11,-6
720575940609663812,right,T5b,242,-4,6,7,-1
720575940624823700,right,T5b,243,-1,-21,-10,-11
720575940614590429,right,T5b,244,-4,-12,-2,-10
720575940625936740,right,T5b,245,-5,-3,3,-6
720575940622620705,right,T5b,246,-4,15,11,4
720575940636271758,right,T5b,247,-4,-15,-4,-11
720575940620333038,right,T5b,248,-6,0,6,-6
720575940617185403,right,T5b,249,2,-12,-8,-4
720575940640536053,right,T5b,250,-1,1,1,0
720575940621853386,right,T5b,251,-1,-14,-6,-8
720575940625504601,right,T5b,252,3,23,8,15
720575940633764959,right,T5b,253,5,16,3,13
720575940612906904,right,T5b,254,3,-24,-15,-9
720575940611805333,right,T5b,255,-6,-13,-1,-12
720575940614296214,right,T5b,256,5,-20,-15,-5
720575940615560278,right,T5b,257,2,21,8,13
720575940627087930,right,T5b,258,-4,-17,-5,-12
720575940632452909,right,T5b,259,-7,-5,4,-9
720575940626435459,right,T5b,260,-3,19,12,7
720575940624993836,right,T5b,261,-1,13,7,6
720575940639907517,right,T5b,262,1,-11,-7,-4
720575940631703341,right,T5b,263,-3,4,5,-1
720575940617382740,right,T5b,264,-1,-6,-2,-4
720575940620274566,right,T5b,265,-6,-1,5,-6
720575940615026070,right,T5b,266,-1,-25,-12,-13
720575940637727066,right,T5b,267,-6,2,7,-5
720575940629788542,right,T5b,268,7,-6,-10,4
720575940643819812,right,T5b,269,2,-19,-12,-7
720575940627372565,right,T5b,270,1,-8,-5,-3
720575940623927559,right,T5b,271,4,6,-1,7
720575940600124169,right,T5b,272,3,-2,-4,2
720575940629260035,right,T5b,273,-6,23,17,6
720575940624601392,right,T5b,274,6,4,-4,8
720575940654389921,right,T5b,275,-8,-1,7,-8
720575940613673779,right,T5b,276,2,3,-1,4
720575940610294979,right,T5b,277,7,-3,-9,6
720575940611561109,right,T5b,278,-5,10,10,0
720575940608334345,right,T5b,279,-4,8,8,0
720575940606077374,right,T5b,280,-6,-14,-1,-13
720575940632454957,right,T5b,281,-9,2,10,-8
720575940642465499,right,T5b,282,0,26,13,13
720575940623551565,right,T5b,283,-4,4,6,-2
720575940621107136,right,T5b,284,0,25,12,13
720575940612110946,right,T5b,285,6,-18,-15,-3
720575940627661640,right,T5b,286,0,-24,-12,-12
720575940617845533,right,T5b,287,-5,13,11,2
720575940619726727,right,T5b,289,-1,11,6,5
720575940627584787,right,T5b,290,5,-24,-17,-7
720575940641563700,right,T5b,291,7,2,-6,8
720575940627212618,right,T5b,292,-4,18,13,5
720575940615313373,right,T5b,293,4,-17,-13,-4
720575940630264919,right,T5b,294,1,-20,-11,-9
720575940626260780,right,T5b,295,-2,29,16,13
720575940613056218,right,T5b,296,1,-18,-10,-8
720575940642021773,right,T5b,298,-5,5,7,-2
720575940629847808,right,T5b,299,-4,12,10,2
720575940624101709,right,T5b,300,4,-18,-13,-5
720575940619211480,right,T5b,301,-5,16,13,3
720575940620645709,right,T5b,302,2,17,6,11
720575940621605997,right,T5b,303,-5,22,16,6
720575940631024209,right,T5b,304,6,5,-4,9
720575940636419502,right,T5b,305,-7,4,9,-5
720575940619501982,right,T5b,306,3,7,0,7
720575940639550928,right,T5b,307,5,-25,-18,-7
720575940620876935,right,T5b,308,-5,8,9,-1
720575940617251001,right,T5b,309,-6,12,12,0
720575940629755947,right,T5b,310,2,22,9,13
720575940621720158,right,T5b,311,-7,15,14,1
720575940631235343,right,T5b,312,4,-7,-8,1
720575940622710655,right,T5b,313,7,3,-6,9
720575940630204636,right,T5b,314,-9,5,11,-6
720575940625217661,right,T5b,315,-3,-6,0,-6
720575940632682067,right,T5b,316,5,-4,-7,3
720575940605306726,right,T5b,317,-5,-4,3,-7
720575940636011127,right,T5b,318,4,-19,-14,-5
720575940630341371,right,T5b,319,-2,5,4,1
720575940620415809,right,T5b,320,-2,-5,-1,-4
720575940619868539,right,T5b,322,2,26,11,15
720575940616219353,right,T5b,323,-7,-13,0,-13
720575940620346900,right,T5b,324,3,24,9,15
720575940638137140,right,T5b,325,5,1,-5,6
720575940623854077,right,T5b,326,2,16,6,10
720575940612186803,right,T5b,327,5,3,-4,7
720575940613291749,right,T5b,328,5,-9,-10,1
720575940626638384,right,T5b,329,0,24,12,12
720575940640591924,right,T5b,330,3,3,-2,5
720575940626627076,right,T5b,331,1,-15,-9,-6
720575940625013948,right,T5b,332,4,-26,-17,-9
720575940631323663,right,T5b,333,0,-21,-11,-10
720575940616268866,right,T5b,335,2,8,2,6
720575940629388785,right,T5b,336,0,23,11,12
720575940623165608,right,T5b,337,-5,-6,2,-8
720575940624434616,right,T5b,338,-1,0,1,-1
720575940617516729,right,T5b,339,6,11,-1,12
720575940643754952,right,T5b,340,-4,17,12,5
720575940631188524,right,T5b,341,6,-17,-15,-2
720575940622639715,right,T5b,342,2,-15,-10,-5
720575940628362813,right,T5b,343,-3,27,16,11
720575940616626945,right,T5b,344,-2,-15,-6,-9
720575940615040943,right,T5b,345,3,-12,-9,-3
720575940621010785,right,T5b,346,-7,-9,2,-11
720575940605398304,right,T5b,347,-5,-13,-2,-11
720575940631306538,right,T5b,348,3,14,4,10
720575940613804083,right,T5b,349,-5,-14,-2,-12
720575940621460872,right,T5b,350,1,15,6,9
720575940630306007,right,T5b,351,-1,-17,-8,-9
720575940633168548,right,T5b,352,-2,28,16,12
720575940610896708,right,T5b,353,2,24,10,14
720575940637227998,right,T5b,355,-7,-6,4,-10
720575940629434630,right,T5b,356,0,22,11,11
720575940637873636,right,T5b,357,4,17,4,13
720575940621178806,right,T5b,358,-3,17,11,6
720575940619867771,right,T5b,359,2,23,9,14
720575940623986439,right,T5b,360,-5,19,14,5
720575940637536653,right,T5b,361,0,-7,-4,-3
720575940626193283,right,T5b,362,2,-20,-12,-8
720575940617643810,right,T5b,363,7,-4,-9,5
720575940617529378,right,T5b,364,4,4,-2,6
720575940629493626,right,T5b,365,4,7,-1,8
720575940635926008,right,T5b,366,-5,-20,-5,-15
720575940624823283,right,T5b,367,-6,-15,-2,-13
720575940613718824,right,T5b,368,-4,-20,-6,-14
720575940615056790,right,T5b,369,5,-5,-8,3
720575940608492299,right,T5b,370,-3,21,13,8
720575940640310480,right,T5b,371,6,-5,-9,4
720575940620348513,right,T5b,372,1,-2,-2,0
720575940612945686,right,T5b,373,1,-21,-12,-9
720575940643532704,right,T5b,374,2,13,4,9
720575940613771246,right,T5b,375,-6,7,9,-2
720575940647828356,right,T5b,376,-7,-10,2,-12
720575940614862226,right,T5b,377,0,7,3,4
720575940626719262,right,T5b,379,3,-17,-12,-5
720575940607688393,right,T5b,380,-1,29,15,14
720575940625567762,right,T5b,382,3,-6,-6,0
720575940636188261,right,T5b,383,-6,11,11,0
720575940632823912,right,T5b,385,-3,-18,-6,-12
720575940627141946,right,T5b,386,-6,19,15,4
720575940619016408,right,T5b,387,-1,-15,-7,-8
720575940617473163,right,T5b,388,3,19,6,13
720575940622436641,right,T5b,389,-6,-16,-2,-14
720575940628494588,right,T5b,390,-6,-9,1,-10
720575940621816140,right,T5b,391,4,-3,-6,3
720575940632638253,right,T5b,392,-4,7,7,0
720575940615674262,right,T5b,393,-1,22,12,10
720575940624801511,right,T5b,394,-7,-8,3,-11
720575940609966690,right,T5b,395,0,-22,-11,-11
720575940618999461,right,T5b,396,-1,10,6,4
720575940614672786,right,T5b,397,-3,-19,-7,-12
720575940609195971,right,T5b,398,-3,22,14,8
720575940631525839,right,T5b,399,-4,-24,-8,-16
720575940616238009,right,T5b,400,1,-29,-16,-13
720575940614276002,right,T5b,401,-2,-19,-8,-11
720575940612861649,right,T5b,402,3,26,10,16
720575940621985482,right,T5b,403,-2,-12,-4,-8
720575940638418246,right,T5b,404,-1,20,11,9
720575940620237039,right,T5b,405,3,10,2,8
720575940635981167,right,T5b,406,1,-25,-14,-11
720575940622687757,right,T5b,407,-5,-10,0,-10
720575940623725385,right,T5b,408,-6,-4,4,-8
720575940622044328,right,T5b,409,0,-3,-2,-1
720575940632081316,right,T5b,410,-2,-2,1,-3
720575940616582027,right,T5b,411,-5,-19,-5,-14
720575940615218087,right,T5b,412,-6,21,16,5
720575940604413664,right,T5b,413,-2,-7,-2,-5
720575940621690100,right,T5b,414,4,21,6,15
720575940642268045,right,T5b,415,6,12,0,12
720575940630118871,right,T5b,416,3,-8,-7,-1
720575940621785377,right,T5b,417,-6,-10,1,-11
720575940627757800,right,T5b,418,-2,15,9,6
720575940624677048,right,T5b,419,-3,-11,-3,-8
720575940609201347,right,T5b,420,6,-3,-8,5
720575940628459536,right,T5b,421,-1,12,7,5
720575940640587472,right,T5b,422,-7,-4,5,-9
720575940643722440,right,T5b,423,3,-18,-12,-6
720575940610587000,right,T5b,424,-3,-2,2,-4
720575940629699063,right,T5b,425,3,20,7,13
720575940603873033,right,T5b,426,-3,0,3,-3
720575940617495508,right,T5b,427,5,-18,-14,-4
720575940606926722,right,T5b,428,-2,23,13,10
720575940654512545,right,T5b,429,-2,14,9,5
720575940622620874,right,T5b,430,-3,-7,-1,-6
720575940604427232,right,T5b,431,-2,-10,-3,-7
720575940624514547,right,T5b,432,-5,7,8,-1
720575940630003983,right,T5b,433,0,-8,-4,-4
720575940611748216,right,T5b,434,-3,7,6,1
720575940620289729,right,T5b,435,5,-17,-14,-3
720575940628376679,right,T5b,436,0,-15,-8,-7
720575940636270181,right,T5b,437,-3,12,9,3
720575940639536291,right,T5b,439,-3,-9,-2,-7
720575940619396933,right,T5b,440,1,23,10,13
720575940622650723,right,T5b,441,3,-16,-11,-5
720575940621889206,right,T5b,442,-5,25,17,8
720575940622120268,right,T5b,443,-6,4,8,-4
720575940620314305,right,T5b,445,-2,8,6,2
720575940627887888,right,T5b,446,2,-14,-9,-5
720575940622983146,right,T5b,447,-1,2,2,0
720575940629461097,right,T5b,448,0,30,15,15
720575940642267021,right,T5b,449,6,-16,-14,-2
720575940631527480,right,T5b,450,2,-9,-7,-2
720575940623287081,right,T5b,451,4,20,6,14
720575940626999689,right,T5b,452,1,-9,-6,-3
720575940633648526,right,T5b,453,3,25,9,16
720575940619355984,right,T5b,454,5,-12,-11,-1
720575940631856451,right,T5b,455,7,-7,-11,4
720575940631816143,right,T5b,456,0,21,10,11
720575940609251523,right,T5b,458,5,0,-5,5
720575940609985860,right,T5b,459,5,-3,-7,4
720575940617694182,right,T5b,460,-3,-20,-7,-13
720575940627842792,right,T5b,461,7,-5,-10,5
720575940622057804,right,T5b,462,-1,18,10,8
720575940626835801,right,T5b,463,5,17,3,14
720575940621747580,right,T5b,464,4,0,-4,4
720575940640595252,right,T5b,465,3,0,-3,3
720575940624032747,right,T5b,466,1,14,6,8
720575940617586210,right,T5b,467,-2,-20,-8,-12
720575940618962136,right,T5b,468,-3,11,8,3
720575940638375494,right,T5b,469,-7,13,13,0
720575940613248435,right,T5b,470,4,-9,-9,0
720575940621949985,right,T5b,471,3,-26,-16,-10
720575940628549653,right,T5b,472,1,25,11,14
720575940637741402,right,T5b,473,-4,23,15,8
720575940613889587,right,T5b,474,-3,-17,-6,-11
720575940627415976,right,T5b,475,-4,-1,3,-4
720575940626403715,right,T5b,476,-1,15,8,7
720575940608400139,right,T5b,477,-3,2,4,-2
720575940620380075,right,T5b,478,-7,16,15,1
720575940608669379,right,T5b,479,-2,10,7,3
720575940635021759,right,T5b,480,3,-19,-13,-6
720575940621092212,right,T5b,482,1,17,7,10
720575940620319323,right,T5b,483,2,-7,-6,-1
720575940610914010,right,T5b,484,3,-9,-8,-1
720575940633016019,right,T5b,485,-3,-3,1,-4
720575940620414794,right,T5b,486,0,1,0,1
720575940630389445,right,T5b,487,1,-1,-2,1
720575940638471768,right,T5b,488,7,5,-5,10
720575940621011696,right,T5b,489,-3,10,8,2
720575940630941714,right,T5b,490,-5,6,8,-2
720575940618207045,right,T5b,491,7,-1,-8,7
720575940612064997,right,T5b,492,-7,-2,6,-8
720575940627063326,right,T5b,493,-3,23,14,9
720575940614121443,right,T5b,494,0,29,14,15
720575940614974110,right,T5b,495,4,5,-2,7
720575940639618432,right,T5b,497,6,1,-6,7
720575940620428668,right,T5b,498,6,10,-1,11
720575940624593968,right,T5b,499,5,10,0,10
720575940626638110,right,T5b,501,1,2,0,2
720575940616731665,right,T5b,502,5,8,-1,9
720575940606800073,right,T5b,503,3,17,5,12
720575940626441561,right,T5b,504,-2,9,6,3
720575940617976389,right,T5b,506,1,-12,-7,-5
720575940626560220,right,T5b,507,-5,-12,-1,-11
720575940627773416,right,T5b,508,-5,11,10,1
720575940629082684,right,T5b,509,-4,10,9,1
720575940639396003,right,T5b,510,-2,11,7,4
720575940634400959,right,T5b,511,5,-11,-11,0
720575940625663280,right,T5b,512,6,0,-6,6
720575940599459782,right,T5b,513,-4,-13,-3,-10
720575940628029306,right,T5b,514,-4,-10,-1,-9
720575940631913041,right,T5b,515,-8,-7,4,-11
720575940612790442,right,T5b,517,6,3,-5,8
720575940620910171,right,T5b,518,-4,22,15,7
720575940627312456,right,T5b,519,-5,-5,2,-7
720575940627426362,right,T5b,520,-2,-22,-9,-13
720575940623536020,right,T5b,521,6,-9,-11,2
720575940643520160,right,T5b,522,-4,0,4,-4
720575940618652982,right,T5b,523,2,14,5,9
720575940618665339,right,T5b,525,-1,-20,-9,-11
720575940646528308,right,T5b,526,0,-10,-5,-5
720575940631186596,right,T5b,527,-4,-8,0,-8
720575940608276233,right,T5b,528,2,7,1,6
720575940622693119,right,T5b,529,2,-2,-3,1
720575940624675512,right,T5b,530,-3,-13,-4,-9
720575940611067505,right,T5b,531,1,0,-1,1
720575940639446104,right,T5b,532,-8,7,11,-4
720575940624698040,right,T5b,533,0,-16,-8,-8
720575940642643252,right,T5b,534,3,2,-2,4
720575940610397230,right,T5b,535,8,-4,-10,6
720575940624804861,right,T5b,536,3,4,-1,5
720575940626240514,right,T5b,537,0,-23,-12,-11
720575940627254532,right,T5b,538,-4,1,4,-3
720575940626210844,right,T5b,539,-6,15,13,2
720575940626012930,right,T5b,540,-2,-9,-3,-6
720575940622685795,right,T5b,541,-4,14,11,3
720575940621342902,right,T5b,542,6,-13,-13,0
720575940627859655,right,T5b,543,-1,-4,-1,-3
720575940609068227,right,T5b,544,3,-13,-10,-3
720575940628805019,right,T5b,545,5,11,0,11
720575940628933873,right,T5b,546,3,6,0,6
720575940634467064,right,T5b,547,-1,21,11,10
720575940611976115,right,T5b,548,1,-16,-9,-7
720575940617211351,right,T5b,549,0,-9,-5,-4
720575940623950077,right,T5b,550,-2,3,3,0
720575940630364983,right,T5b,551,-4,-9,-1,-8
720575940607859804,right,T5b,552,4,-1,-5,4
720575940613877299,right,T5b,553,-3,16,11,5
720575940614332322,right,T5b,555,-4,9,8,1
720575940618950221,right,T5b,556,0,10,5,5
720575940624913592,right,T5b,557,6,-10,-11,1
720575940646792739,right,T5b,558,-4,-21,-7,-14
720575940620805568,right,T5b,559,-6,22,17,5
720575940621975420,right,T5b,560,-7,14,14,0
720575940622079657,right,T5b,561,5,7,-2,9
720575940628863276,right,T5b,562,-5,-2,4,-6
720575940620864877,right,T5b,563,5,-13,-12,-1
720575940617512121,right,T5b,564,3,-23,-15,-8
720575940640753104,right,T5b,565,0,-26,-13,-13
720575940625823376,right,T5b,566,5,-8,-9,1
720575940614598546,right,T5b,567,-2,22,13,9
720575940635187557,right,T5b,568,-6,-8,2,-10
720575940610070596,right,T5b,569,6,6,-3,9
720575940610895684,right,T5b,570,2,25,10,15
720575940599733446,right,T5b,571,0,-14,-7,-7
720575940634600287,right,T5b,572,-8,3,9,-6
720575940628081482,right,T5b,573,4,14,3,11
720575940624439015,right,T5b,574,-6,5,8,-3
720575940620534624,right,T5b,575,6,9,-2,11
720575940621640027,right,T5b,576,0,28,14,14
720575940630246555,right,T5b,577,5,-14,-12,-2
720575940628618106,right,T5b,578,4,-11,-10,-1
720575940640625792,right,T5b,579,-3,-10,-2,-8
720575940634215836,right,T5b,580,-2,-23,-10,-13
720575940616761617,right,T5b,581,3,9,1,8
720575940633683757,right,T5b,582,-1,23,12,11
720575940632534988,right,T5b,583,3,-25,-16,-9
720575940626251909,right,T5b,584,4,23,7,16
720575940625939749,right,T5b,585,-1,-23,-11,-12
720575940638400582,right,T5b,586,2,18,7,11
720575940632630611,right,T5b,587,4,22,7,15
720575940624885543,right,T5b,588,1,4,1,3
720575940627523527,right,T5b,589,-1,-5,-2,-3
720575940623994860,right,T5b,590,1,9,3,6
720575940624292938,right,T5b,591,3,-3,-5,2
720575940618053147,right,T5b,593,3,-14,-10,-4
720575940612962730,right,T5b,594,7,-16,-15,-1
720575940631330263,right,T5b,595,7,-12,-13,1
720575940626565852,right,T5b,596,-4,-16,-4,-12
720575940630029612,right,T5b,597,4,1,-4,5
720575940604411616,right,T5b,598,2,-18,-11,-7
720575940626065753,right,T5b,599,-1,9,5,4
720575940636529765,right,T5b,600,3,-10,-8,-2
720575940605051052,right,T5b,601,1,16,7,9
720575940629208058,right,T5b,602,4,-2,-5,3
720575940627727016,right,T5b,603,-3,-23,-9,-14
720575940627484041,right,T5b,604,-6,-17,-3,-14
720575940630884203,right,T5b,605,3,15,4,11
720575940619367872,right,T5b,606,-1,-19,-9,-10
720575940619556987,right,T5b,607,1,18,8,10
720575940618939469,right,T5b,608,1,10,4,6
720575940622680456,right,T5b,609,-2,0,2,-2
720575940632216290,right,T5b,610,2,-23,-14,-9
720575940626979461,right,T5b,611,-1,-18,-8,-10
720575940621321057,right,T5b,612,-3,-26,-10,-16
720575940632643501,right,T5b,614,-2,-8,-2,-6
720575940605238705,right,T5b,615,-7,-7,3,-10
720575940610587972,right,T5b,616,-3,15,10,5
720575940604778156,right,T5b,617,-2,-17,-7,-10
720575940632179983,right,T5b,618,-1,24,13,11
720575940634346592,right,T5b,619,-4,-19,-6,-13
720575940641563188,right,T5b,620,7,1,-7,8
720575940615887775,right,T5b,622,-5,20,15,5
720575940613219751,right,T5b,623,1,13,5,8
720575940631560504,right,T5b,624,1,-17,-10,-7
720575940641133557,right,T5b,625,-2,24,14,10
720575940621645829,right,T5b,626,-5,-8,1,-9
720575940614417887,right,T5b,627,0,-1,-1,0
720575940625204226,right,T5b,628,0,0,0,0
720575940638037318,right,T5b,629,4,24,8,16
720575940644526024,right,T5b,630,4,8,0,8
720575940615247839,right,T5b,632,3,-20,-13,-7
720575940604084704,right,T5b,633,-1,-24,-11,-13
720575940634722239,right,T5b,634,-3,-15,-5,-10
720575940630729320,right,T5b,635,6,-6,-9,3
720575940649801081,right,T5b,636,0,6,3,3
720575940612661418,right,T5b,637,3,-21,-14,-7
720575940643561888,right,T5b,638,-1,7,4,3
720575940631501123,right,T5b,639,-4,19,13,6
720575940621745441,right,T5b,640,-1,-16,-7,-9
720575940613020018,right,T5b,641,-8,-5,5,-10
720575940624740091,right,T5b,642,-5,-11,-1,-10
720575940612489113,right,T5b,643,6,14,1,13
720575940627062291,right,T5b,644,-6,18,15,3
720575940645277207,right,T5b,645,-4,27,17,10
720575940641178075,right,T5b,647,-4,-7,0,-7
720575940617340736,right,T5b,648,1,7,2,5
720575940625961516,right,T5b,649,-1,5,3,2
720575940623596435,right,T5b,650,-3,-25,-10,-15
720575940621680252,right,T5b,651,-4,-5,1,-6
720575940603714652,right,T5b,652,-6,-11,0,-11
720575940607204530,right,T5b,653,-6,-12,0,-12
720575940635237044,right,T5b,654,-3,8,7,1
720575940609601092,right,T5b,655,6,-1,-7,6
720575940619929765,right,T5b,656,0,-11,-6,-5
720575940635192159,right,T5b,657,-2,-25,-11,-14
720575940622981325,right,T5b,658,1,20,9,11
720575940630588367,right,T5b,659,-4,-6,1,-7
720575940624885429,right,T5b,660,2,28,12,16
720575940652191734,right,T5b,661,-3,14,10,4
720575940634890095,right,T5b,662,2,-1,-3,2
720575940620765025,right,T5b,663,0,8,4,4
720575940630364160,right,T5b,664,1,-27,-15,-12
720575940612030437,right,T5b,665,7,-2,-8,6
720575940602140862,right,T5b,667,1,-28,-15,-13
720575940623023103,right,T5b,668,1,19,8,11
720575940621151809,right,T5b,669,4,-16,-12,-4
720575940620928321,right,T5b,670,5,5,-3,8
720575940634206576,right,T5b,671,-4,-23,-8,-15
720575940630972178,right,T5b,672,-8,11,13,-2
720575940647036804,right,T5b,673,2,5,0,5
720575940639037006,right,T5b,674,-4,-14,-3,-11
720575940638379846,right,T5b,675,-7,19,16,3
720575940633355987,right,T5b,676,-3,-21,-8,-13
720575940617750299,right,T5b,677,0,11,5,6
720575940628083530,right,T5b,678,3,-7,-7,0
720575940623731396,right,T5b,679,4,18,5,13
720575940628482447,right,T5b,680,-1,25,13,12
720575940606835074,right,T5b,681,-2,-21,-9,-12
720575940621949022,right,T5b,682,6,-8,-10,2
720575940612660520,right,T5b,683,2,6,1,5
720575940636601572,right,T5b,684,-6,17,14,3
720575940610865614,right,T5b,685,-5,-9,0,-9
720575940633078829,right,T5b,686,5,-22,-16,-6
720575940630614981,right,T5b,687,-6,-3,4,-7
720575940617634594,right,T5b,688,-7,10,12,-2
720575940616989243,right,T5b,689,-2,18,11,7
720575940654668193,right,T5b,690,-7,-3,5,-8
720575940641171931,right,T5b,691,-9,4,11,-7
720575940613342873,right,T5b,692,-4,24,16,8
720575940616809333,right,T5b,693,-3,25,15,10
720575940631295483,right,T5b,694,4,3,-3,6
720575940638806591,right,T5b,695,-6,10,11,-1
720575940622765508,right,T5b,696,-2,16,10,6
720575940630221980,right,T5b,697,1,-22,-12,-10
720575940625210130,right,T5b,698,6,-7,-10,3
720575940642467636,right,T5b,699,-5,0,5,-5
720575940616344849,right,T5b,700,5,15,2,13
720575940644801902,right,T5b,701,0,-4,-2,-2
720575940615329951,right,T5b,702,-5,23,16,7
720575940615362866,right,T5b,703,-3,1,3,-2
720575940643618327,right,T5b,704,-7,8,11,-3
720575940637406180,right,T5b,705,1,1,-1,2
720575940621915814,right,T5b,707,-2,25,14,11
720575940606014310,right,T5b,708,-4,-25,-9,-16
720575940623337510,right,T5b,709,-2,-24,-10,-14
720575940615556255,right,T5b,710,4,-25,-17,-8
720575940614382226,right,T5b,711,-1,19,10,9
720575940636384398,right,T5b,712,-7,12,13,-1
720575940660737921,right,T5b,713,-6,16,14,2
720575940636024183,right,T5b,714,5,12,1,11
720575940631368259,right,T5b,715,4,10,1,9
720575940631408203,right,T5b,716,4,-6,-7,1
720575940614708642,right,T5b,717,2,-22,-13,-9
720575940646796835,right,T5b,718,-5,24,17,7
720575940610895940,right,T5b,719,1,27,12,15
720575940627254842,right,T5b,720,-5,21,15,6
720575940638040142,right,T5b,721,5,13,1,12
720575940644916759,right,T5b,722,6,-15,-14,-1
720575940639771008,right,T5b,723,-2,-11,-4,-7
720575940641644084,right,T5b,724,4,2,-3,5
720575940619923029,right,T5b,725,-3,-24,-9,-15
720575940633142497,right,T5b,727,7,6,-4,10
720575940630964561,right,T5b,728,7,12,-1,13
720575940647289396,right,T5b,729,-3,29,17,12
720575940614986719,right,T5b,731,-6,9,10,-1
720575940605408870,right,T5b,732,-3,6,6,0
720575940624822771,right,T5b,733,-5,-17,-4,-13
720575940627262440,right,T5b,734,2,0,-2,2
720575940636378999,right,T5b,735,1,-23,-13,-10
720575940612068581,right,T5b,736,-8,1,8,-7
720575940628576450,right,T5b,737,0,19,9,10
720575940627043859,right,T5b,738,-3,13,9,4
720575940613606575,right,T5b,739,-7,2,8,-6
720575940633962853,right,T5b,740,2,-8,-6,-2
720575940599763910,right,T5b,741,-2,-14,-5,-9
720575940627134010,right,T5b,742,-4,11,9,2
720575940623866153,right,T5b,744,-4,25,16,9
720575940626101788,right,T5b,745,0,13,6,7
720575940627323157,right,T5b,746,-3,3,4,-1
720575940625686801,right,T5b,747,0,2,1,1
720575940624556263,right,T5b,748,-4,20,14,6
720575940620275053,right,T5b,749,-2,1,2,-1
720575940624313068,right,T5b,750,4,-24,-16,-8
720575940629472638,right,T5b,751,1,6,2,4
720575940613747562,right,T5b,752,-2,7,5,2
720575940642665101,right,T5b,753,-3,24,15,9
720575940616302292,right,T5b,754,-1,-13,-6,-7
720575940617880916,right,T5b,755,4,19,5,14
720575940620474817,right,T5b,756,5,20,5,15
720575940613064165,right,T5b,757,0,-6,-3,-3
720575940627090002,right,T5b,758,5,-1,-6,5
720575940624323657,right,T5b,759,7,14,0,14
720575940617638814,right,T5b,760,0,17,8,9
720575940633548499,right,T5b,761,-4,-18,-5,-13
720575940619232216,right,T5b,762,0,14,7,7
720575940604811692,right,T5b,763,-5,14,12,2
720575940624757739,right,T5b,764,-8,-6,5,-11
720575940631628345,right,T5b,765,-3,9,7,2
720575940618198395,right,T5b,766,2,-4,-4,0
720575940616748817,right,T5b,768,3,5,-1,6
720575940643679688,right,T5b,770,5,4,-3,7
720575940646648372,right,T5b,772,1,12,5,7
720575940634866799,right,T5b,773,5,-19,-15,-4
720575940626161922,right,T5b,774,-8,6,11,-5
720575940610805858,right,T5b,775,5,22,6,16
720575940639464867,right,T5b,777,6,20,4,16
720575940630560763,right,T5b,778,4,25,8,17
720575940646798883,right,T5b,780,-6,25,18,7
720575940610367812,right,T5b,781,-5,26,18,8
720575940627530045,right,T5b,782,-5,27,18,9
720575940618265940,right,T5b,783,-4,28,18,10
720575940627521597,right,T5b,784,-4,29,18,11
720575940621225069,right,T5b,786,-2,30,17,13
720575940611836309,right,T5b,787,3,28,11,17
720575940616174292,right,T5b,790,-2,-27,-12,-15
720575940638991413,right,T5c,1,-6,13,12,1
720575940620353883,right,T5c,2,-8,2,9,-7
720575940627191823,right,T5c,3,6,-12,-12,0
720575940639551797,right,T5c,4,-5,-21,-6,-15
720575940640993525,right,T5c,5,-1,16,9,7
720575940621161640,right,T5c,6,-2,-4,0,-4
720575940620162241,right,T5c,7,-6,-6,3,-9
720575940629797180,right,T5c,8,-4,26,17,9
720575940632593735,right,T5c,9,4,9,0,9
720575940626419986,right,T5c,10,5,-15,-13,-2
720575940632233287,right,T5c,11,7,-14,-14,0
720575940623059238,right,T5c,12,-7,9,11,-2
720575940627295896,right,T5c,13,-1,-26,-12,-14
720575940619893208,right,T5c,14,0,-27,-14,-13
720575940621428724,right,T5c,15,2,-3,-4,1
720575940610814682,right,T5c,16,-2,-16,-6,-10
720575940639452750,right,T5c,17,1,-5,-4,-1
720575940640102528,right,T5c,18,5,-16,-13,-3
720575940625174605,right,T5c,19,-7,17,15,2
720575940629421182,right,T5c,20,3,-11,-9,-2
720575940623790947,right,T5c,21,-2,19,11,8
720575940627420181,right,T5c,22,-1,3,2,1
720575940627024698,right,T5c,23,-3,-16,-5,-11
720575940641180123,right,T5c,24,-1,-10,-4,-6
720575940613086179,right,T5c,25,-9,3,10,-7
720575940624971341,right,T5c,26,1,-3,-3,0
720575940622298515,right,T5c,27,0,-25,-13,-12
720575940609898308,right,T5c,28,5,6,-2,8
720575940633242649,right,T5c,29,-1,-3,-1,-2
720575940631493739,right,T5c,30,6,16,2,14
720575940635093785,right,T5c,31,0,16,8,8
720575940624170061,right,T5c,32,0,12,6,6
720575940622010956,right,T5c,33,3,18,6,12
720575940620368043,right,T5c,34,6,18,3,15
720575940621365313,right,T5c,35,1,-24,-13,-11
720575940620550240,right,T5c,36,6,8,-2,10
720575940622930505,right,T5c,37,1,5,1,4
720575940633332505,right,T5c,38,0,-2,-1,-1
720575940626942508,right,T5c,39,0,20,10,10
720575940612499222,right,T5c,40,-2,-6,-1,-5
720575940624249607,right,T5c,41,-3,28,17,11
720575940639560867,right,T5c,42,-1,14,8,6
720575940614724502,right,T5c,43,-5,18,14,4
720575940627256634,right,T5c,44,5,-10,-10,0
720575940606592713,right,T5c,45,-5,-1,4,-5
720575940620559469,right,T5c,46,-5,15,12,3
720575940619616203,right,T5c,47,-9,-1,8,-9
720575940619692710,right,T5c,48,-4,-22,-7,-15
720575940613550376,right,T5c,49,4,-4,-6,2
720575940615931186,right,T5c,50,-2,21,12,9
720575940626427544,right,T5c,51,0,-19,-10,-9
720575940609351516,right,T5c,52,-1,-22,-10,-12
720575940616091954,right,T5c,53,5,14,2,12
720575940618314048,right,T5c,54,-4,3,5,-2
720575940623864503,right,T5c,55,-4,-11,-2,-9
720575940635196528,right,T5c,56,1,-13,-8,-5
720575940640014464,right,T5c,57,6,-11,-12,1
720575940623116582,right,T5c,58,3,12,3,9
720575940611606165,right,T5c,59,-2,2,3,-1
720575940605304166,right,T5c,61,-4,-4,2,-6
720575940626424005,right,T5c,63,4,12,2,10
720575940629713719,right,T5c,64,4,-23,-16,-7
720575940637713326,right,T5c,65,-1,28,15,13
720575940632564781,right,T5c,66,2,15,5,10
720575940616586891,right,T5c,67,-2,-13,-5,-8
720575940620944566,right,T5c,68,3,16,5,11
720575940615213983,right,T5c,69,1,8,3,5
720575940623921677,right,T5c,70,-4,21,14,7
720575940619025601,right,T5c,71,-2,-3,0,-3
720575940618119970,right,T5c,72,0,-28,-14,-14
720575940643808712,right,T5c,73,2,2,-1,3
720575940627215377,right,T5c,74,-1,-9,-4,-5
720575940622154828,right,T5c,75,-6,14,13,1
720575940626923530,right,T5c,76,-3,-4,1,-5
720575940624193866,right,T5c,77,2,-5,-5,0
720575940621111472,right,T5c,78,2,20,8,12
720575940625474435,right,T5c,79,2,1,-2,3
720575940620075941,right,T5c,80,4,13,2,11
720575940632240465,right,T5c,81,6,-2,-7,5
720575940620765862,right,T5c,82,-7,7,10,-3
720575940631346892,right,T5c,83,2,-21,-13,-8
720575940637799231,right,T5c,84,-2,12,8,4
720575940630092288,right,T5c,85,4,-22,-15,-7
720575940636074853,right,T5c,86,-5,-7,1,-8
720575940619067213,right,T5c,87,1,11,4,7
720575940616667509,right,T5c,88,7,4,-5,9
720575940653680545,right,T5c,89,1,-19,-11,-8
720575940636536238,right,T5c,90,-4,5,6,-1
720575940605384736,right,T5c,91,-1,6,4,2
720575940634414783,right,T5c,92,0,9,4,5
720575940596125868,right,T5c,93,-6,3,7,-4
720575940633746713,right,T5c,94,5,18,4,14
720575940629804087,right,T5c,95,4,-21,-15,-6
720575940624746573,right,T5c,96,1,-10,-6,-4
720575940620572737,right,T5c,97,-5,2,6,-4
720575940623601993,right,T5c,98,-1,-12,-5,-7
720575940659821697,right,T5c,99,4,15,3,12
720575940632442707,right,T5c,100,2,-10,-7,-3
720575940630594135,right,T5c,101,-7,6,10,-4
720575940623647975,right,T5c,102,3,13,3,10
720575940619344344,right,T5c,103,7,9,-3,12
720575940630305271,right,T5c,104,-1,-27,-13,-14
720575940639916789,right,T5c,105,3,22,8,14
720575940606601417,right,T5c,106,-7,11,12,-1
720575940604782764,right,T5c,108,-3,-12,-3,-9
720575940615280962,right,T5c,109,4,-5,-7,2
720575940642512692,right,T5c,110,-7,0,7,-7
720575940625779146,right,T5c,111,2,-24,-14,-10
720575940608661187,right,T5c,112,-6,1,6,-5
720575940618475569,right,T5c,113,-2,4,4,0
720575940620767073,right,T5c,114,2,-13,-9,-4
720575940605773233,right,T5c,115,-4,2,5,-3
720575940640646029,right,T5c,116,-1,-8,-3,-5
720575940606612098,right,T5c,117,-8,-2,7,-9
720575940614147123,right,T5c,118,3,1,-3,4
720575940615611846,right,T5c,119,-2,6,5,1
720575940629205698,right,T5c,120,-1,-1,0,-1
720575940624419303,right,T5c,121,-8,4,10,-6
720575940636450935,right,T5c,122,-5,9,9,0
720575940638518325,right,T5c,124,1,-7,-5,-2
720575940616725009,right,T5c,125,5,9,-1,10
720575940617943124,right,T5c,126,3,11,2,9
720575940628035402,right,T5c,127,0,15,7,8
720575940627798037,right,T5c,128,3,-22,-14,-8
720575940642712520,right,T5c,129,0,-13,-7,-6
720575940631505219,right,T5c,130,2,12,4,8
720575940631172665,right,T5c,132,2,4,0,4
720575940621023493,right,T5c,133,-3,20,13,7
720575940626092290,right,T5c,134,-5,-18,-4,-14
720575940638638820,right,T5c,135,-3,-22,-8,-14
720575940620148673,right,T5c,136,0,3,1,2
720575940637214349,right,T5c,137,5,-7,-9,2
720575940619869051,right,T5c,138,0,27,13,14
720575940617634388,right,T5c,139,1,-14,-8,-6
720575940616819729,right,T5c,140,3,8,1,7
720575940639040846,right,T5c,142,-2,-18,-7,-11
720575940640525776,right,T5c,143,-4,16,12,4
720575940627091593,right,T5c,144,7,-11,-13,2
720575940632148051,right,T5c,145,0,4,2,2
720575940624226633,right,T5c,146,1,-6,-4,-2
720575940617254801,right,T5c,147,1,21,9,12
720575940642395533,right,T5c,148,-7,-11,1,-12
720575940615901382,right,T5c,149,6,-14,-13,-1
720575940631277866,right,T5c,150,-8,5,10,-5
720575940620723521,right,T5c,151,-3,-14,-4,-10
720575940635690351,right,T5c,152,3,-15,-11,-4
720575940622929958,right,T5c,154,-8,0,8,-8
720575940641056308,right,T5c,156,-9,1,9,-8
720575940631716781,right,T5c,157,-1,-7,-3,-4
720575940624280906,right,T5c,158,3,-5,-6,1
720575940616250041,right,T5c,159,7,7,-4,11
720575940619804752,right,T5c,160,-2,20,12,8
720575940637751949,right,T5c,161,4,-14,-11,-3
720575940625655754,right,T5c,162,-4,-2,3,-5
720575940637404132,right,T5c,164,-1,-2,0,-2
720575940624922552,right,T5c,165,4,16,4,12
720575940620674125,right,T5c,166,0,18,9,9
720575940630906130,right,T5c,167,0,-17,-9,-8
720575940620910957,right,T5c,168,-1,17,9,8
720575940631025995,right,T5c,169,0,-18,-9,-9
720575940629012839,right,T5c,170,-5,1,5,-4
720575940628415050,right,T5c,171,6,-20,-16,-4
720575940620419008,right,T5c,173,2,-25,-15,-10
720575940615230523,right,T5c,174,4,-15,-12,-3
720575940630456151,right,T5c,175,-6,-7,2,-9
720575940634189790,right,T5c,176,-2,13,8,5
720575940610065614,right,T5c,177,-2,-1,1,-2
720575940622391821,right,T5c,178,2,11,3,8
720575940633400986,right,T5c,179,-5,-16,-3,-13
720575940629955778,right,T5c,180,2,-27,-16,-11
720575940622047656,right,T5c,181,1,-4,-3,-1
720575940624033353,right,T5c,182,7,-10,-12,2
720575940624533392,right,T5c,183,-5,-15,-3,-12
720575940640806133,right,T5c,184,-6,-5,3,-8
720575940602790610,right,T5c,185,2,-11,-8,-3
720575940606807729,right,T5c,186,-1,26,14,12
720575940630582523,right,T5c,187,3,21,7,14
720575940617782941,right,T5c,188,-5,17,13,4
720575940620591494,right,T5c,189,6,13,0,13
720575940618600059,right,T5c,190,-3,-5,0,-5
720575940628259689,right,T5c,191,-1,-11,-5,-6
720575940616316884,right,T5c,192,7,10,-2,12
720575940621678204,right,T5c,193,-5,4,7,-3
720575940622048168,right,T5c,194,0,-5,-3,-2
720575940616936285,right,T5c,195,-3,-1,2,-3
720575940605394022,right,T5c,196,-1,8,5,3
720575940605734944,right,T5c,197,0,-20,-10,-10
720575940634316439,right,T5c,198,6,2,-5,7
720575940627264168,right,T5c,199,0,-12,-6,-6
720575940621921916,right,T5c,200,-5,12,11,1
720575940615745548,right,T5c,201,-8,9,12,-3
720575940633637805,right,T5c,202,-1,27,14,13
720575940609274819,right,T5c,203,3,-1,-4,3
720575940627992519,right,T5c,204,5,-2,-6,4
720575940619332312,right,T5c,205,5,-6,-8,2
720575940632541838,right,T5c,206,-3,5,5,0
720575940630591358,right,T5c,207,1,29,13,16
720575940612463511,right,T5c,208,5,-21,-16,-5
720575940608954307,right,T5c,209,-3,-8,-1,-7
720575940625748426,right,T5c,210,-6,8,10,-2
720575940620190656,right,T5c,211,-7,-1,6,-7
720575940630342907,right,T5c,212,2,-16,-10,-6
720575940618607262,right,T5c,213,3,-4,-5,1
720575940613608232,right,T5c,214,-5,3,6,-3
720575940622383692,right,T5c,215,6,7,-3,10
720575940632211667,right,T5c,216,2,19,7,12
720575940620651361,right,T5c,217,6,15,1,14
720575940610649810,right,T5c,218,2,10,3,7
720575940605413385,right,T5c,219,6,-4,-8,4
720575940633641186,right,T5c,220,2,-6,-5,-1
720575940632191652,right,T5c,221,-7,3,8,-5
720575940627976018,right,T5c,222,-3,26,16,10
720575940638184937,right,T5c,223,-2,26,15,11
720575940633685982,right,T5c,224,0,5,2,3
720575940621023926,right,T5c,225,2,-26,-15,-11
720575940641040781,right,T5c,226,5,19,4,15
720575940625779386,right,T5c,227,-7,5,9,-4
720575940621552133,right,T5c,228,-7,1,7,-6
720575940621617647,right,T5c,229,5,2,-4,6
720575940630559991,right,T5c,230,2,9,2,7
720575940628324346,right,T5c,231,4,-12,-10,-2
720575940620773953,right,T5c,232,-4,13,10,3
720575940636896909,right,T5c,233,4,-13,-11,-2
720575940633684446,right,T5c,234,1,3,0,3
720575940606821506,right,T5c,235,4,11,1,10
720575940632272782,right,T5c,236,-1,4,3,1
720575940620207952,right,T5c,237,-2,27,15,12
720575940628104710,right,T5c,239,-6,6,9,-3
720575940626578045,right,T5c,240,-4,-3,2,-5
720575940614971005,right,T5c,241,2,-17,-11,-6
720575940643735752,right,T5c,242,-4,6,7,-1
720575940604900832,right,T5c,243,-1,-21,-10,-11
720575940625859940,right,T5c,244,-4,-12,-2,-10
720575940625796282,right,T5c,246,-4,15,11,4
720575940605371494,right,T5c,247,-4,-15,-4,-11
720575940616606779,right,T5c,248,-6,0,6,-6
720575940637296862,right,T5c,249,2,-12,-8,-4
720575940623645959,right,T5c,250,-1,1,1,0
720575940620970081,right,T5c,251,-1,-14,-6,-8
720575940622377571,right,T5c,253,5,16,3,13
720575940618229332,right,T5c,254,3,-24,-15,-9
720575940608253961,right,T5c,255,-6,-13,-1,-12
720575940633651737,right,T5c,256,5,-20,-15,-5
720575940612543146,right,T5c,257,2,21,8,13
720575940631575096,right,T5c,258,-4,-17,-5,-12
720575940606622082,right,T5c,259,-7,-5,4,-9
720575940631802937,right,T5c,260,-3,19,12,7
720575940629820972,right,T5c,261,-1,13,7,6
720575940616740027,right,T5c,262,1,-11,-7,-4
720575940614246055,right,T5c,263,-3,4,5,-1
720575940622692621,right,T5c,264,-1,-6,-2,-4
720575940649316473,right,T5c,265,-6,-1,5,-6
720575940622613206,right,T5c,266,-1,-25,-12,-13
720575940630993423,right,T5c,267,-6,2,7,-5
720575940628275817,right,T5c,268,7,-6,-10,4
720575940624439539,right,T5c,269,2,-19,-12,-7
720575940627901258,right,T5c,270,1,-8,-5,-3
720575940616755985,right,T5c,271,4,6,-1,7
720575940628950588,right,T5c,272,3,-2,-4,2
720575940605952702,right,T5c,273,-6,23,17,6
720575940624698300,right,T5c,274,6,4,-4,8
720575940628548943,right,T5c,275,-8,-1,7,-8
720575940619308109,right,T5c,276,2,3,-1,4
720575940629223038,right,T5c,277,7,-3,-9,6
720575940624716302,right,T5c,278,-5,10,10,0
720575940634184800,right,T5c,279,-4,8,8,0
720575940634256540,right,T5c,280,-6,-14,-1,-13
720575940623955592,right,T5c,282,0,26,13,13
720575940628046086,right,T5c,283,-4,4,6,-2
720575940618172121,right,T5c,284,0,25,12,13
720575940622088745,right,T5c,285,6,-18,-15,-3
720575940631740970,right,T5c,286,0,-24,-12,-12
720575940606577865,right,T5c,287,-5,13,11,2
720575940630620154,right,T5c,289,-1,11,6,5
720575940623178751,right,T5c,290,5,-24,-17,-7
720575940618143261,right,T5c,291,7,2,-6,8
720575940660034945,right,T5c,292,-4,18,13,5
720575940633670882,right,T5c,293,4,-17,-13,-4
720575940604457200,right,T5c,294,1,-20,-11,-9
720575940642007949,right,T5c,296,1,-18,-10,-8
720575940631884369,right,T5c,298,-5,5,7,-2
720575940628711415,right,T5c,299,-4,12,10,2
720575940612255641,right,T5c,300,4,-18,-13,-5
720575940615837746,right,T5c,301,-5,16,13,3
720575940617485286,right,T5c,302,2,17,6,11
720575940647828612,right,T5c,303,-5,22,16,6
720575940605174700,right,T5c,304,6,5,-4,9
720575940617820955,right,T5c,305,-7,4,9,-5
720575940631694127,right,T5c,306,3,7,0,7
720575940644957732,right,T5c,307,5,-25,-18,-7
720575940630995983,right,T5c,308,-5,8,9,-1
720575940634185568,right,T5c,309,-6,12,12,0
720575940618067739,right,T5c,310,2,22,9,13
720575940627538600,right,T5c,311,-7,15,14,1
720575940633558047,right,T5c,312,4,-7,-8,1
720575940633672162,right,T5c,313,7,3,-6,9
720575940628558671,right,T5c,315,-3,-6,0,-6
720575940624273226,right,T5c,316,5,-4,-7,3
720575940631994193,right,T5c,317,-5,-4,3,-7
720575940621732336,right,T5c,318,4,-19,-14,-5
720575940639095374,right,T5c,319,-2,5,4,1
720575940604511776,right,T5c,320,-2,-5,-1,-4
720575940634123219,right,T5c,322,2,26,11,15
720575940613862802,right,T5c,323,-7,-13,0,-13
720575940631116847,right,T5c,324,3,24,9,15
720575940631048279,right,T5c,325,5,1,-5,6
720575940608350731,right,T5c,326,2,16,6,10
720575940621817584,right,T5c,327,5,3,-4,7
720575940626586626,right,T5c,328,5,-9,-10,1
720575940619398981,right,T5c,329,0,24,12,12
720575940629280586,right,T5c,330,3,3,-2,5
720575940622380554,right,T5c,331,1,-15,-9,-6
720575940631558995,right,T5c,332,4,-26,-17,-9
720575940639476864,right,T5c,333,0,-21,-11,-10
720575940612986482,right,T5c,334,1,-26,-14,-12
720575940631696441,right,T5c,335,2,8,2,6
720575940625655271,right,T5c,336,0,23,11,12
720575940619358155,right,T5c,337,-5,-6,2,-8
720575940638496189,right,T5c,338,-1,0,1,-1
720575940605566310,right,T5c,339,6,11,-1,12
720575940618375232,right,T5c,340,-4,17,12,5
720575940621194561,right,T5c,342,2,-15,-10,-5
720575940627576381,right,T5c,343,-3,27,16,11
720575940623121098,right,T5c,344,-2,-15,-6,-9
720575940627823753,right,T5c,345,3,-12,-9,-3
720575940619925012,right,T5c,346,-7,-9,2,-11
720575940629126503,right,T5c,347,-5,-13,-2,-11
720575940620778662,right,T5c,348,3,14,4,10
720575940624740347,right,T5c,349,-5,-14,-2,-12
720575940627589288,right,T5c,350,1,15,6,9
720575940621798945,right,T5c,351,-1,-17,-8,-9
720575940631034455,right,T5c,352,-2,28,16,12
720575940644666056,right,T5c,354,-2,-26,-11,-15
720575940621397697,right,T5c,355,-7,-6,4,-10
720575940629047882,right,T5c,356,0,22,11,11
720575940620990561,right,T5c,357,4,17,4,13
720575940619874694,right,T5c,358,-3,17,11,6
720575940617815481,right,T5c,359,2,23,9,14
720575940613145059,right,T5c,360,-5,19,14,5
720575940640350835,right,T5c,361,0,-7,-4,-3
720575940627173263,right,T5c,362,2,-20,-12,-8
720575940622251945,right,T5c,363,7,-4,-9,5
720575940617145361,right,T5c,364,4,4,-2,6
720575940629623004,right,T5c,365,4,7,-1,8
720575940615816863,right,T5c,367,-6,-15,-2,-13
720575940634877547,right,T5c,368,-4,-20,-6,-14
720575940635178091,right,T5c,369,5,-5,-8,3
720575940630533176,right,T5c,370,-3,21,13,8
720575940624438542,right,T5c,371,6,-5,-9,4
720575940624270845,right,T5c,372,1,-2,-2,0
720575940612376983,right,T5c,373,1,-21,-12,-9
720575940629525804,right,T5c,374,2,13,4,9
720575940620662622,right,T5c,375,-6,7,9,-2
720575940618107220,right,T5c,376,-7,-10,2,-12
720575940608763147,right,T5c,377,0,7,3,4
720575940639528765,right,T5c,378,-3,18,12,6
720575940646995508,right,T5c,379,3,-17,-12,-5
720575940620608895,right,T5c,380,-1,29,15,14
720575940621405534,right,T5c,382,3,-6,-6,0
720575940646245923,right,T5c,383,-6,11,11,0
720575940625571868,right,T5c,385,-3,-18,-6,-12
720575940637835610,right,T5c,386,-6,19,15,4
720575940629639223,right,T5c,387,-1,-15,-7,-8
720575940620628818,right,T5c,388,3,19,6,13
720575940611130744,right,T5c,389,-6,-16,-2,-14
720575940622119382,right,T5c,390,-6,-9,1,-10
720575940629820790,right,T5c,391,4,-3,-6,3
720575940611785841,right,T5c,392,-4,7,7,0
720575940628827179,right,T5c,393,-1,22,12,10
720575940636803418,right,T5c,394,-7,-8,3,-11
720575940629419386,right,T5c,395,0,-22,-11,-11
720575940610406702,right,T5c,396,-1,10,6,4
720575940602497726,right,T5c,397,-3,-19,-7,-12
720575940637850970,right,T5c,398,-3,22,14,8
720575940629367043,right,T5c,400,1,-29,-16,-13
720575940613928676,right,T5c,401,-2,-19,-8,-11
720575940620928097,right,T5c,402,3,26,10,16
720575940634414999,right,T5c,403,-2,-12,-4,-8
720575940634437089,right,T5c,404,-1,20,11,9
720575940631335978,right,T5c,405,3,10,2,8
720575940631779395,right,T5c,406,1,-25,-14,-11
720575940627461905,right,T5c,407,-5,-10,0,-10
720575940611748314,right,T5c,408,-6,-4,4,-8
720575940622711081,right,T5c,409,0,-3,-2,-1
720575940610076792,right,T5c,410,-2,-2,1,-3
720575940612561125,right,T5c,411,-5,-19,-5,-14
720575940623132713,right,T5c,412,-6,21,16,5
720575940624497644,right,T5c,413,-2,-7,-2,-5
720575940621635333,right,T5c,414,4,21,6,15
720575940608972995,right,T5c,415,6,12,0,12
720575940609360323,right,T5c,416,3,-8,-7,-1
720575940625417037,right,T5c,417,-6,-10,1,-11
720575940634195934,right,T5c,418,-2,15,9,6
720575940622780296,right,T5c,419,-3,-11,-3,-8
720575940605676041,right,T5c,420,6,-3,-8,5
720575940622729752,right,T5c,421,-1,12,7,5
720575940652010998,right,T5c,422,-7,-4,5,-9
720575940638050788,right,T5c,423,3,-18,-12,-6
720575940628787867,right,T5c,424,-3,-2,2,-4
720575940623568428,right,T5c,425,3,20,7,13
720575940637784383,right,T5c,426,-3,0,3,-3
720575940639229757,right,T5c,427,5,-18,-14,-4
720575940623499308,right,T5c,428,-2,23,13,10
720575940643701960,right,T5c,429,-2,14,9,5
720575940612496918,right,T5c,430,-3,-7,-1,-6
720575940610680433,right,T5c,431,-2,-10,-3,-7
720575940616924741,right,T5c,432,-5,7,8,-1
720575940635675767,right,T5c,433,0,-8,-4,-4
720575940627953158,right,T5c,434,-3,7,6,1
720575940618064965,right,T5c,435,5,-17,-14,-3
720575940627821255,right,T5c,436,0,-15,-8,-7
720575940623771319,right,T5c,437,-3,12,9,3
720575940638019162,right,T5c,438,2,27,11,16
720575940649349497,right,T5c,439,-3,-9,-2,-7
720575940612532629,right,T5c,440,1,23,10,13
720575940636240997,right,T5c,441,3,-16,-11,-5
720575940622786985,right,T5c,442,-5,25,17,8
720575940612173541,right,T5c,443,-6,4,8,-4
720575940641485709,right,T5c,444,4,-10,-9,-1
720575940636882032,right,T5c,445,-2,8,6,2
720575940637644122,right,T5c,446,2,-14,-9,-5
720575940622680968,right,T5c,447,-1,2,2,0
720575940640864464,right,T5c,449,6,-16,-14,-2
720575940624599539,right,T5c,450,2,-9,-7,-2
720575940611378552,right,T5c,451,4,20,6,14
720575940621944712,right,T5c,452,1,-9,-6,-3
720575940619817293,right,T5c,453,3,25,9,16
720575940617234132,right,T5c,454,5,-12,-11,-1
720575940627820443,right,T5c,455,7,-7,-11,4
720575940619460811,right,T5c,456,0,21,10,11
720575940632153415,right,T5c,457,-2,17,10,7
720575940630142521,right,T5c,458,5,0,-5,5
720575940620090544,right,T5c,459,5,-3,-7,4
720575940619919696,right,T5c,460,-3,-20,-7,-13
720575940617069115,right,T5c,462,-1,18,10,8
720575940647111300,right,T5c,463,5,17,3,14
720575940630249846,right,T5c,464,4,0,-4,4
720575940628013809,right,T5c,465,3,0,-3,3
720575940627977415,right,T5c,466,1,14,6,8
720575940621870881,right,T5c,467,-2,-20,-8,-12
720575940625832804,right,T5c,468,-3,11,8,3
720575940621780250,right,T5c,469,-7,13,13,0
720575940649629049,right,T5c,470,4,-9,-9,0
720575940628241226,right,T5c,471,3,-26,-16,-10
720575940621439615,right,T5c,473,-4,23,15,8
720575940632361953,right,T5c,474,-3,-17,-6,-11
720575940621965388,right,T5c,475,-4,-1,3,-4
720575940627455560,right,T5c,476,-1,15,8,7
720575940625737162,right,T5c,477,-3,2,4,-2
720575940611693205,right,T5c,478,-7,16,15,1
720575940627115858,right,T5c,479,-2,10,7,3
720575940624817191,right,T5c,480,3,-19,-13,-6
720575940615788742,right,T5c,481,4,-8,-8,0
720575940609295299,right,T5c,482,1,17,7,10
720575940628029202,right,T5c,483,2,-7,-6,-1
720575940632540620,right,T5c,484,3,-9,-8,-1
720575940619213361,right,T5c,485,-3,-3,1,-4
720575940624012552,right,T5c,486,0,1,0,1
720575940617261346,right,T5c,487,1,-1,-2,1
720575940641575988,right,T5c,488,7,5,-5,10
720575940624014060,right,T5c,489,-3,10,8,2
720575940620766374,right,T5c,490,-5,6,8,-2
720575940637810997,right,T5c,491,7,-1,-8,7
720575940606938546,right,T5c,492,-7,-2,6,-8
720575940620168395,right,T5c,493,-3,23,14,9
720575940640002749,right,T5c,494,0,29,14,15
720575940638310259,right,T5c,495,4,5,-2,7
720575940621083995,right,T5c,496,7,8,-3,11
720575940624796908,right,T5c,497,6,1,-6,7
720575940615175903,right,T5c,498,6,10,-1,11
720575940617147409,right,T5c,499,5,10,0,10
720575940628063019,right,T5c,500,7,-8,-11,3
720575940625774948,right,T5c,501,1,2,0,2
720575940640245888,right,T5c,502,5,8,-1,9
720575940622077052,right,T5c,503,3,17,5,12
720575940630645729,right,T5c,504,-2,9,6,3
720575940622361098,right,T5c,506,1,-12,-7,-5
720575940624738043,right,T5c,507,-5,-12,-1,-11
720575940627778300,right,T5c,508,-5,11,10,1
720575940632206244,right,T5c,509,-4,10,9,1
720575940607627868,right,T5c,510,-2,11,7,4
720575940629821696,right,T5c,511,5,-11,-11,0
720575940649760889,right,T5c,512,6,0,-6,6
720575940622875402,right,T5c,513,-4,-13,-3,-10
720575940624148883,right,T5c,514,-4,-10,-1,-9
720575940616844475,right,T5c,515,-8,-7,4,-11
720575940630957007,right,T5c,517,6,3,-5,8
720575940632033996,right,T5c,518,-4,22,15,7
720575940631927855,right,T5c,519,-5,-5,2,-7
720575940627330319,right,T5c,521,6,-9,-11,2
720575940604324320,right,T5c,522,-4,0,4,-4
720575940621752397,right,T5c,523,2,14,5,9
720575940628781315,right,T5c,524,4,-20,-14,-6
720575940627685419,right,T5c,525,-1,-20,-9,-11
720575940616136565,right,T5c,526,0,-10,-5,-5
720575940605550112,right,T5c,527,-4,-8,0,-8
720575940623053764,right,T5c,528,2,7,1,6
720575940624209994,right,T5c,529,2,-2,-3,1
720575940617720916,right,T5c,530,-3,-13,-4,-9
720575940627681103,right,T5c,531,1,0,-1,1
720575940621942908,right,T5c,532,-8,7,11,-4
720575940629771308,right,T5c,533,0,-16,-8,-8
720575940643616200,right,T5c,534,3,2,-2,4
720575940628997812,right,T5c,535,8,-4,-10,6
720575940622059525,right,T5c,536,3,4,-1,5
720575940627122718,right,T5c,537,0,-23,-12,-11
720575940608404747,right,T5c,538,-4,1,4,-3
720575940632397454,right,T5c,539,-6,15,13,2
720575940624443367,right,T5c,540,-2,-9,-3,-6
720575940607762354,right,T5c,541,-4,14,11,3
720575940627255818,right,T5c,542,6,-13,-13,0
720575940629472382,right,T5c,543,-1,-4,-1,-3
720575940614952635,right,T5c,544,3,-13,-10,-3
720575940626857704,right,T5c,545,5,11,0,11
720575940631414120,right,T5c,546,3,6,0,6
720575940638886372,right,T5c,547,-1,21,11,10
720575940604412896,right,T5c,548,1,-16,-9,-7
720575940612061170,right,T5c,549,0,-9,-5,-4
720575940619741131,right,T5c,550,-2,3,3,0
720575940614447506,right,T5c,551,-4,-9,-1,-8
720575940624268692,right,T5c,552,4,-1,-5,4
720575940634004124,right,T5c,553,-3,16,11,5
720575940617964379,right,T5c,555,-4,9,8,1
720575940640136400,right,T5c,556,0,10,5,5
720575940613465750,right,T5c,557,6,-10,-11,1
720575940629947383,right,T5c,558,-4,-21,-7,-14
720575940619749979,right,T5c,559,-6,22,17,5
720575940625629198,right,T5c,560,-7,14,14,0
720575940627797992,right,T5c,561,5,7,-2,9
720575940604323808,right,T5c,562,-5,-2,4,-6
720575940607827657,right,T5c,563,5,-13,-12,-1
720575940612451223,right,T5c,564,3,-23,-15,-8
720575940637962047,right,T5c,565,0,-26,-13,-13
720575940626049881,right,T5c,566,5,-8,-9,1
720575940647416708,right,T5c,567,-2,22,13,9
720575940618052426,right,T5c,568,-6,-8,2,-10
720575940638634310,right,T5c,569,6,6,-3,9
720575940619680085,right,T5c,570,2,25,10,15
720575940609344866,right,T5c,571,0,-14,-7,-7
720575940625998594,right,T5c,572,-8,3,9,-6
720575940621066177,right,T5c,573,4,14,3,11
720575940634949995,right,T5c,574,-6,5,8,-3
720575940622564109,right,T5c,575,6,9,-2,11
720575940625825424,right,T5c,576,0,28,14,14
720575940627705621,right,T5c,577,5,-14,-12,-2
720575940618176027,right,T5c,578,4,-11,-10,-1
720575940635701103,right,T5c,579,-3,-10,-2,-8
720575940630876111,right,T5c,580,-2,-23,-10,-13
720575940629546959,right,T5c,581,3,9,1,8
720575940644937160,right,T5c,582,-1,23,12,11
720575940617588198,right,T5c,583,3,-25,-16,-9
720575940636594021,right,T5c,584,4,23,7,16
720575940627817948,right,T5c,585,-1,-23,-11,-12
720575940630324035,right,T5c,586,2,18,7,11
720575940611140325,right,T5c,587,4,22,7,15
720575940631068227,right,T5c,588,1,4,1,3
720575940622985254,right,T5c,590,1,9,3,6
720575940631330484,right,T5c,591,3,-3,-5,2
720575940629426046,right,T5c,593,3,-14,-10,-4
720575940623930375,right,T5c,594,7,-16,-15,-1
720575940625751677,right,T5c,595,7,-12,-13,1
720575940635920820,right,T5c,596,-4,-16,-4,-12
720575940620792486,right,T5c,597,4,1,-4,5
720575940631633489,right,T5c,598,2,-18,-11,-7
720575940631912495,right,T5c,599,-1,9,5,4
720575940624252168,right,T5c,600,3,-10,-8,-2
720575940633791513,right,T5c,601,1,16,7,9
720575940620076368,right,T5c,602,4,-2,-5,3
720575940636372599,right,T5c,603,-3,-23,-9,-14
720575940613523478,right,T5c,604,-6,-17,-3,-14
720575940620435627,right,T5c,605,3,15,4,11
720575940626362755,right,T5c,606,-1,-19,-9,-10
720575940615697932,right,T5c,607,1,18,8,10
720575940628564739,right,T5c,608,1,10,4,6
720575940631092291,right,T5c,609,-2,0,2,-2
720575940637773631,right,T5c,610,2,-23,-14,-9
720575940614036452,right,T5c,611,-1,-18,-8,-10
720575940621681020,right,T5c,614,-2,-8,-2,-6
720575940629704058,right,T5c,615,-7,-7,3,-10
720575940629151488,right,T5c,616,-3,15,10,5
720575940614219926,right,T5c,617,-2,-17,-7,-10
720575940615982047,right,T5c,618,-1,24,13,11
720575940611523426,right,T5c,619,-4,-19,-6,-13
720575940612687382,right,T5c,620,7,1,-7,8
720575940632384810,right,T5c,621,1,24,11,13
720575940614271919,right,T5c,622,-5,20,15,5
720575940620653665,right,T5c,623,1,13,5,8
720575940620238063,right,T5c,624,1,-17,-10,-7
720575940618616733,right,T5c,625,-2,24,14,10
720575940617622100,right,T5c,626,-5,-8,1,-9
720575940631570733,right,T5c,627,0,-1,-1,0
720575940637062878,right,T5c,628,0,0,0,0
720575940619828813,right,T5c,629,4,24,8,16
720575940607042994,right,T5c,630,4,8,0,8
720575940619868027,right,T5c,631,1,26,12,14
720575940631219364,right,T5c,632,3,-20,-13,-7
720575940623002893,right,T5c,633,-1,-24,-11,-13
720575940629340012,right,T5c,634,-3,-15,-5,-10
720575940633024869,right,T5c,635,6,-6,-9,3
720575940627014474,right,T5c,636,0,6,3,3
720575940612428951,right,T5c,637,3,-21,-14,-7
720575940627810759,right,T5c,638,-1,7,4,3
720575940621975329,right,T5c,639,-4,19,13,6
720575940638016831,right,T5c,640,-1,-16,-7,-9
720575940620040528,right,T5c,641,-8,-5,5,-10
720575940659856001,right,T5c,642,-5,-11,-1,-10
720575940631464811,right,T5c,643,6,14,1,13
720575940630026039,right,T5c,644,-6,18,15,3
720575940616272962,right,T5c,645,-4,27,17,10
720575940630617285,right,T5c,647,-4,-7,0,-7
720575940632807085,right,T5c,648,1,7,2,5
720575940605335910,right,T5c,649,-1,5,3,2
720575940623635431,right,T5c,650,-3,-25,-10,-15
720575940620866992,right,T5c,651,-4,-5,1,-6
720575940624611835,right,T5c,652,-6,-11,0,-11
720575940637003365,right,T5c,653,-6,-12,0,-12
720575940634664895,right,T5c,654,-3,8,7,1
720575940639604789,right,T5c,655,6,-1,-7,6
720575940621631690,right,T5c,656,0,-11,-6,-5
720575940626642584,right,T5c,657,-2,-25,-11,-14
720575940619806305,right,T5c,658,1,20,9,11
720575940617732948,right,T5c,659,-4,-6,1,-7
720575940607786251,right,T5c,661,-3,14,10,4
720575940612775958,right,T5c,662,2,-1,-3,2
720575940619598502,right,T5c,663,0,8,4,4
720575940628889935,right,T5c,664,1,-27,-15,-12
720575940630894799,right,T5c,665,7,-2,-8,6
720575940613100566,right,T5c,667,1,-28,-15,-13
720575940627170250,right,T5c,668,1,19,8,11
720575940643466912,right,T5c,669,4,-16,-12,-4
720575940630320087,right,T5c,670,5,5,-3,8
720575940621549377,right,T5c,671,-4,-23,-8,-15
720575940633483746,right,T5c,672,-8,11,13,-2
720575940611461082,right,T5c,673,2,5,0,5
720575940605397536,right,T5c,674,-4,-14,-3,-11
720575940618177349,right,T5c,675,-7,19,16,3
720575940622490444,right,T5c,676,-3,-21,-8,-13
720575940623190506,right,T5c,677,0,11,5,6
720575940621898264,right,T5c,678,3,-7,-7,0
720575940612466329,right,T5c,679,4,18,5,13
720575940621915558,right,T5c,680,-1,25,13,12
720575940638388314,right,T5c,681,-2,-21,-9,-12
720575940630669672,right,T5c,682,6,-8,-10,2
720575940624057608,right,T5c,683,2,6,1,5
720575940626783740,right,T5c,684,-6,17,14,3
720575940606466761,right,T5c,685,-5,-9,0,-9
720575940622521930,right,T5c,687,-6,-3,4,-7
720575940605426278,right,T5c,688,-7,10,12,-2
720575940614831144,right,T5c,689,-2,18,11,7
720575940622955561,right,T5c,690,-7,-3,5,-8
720575940612962611,right,T5c,691,-9,4,11,-7
720575940645877358,right,T5c,692,-4,24,16,8
720575940617368123,right,T5c,693,-3,25,15,10
720575940640500276,right,T5c,694,4,3,-3,6
720575940637714239,right,T5c,695,-6,10,11,-1
720575940611558037,right,T5c,696,-2,16,10,6
720575940616905145,right,T5c,697,1,-22,-12,-10
720575940612621999,right,T5c,698,6,-7,-10,3
720575940607033010,right,T5c,699,-5,0,5,-5
720575940619473089,right,T5c,700,5,15,2,13
720575940626737722,right,T5c,701,0,-4,-2,-2
720575940610363972,right,T5c,702,-5,23,16,7
720575940622412253,right,T5c,703,-3,1,3,-2
720575940623873609,right,T5c,704,-7,8,11,-3
720575940624010493,right,T5c,705,1,1,-1,2
720575940629977959,right,T5c,706,-7,-12,1,-13
720575940630518071,right,T5c,707,-2,25,14,11
720575940626360869,right,T5c,709,-2,-24,-10,-14
720575940633894507,right,T5c,710,4,-25,-17,-8
720575940626373016,right,T5c,711,-1,19,10,9
720575940628761423,right,T5c,712,-7,12,13,-1
720575940636975216,right,T5c,713,-6,16,14,2
720575940626423493,right,T5c,714,5,12,1,11
720575940617712214,right,T5c,715,4,10,1,9
720575940619528784,right,T5c,716,4,-6,-7,1
720575940631260175,right,T5c,717,2,-22,-13,-9
720575940613675542,right,T5c,719,1,27,12,15
720575940640116312,right,T5c,720,-5,21,15,6
720575940624443832,right,T5c,721,5,13,1,12
720575940617917926,right,T5c,722,6,-15,-14,-1
720575940638856757,right,T5c,723,-2,-11,-4,-7
720575940624623288,right,T5c,724,4,2,-3,5
720575940629807354,right,T5c,725,-3,-24,-9,-15
720575940620597524,right,T5c,726,2,-28,-16,-12
720575940630364012,right,T5c,727,7,6,-4,10
720575940629815490,right,T5c,728,7,12,-1,13
720575940627231262,right,T5c,729,-3,29,17,12
720575940631991476,right,T5c,730,7,0,-7,7
720575940628351546,right,T5c,731,-6,9,10,-1
720575940626501676,right,T5c,732,-3,6,6,0
720575940639509667,right,T5c,733,-5,-17,-4,-13
720575940631738415,right,T5c,734,2,0,-2,2
720575940634452080,right,T5c,735,1,-23,-13,-10
720575940627682556,right,T5c,736,-8,1,8,-7
720575940606920578,right,T5c,737,0,19,9,10
720575940635244133,right,T5c,738,-3,13,9,4
720575940638647785,right,T5c,739,-7,2,8,-6
720575940619816071,right,T5c,740,2,-8,-6,-2
720575940623041609,right,T5c,741,-2,-14,-5,-9
720575940647171204,right,T5c,742,-4,11,9,2
720575940621383617,right,T5c,744,-4,25,16,9
720575940628593664,right,T5c,745,0,13,6,7
720575940617576226,right,T5c,746,-3,3,4,-1
720575940621050608,right,T5c,747,0,2,1,1
720575940611375314,right,T5c,748,-4,20,14,6
720575940627418133,right,T5c,749,-2,1,2,-1
720575940631563091,right,T5c,750,4,-24,-16,-8
720575940633553886,right,T5c,751,1,6,2,4
720575940605725105,right,T5c,752,-2,7,5,2
720575940630141050,right,T5c,753,-3,24,15,9
720575940620198127,right,T5c,754,-1,-13,-6,-7
720575940639140413,right,T5c,755,4,19,5,14
720575940639448784,right,T5c,756,5,20,5,15
720575940637527693,right,T5c,757,0,-6,-3,-3
720575940633859482,right,T5c,758,5,-1,-6,5
720575940627437765,right,T5c,759,7,14,0,14
720575940637005801,right,T5c,760,0,17,8,9
720575940646051460,right,T5c,761,-4,-18,-5,-13
720575940623495411,right,T5c,762,0,14,7,7
720575940608343305,right,T5c,763,-5,14,12,2
720575940613254166,right,T5c,764,-8,-6,5,-11
720575940626924681,right,T5c,765,-3,9,7,2
720575940638428998,right,T5c,766,2,-4,-4,0
720575940623927303,right,T5c,768,3,5,-1,6
720575940631697000,right,T5c,770,5,4,-3,7
720575940623032652,right,T5c,771,3,-27,-17,-10
720575940618941261,right,T5c,772,1,12,5,7
720575940607259228,right,T5c,773,5,-19,-15,-4
720575940624693996,right,T5c,775,5,22,6,16
720575940638050020,right,T5c,778,4,25,8,17
720575940616732722,right,T5c,780,-6,25,18,7
720575940620333784,right,T5c,784,-4,29,18,11
720575940612944435,right,T5c,786,-2,30,17,13
720575940614510899,right,T5c,790,-2,-27,-12,-15
720575940641579316,right,T5c,792,8,2,-7,9
720575940628573545,right,T5c,793,8,-6,-11,5
720575940612207253,right,T5c,795,6,-21,-17,-4
720575940632062372,right,T5d,2,-8,2,9,-7
720575940626345490,right,T5d,3,6,-12,-12,0
720575940623967466,right,T5d,4,-5,-21,-6,-15
720575940608020931,right,T5d,5,-1,16,9,7
720575940627424424,right,T5d,6,-2,-4,0,-4
720575940634603711,right,T5d,7,-6,-6,3,-9
720575940612407409,right,T5d,8,-4,26,17,9
720575940620278875,right,T5d,9,4,9,0,9
720575940631748152,right,T5d,10,5,-15,-13,-2
720575940621519180,right,T5d,12,-7,9,11,-2
720575940610989944,right,T5d,15,2,-3,-4,1
720575940607288843,right,T5d,16,-2,-16,-6,-10
720575940621702405,right,T5d,17,1,-5,-4,-1
720575940619600213,right,T5d,18,5,-16,-13,-3
720575940621193910,right,T5d,19,-7,17,15,2
720575940618614942,right,T5d,20,3,-11,-9,-2
720575940626309164,right,T5d,21,-2,19,11,8
720575940635736687,right,T5d,22,-1,3,2,1
720575940623784955,right,T5d,23,-3,-16,-5,-11
720575940617303014,right,T5d,24,-1,-10,-4,-6
720575940622135208,right,T5d,26,1,-3,-3,0
720575940621938437,right,T5d,27,0,-25,-13,-12
720575940619513905,right,T5d,28,5,6,-2,8
720575940629466679,right,T5d,29,-1,-3,-1,-2
720575940623337471,right,T5d,30,6,16,2,14
720575940621792350,right,T5d,31,0,16,8,8
720575940626727592,right,T5d,32,0,12,6,6
720575940641276891,right,T5d,33,3,18,6,12
720575940630351068,right,T5d,35,1,-24,-13,-11
720575940638251590,right,T5d,36,6,8,-2,10
720575940633562078,right,T5d,37,1,5,1,4
720575940623072809,right,T5d,38,0,-2,-1,-1
720575940628604688,right,T5d,39,0,20,10,10
720575940626922754,right,T5d,40,-2,-6,-1,-5
720575940626303418,right,T5d,41,-3,28,17,11
720575940638994485,right,T5d,42,-1,14,8,6
720575940627537064,right,T5d,43,-5,18,14,4
720575940632111311,right,T5d,44,5,-10,-10,0
720575940630470999,right,T5d,45,-5,-1,4,-5
720575940613877555,right,T5d,46,-5,15,12,3
720575940630114938,right,T5d,48,-4,-22,-7,-15
720575940642057357,right,T5d,49,4,-4,-6,2
720575940629048394,right,T5d,50,-2,21,12,9
720575940636622734,right,T5d,51,0,-19,-10,-9
720575940627862415,right,T5d,52,-1,-22,-10,-12
720575940654958753,right,T5d,53,5,14,2,12
720575940612603926,right,T5d,54,-4,3,5,-2
720575940621940682,right,T5d,55,-4,-11,-2,-9
720575940619244337,right,T5d,56,1,-13,-8,-5
720575940634065433,right,T5d,57,6,-11,-12,1
720575940614275070,right,T5d,58,3,12,3,9
720575940641271348,right,T5d,59,-2,2,3,-1
720575940628006897,right,T5d,61,-4,-4,2,-6
720575940626425541,right,T5d,63,4,12,2,10
720575940630812022,right,T5d,64,4,-23,-16,-7
720575940616234252,right,T5d,65,-1,28,15,13
720575940626603151,right,T5d,66,2,15,5,10
720575940620127041,right,T5d,67,-2,-13,-5,-8
720575940621852307,right,T5d,68,3,16,5,11
720575940621760609,right,T5d,69,1,8,3,5
720575940618377024,right,T5d,70,-4,21,14,7
720575940609943928,right,T5d,71,-2,-3,0,-3
720575940615711650,right,T5d,73,2,2,-1,3
720575940617519773,right,T5d,74,-1,-9,-4,-5
720575940636078199,right,T5d,75,-6,14,13,1
720575940635183028,right,T5d,76,-3,-4,1,-5
720575940624489708,right,T5d,77,2,-5,-5,0
720575940620400774,right,T5d,78,2,20,8,12
720575940615297548,right,T5d,79,2,1,-2,3
720575940617132262,right,T5d,80,4,13,2,11
720575940627470867,right,T5d,81,6,-2,-7,5
720575940617409349,right,T5d,82,-7,7,10,-3
720575940613617021,right,T5d,83,2,-21,-13,-8
720575940619438539,right,T5d,84,-2,12,8,4
720575940614292478,right,T5d,87,1,11,4,7
720575940634743403,right,T5d,88,7,4,-5,9
720575940632112211,right,T5d,89,1,-19,-11,-8
720575940630140491,right,T5d,90,-4,5,6,-1
720575940632536718,right,T5d,91,-1,6,4,2
720575940630401910,right,T5d,92,0,9,4,5
720575940615678150,right,T5d,93,-6,3,7,-4
720575940639175989,right,T5d,94,5,18,4,14
720575940616904029,right,T5d,95,4,-21,-15,-6
720575940612039922,right,T5d,96,1,-10,-6,-4
720575940624131848,right,T5d,97,-5,2,6,-4
720575940622942730,right,T5d,98,-1,-12,-5,-7
720575940624426900,right,T5d,99,4,15,3,12
720575940621730842,right,T5d,100,2,-10,-7,-3
720575940620606317,right,T5d,101,-7,6,10,-4
720575940608442379,right,T5d,102,3,13,3,10
720575940628599237,right,T5d,103,7,9,-3,12
720575940646778147,right,T5d,104,-1,-27,-13,-14
720575940622166908,right,T5d,105,3,22,8,14
720575940639578275,right,T5d,106,-7,11,12,-1
720575940628742148,right,T5d,107,8,-2,-9,7
720575940624074829,right,T5d,108,-3,-12,-3,-9
720575940645459054,right,T5d,109,4,-5,-7,2
720575940621637146,right,T5d,110,-7,0,7,-7
720575940627369237,right,T5d,111,2,-24,-14,-10
720575940647031940,right,T5d,112,-6,1,6,-5
720575940621691486,right,T5d,113,-2,4,4,0
720575940615169090,right,T5d,114,2,-13,-9,-4
720575940616249461,right,T5d,115,-4,2,5,-3
720575940619936020,right,T5d,116,-1,-8,-3,-5
720575940622324604,right,T5d,117,-8,-2,7,-9
720575940632237534,right,T5d,118,3,1,-3,4
720575940620778561,right,T5d,119,-2,6,5,1
720575940624431335,right,T5d,120,-1,-1,0,-1
720575940639443288,right,T5d,121,-8,4,10,-6
720575940623935229,right,T5d,122,-5,9,9,0
720575940634219616,right,T5d,124,1,-7,-5,-2
720575940616641931,right,T5d,125,5,9,-1,10
720575940616410129,right,T5d,126,3,11,2,9
720575940621426559,right,T5d,127,0,15,7,8
720575940612907672,right,T5d,128,3,-22,-14,-8
720575940612758243,right,T5d,129,0,-13,-7,-6
720575940620778406,right,T5d,130,2,12,4,8
720575940625393456,right,T5d,131,-6,20,16,4
720575940620273499,right,T5d,132,2,4,0,4
720575940620301483,right,T5d,133,-3,20,13,7
720575940631649554,right,T5d,135,-3,-22,-8,-14
720575940630541519,right,T5d,136,0,3,1,2
720575940634874815,right,T5d,137,5,-7,-9,2
720575940625549716,right,T5d,138,0,27,13,14
720575940622282506,right,T5d,139,1,-14,-8,-6
720575940622852605,right,T5d,140,3,8,1,7
720575940617076107,right,T5d,142,-2,-18,-7,-11
720575940639595939,right,T5d,143,-4,16,12,4
720575940613776680,right,T5d,144,7,-11,-13,2
720575940633345561,right,T5d,145,0,4,2,2
720575940613975970,right,T5d,146,1,-6,-4,-2
720575940645422884,right,T5d,147,1,21,9,12
720575940620937051,right,T5d,148,-7,-11,1,-12
720575940630210103,right,T5d,149,6,-14,-13,-1
720575940635254520,right,T5d,150,-8,5,10,-5
720575940621840252,right,T5d,151,-3,-14,-4,-10
720575940631536455,right,T5d,152,3,-15,-11,-4
720575940610397486,right,T5d,156,-9,1,9,-8
720575940637521037,right,T5d,157,-1,-7,-3,-4
720575940620703983,right,T5d,158,3,-5,-6,1
720575940644889367,right,T5d,159,7,7,-4,11
720575940611900387,right,T5d,160,-2,20,12,8
720575940639817856,right,T5d,161,4,-14,-11,-3
720575940613612207,right,T5d,162,-4,-2,3,-5
720575940627453692,right,T5d,164,-1,-2,0,-2
720575940631440235,right,T5d,165,4,16,4,12
720575940647514676,right,T5d,166,0,18,9,9
720575940618776354,right,T5d,167,0,-17,-9,-8
720575940632435999,right,T5d,168,-1,17,9,8
720575940621132246,right,T5d,169,0,-18,-9,-9
720575940643508384,right,T5d,170,-5,1,5,-4
720575940628515332,right,T5d,172,1,22,10,12
720575940621571312,right,T5d,173,2,-25,-15,-10
720575940629720311,right,T5d,174,4,-15,-12,-3
720575940625799426,right,T5d,175,-6,-7,2,-9
720575940620357615,right,T5d,176,-2,13,8,5
720575940613295400,right,T5d,177,-2,-1,1,-2
720575940629525548,right,T5d,178,2,11,3,8
720575940633787327,right,T5d,179,-5,-16,-3,-13
720575940626269028,right,T5d,180,2,-27,-16,-11
720575940630905228,right,T5d,181,1,-4,-3,-1
720575940632259665,right,T5d,182,7,-10,-12,2
720575940626510812,right,T5d,183,-5,-15,-3,-12
720575940630943668,right,T5d,184,-6,-5,3,-8
720575940639768192,right,T5d,185,2,-11,-8,-3
720575940615838770,right,T5d,188,-5,17,13,4
720575940643758752,right,T5d,189,6,13,0,13
720575940641373147,right,T5d,190,-3,-5,0,-5
720575940622947110,right,T5d,191,-1,-11,-5,-6
720575940605758752,right,T5d,192,7,10,-2,12
720575940632070820,right,T5d,193,-5,4,7,-3
720575940622966506,right,T5d,194,0,-5,-3,-2
720575940638223686,right,T5d,195,-3,-1,2,-3
720575940627471356,right,T5d,196,-1,8,5,3
720575940621950896,right,T5d,198,6,2,-5,7
720575940630755269,right,T5d,199,0,-12,-6,-6
720575940621949052,right,T5d,200,-5,12,11,1
720575940611696248,right,T5d,202,-1,27,14,13
720575940613601426,right,T5d,203,3,-1,-4,3
720575940632931764,right,T5d,204,5,-2,-6,4
720575940633803877,right,T5d,205,5,-6,-8,2
720575940625942078,right,T5d,206,-3,5,5,0
720575940626221100,right,T5d,207,1,29,13,16
720575940626982858,right,T5d,208,5,-21,-16,-5
720575940611895987,right,T5d,209,-3,-8,-1,-7
720575940623043327,right,T5d,210,-6,8,10,-2
720575940619663701,right,T5d,211,-7,-1,6,-7
720575940634676122,right,T5d,212,2,-16,-10,-6
720575940621248500,right,T5d,213,3,-4,-5,1
720575940627158289,right,T5d,214,-5,3,6,-3
720575940621306032,right,T5d,215,6,7,-3,10
720575940624500151,right,T5d,216,2,19,7,12
720575940618931277,right,T5d,218,2,10,3,7
720575940623842236,right,T5d,219,6,-4,-8,4
720575940612695830,right,T5d,220,2,-6,-5,-1
720575940627997425,right,T5d,221,-7,3,8,-5
720575940628299581,right,T5d,222,-3,26,16,10
720575940620443725,right,T5d,223,-2,26,15,11
720575940616666146,right,T5d,224,0,5,2,3
720575940621627233,right,T5d,226,5,19,4,15
720575940627916487,right,T5d,227,-7,5,9,-4
720575940620117163,right,T5d,228,-7,1,7,-6
720575940617009735,right,T5d,229,5,2,-4,6
720575940640065744,right,T5d,230,2,9,2,7
720575940620295105,right,T5d,231,4,-12,-10,-2
720575940625048653,right,T5d,232,-4,13,10,3
720575940619202324,right,T5d,233,4,-13,-11,-2
720575940621183073,right,T5d,234,1,3,0,3
720575940616494865,right,T5d,235,4,11,1,10
720575940624245543,right,T5d,236,-1,4,3,1
720575940616918028,right,T5d,237,-2,27,15,12
720575940616479547,right,T5d,239,-6,6,9,-3
720575940633588761,right,T5d,240,-4,-3,2,-5
720575940619793031,right,T5d,241,2,-17,-11,-6
720575940630359545,right,T5d,242,-4,6,7,-1
720575940639203300,right,T5d,243,-1,-21,-10,-11
720575940622311306,right,T5d,244,-4,-12,-2,-10
720575940626804617,right,T5d,245,-5,-3,3,-6
720575940609113539,right,T5d,246,-4,15,11,4
720575940610727266,right,T5d,247,-4,-15,-4,-11
720575940639425341,right,T5d,249,2,-12,-8,-4
720575940621016429,right,T5d,250,-1,1,1,0
720575940612537366,right,T5d,251,-1,-14,-6,-8
720575940631166208,right,T5d,252,3,23,8,15
720575940639404496,right,T5d,253,5,16,3,13
720575940631183012,right,T5d,255,-6,-13,-1,-12
720575940627274345,right,T5d,256,5,-20,-15,-5
720575940626993171,right,T5d,257,2,21,8,13
720575940612927146,right,T5d,258,-4,-17,-5,-12
720575940623051400,right,T5d,259,-7,-5,4,-9
720575940634382328,right,T5d,260,-3,19,12,7
720575940617134036,right,T5d,261,-1,13,7,6
720575940633655194,right,T5d,262,1,-11,-7,-4
720575940624133640,right,T5d,263,-3,4,5,-1
720575940631093560,right,T5d,264,-1,-6,-2,-4
720575940622808077,right,T5d,265,-6,-1,5,-6
720575940618757147,right,T5d,266,-1,-25,-12,-13
720575940628656683,right,T5d,267,-6,2,7,-5
720575940622249249,right,T5d,268,7,-6,-10,4
720575940616408971,right,T5d,269,2,-19,-12,-7
720575940637532813,right,T5d,270,1,-8,-5,-3
720575940629585146,right,T5d,271,4,6,-1,7
720575940629730268,right,T5d,272,3,-2,-4,2
720575940622912717,right,T5d,273,-6,23,17,6
720575940644519959,right,T5d,274,6,4,-4,8
720575940629984220,right,T5d,275,-8,-1,7,-8
720575940610907204,right,T5d,276,2,3,-1,4
720575940630388086,right,T5d,278,-5,10,10,0
720575940623071526,right,T5d,279,-4,8,8,0
720575940606198449,right,T5d,280,-6,-14,-1,-13
720575940616397727,right,T5d,282,0,26,13,13
720575940629474686,right,T5d,283,-4,4,6,-2
720575940615943786,right,T5d,284,0,25,12,13
720575940628047592,right,T5d,285,6,-18,-15,-3
720575940627409490,right,T5d,286,0,-24,-12,-12
720575940627448904,right,T5d,287,-5,13,11,2
720575940620894599,right,T5d,288,-1,30,16,14
720575940625654003,right,T5d,289,-1,11,6,5
720575940620806336,right,T5d,290,5,-24,-17,-7
720575940637676777,right,T5d,291,7,2,-6,8
720575940643754440,right,T5d,292,-4,18,13,5
720575940619468235,right,T5d,293,4,-17,-13,-4
720575940626693465,right,T5d,294,1,-20,-11,-9
720575940627518269,right,T5d,295,-2,29,16,13
720575940625023536,right,T5d,296,1,-18,-10,-8
720575940622240470,right,T5d,298,-5,5,7,-2
720575940631629625,right,T5d,299,-4,12,10,2
720575940627107134,right,T5d,300,4,-18,-13,-5
720575940633464033,right,T5d,301,-5,16,13,3
720575940617861755,right,T5d,302,2,17,6,11
720575940621673754,right,T5d,303,-5,22,16,6
720575940631775815,right,T5d,305,-7,4,9,-5
720575940646588212,right,T5d,306,3,7,0,7
720575940615909900,right,T5d,307,5,-25,-18,-7
720575940627933639,right,T5d,308,-5,8,9,-1
720575940630356844,right,T5d,309,-6,12,12,0
720575940609382921,right,T5d,310,2,22,9,13
720575940627152442,right,T5d,311,-7,15,14,1
720575940633804389,right,T5d,312,4,-7,-8,1
720575940638064692,right,T5d,313,7,3,-6,9
720575940632206500,right,T5d,314,-9,5,11,-6
720575940612979171,right,T5d,315,-3,-6,0,-6
720575940605686793,right,T5d,316,5,-4,-7,3
720575940634090080,right,T5d,317,-5,-4,3,-7
720575940621485300,right,T5d,319,-2,5,4,1
720575940622684429,right,T5d,320,-2,-5,-1,-4
720575940638888026,right,T5d,322,2,26,11,15
720575940627945724,right,T5d,324,3,24,9,15
720575940637781082,right,T5d,325,5,1,-5,6
720575940623971837,right,T5d,326,2,16,6,10
720575940605996209,right,T5d,327,5,3,-4,7
720575940630258903,right,T5d,328,5,-9,-10,1
720575940616915468,right,T5d,329,0,24,12,12
720575940624142896,right,T5d,330,3,3,-2,5
720575940611540885,right,T5d,331,1,-15,-9,-6
720575940645483118,right,T5d,332,4,-26,-17,-9
720575940609826884,right,T5d,333,0,-21,-11,-10
720575940618978358,right,T5d,334,1,-26,-14,-12
720575940614473622,right,T5d,335,2,8,2,6
720575940616917004,right,T5d,336,0,23,11,12
720575940614547602,right,T5d,337,-5,-6,2,-8
720575940629836396,right,T5d,338,-1,0,1,-1
720575940621412852,right,T5d,339,6,11,-1,12
720575940629324026,right,T5d,340,-4,17,12,5
720575940624722924,right,T5d,341,6,-17,-15,-2
720575940628266373,right,T5d,342,2,-15,-10,-5
720575940618256724,right,T5d,343,-3,27,16,11
720575940606774146,right,T5d,344,-2,-15,-6,-9
720575940634727834,right,T5d,345,3,-12,-9,-3
720575940633035693,right,T5d,346,-7,-9,2,-11
720575940628842651,right,T5d,347,-5,-13,-2,-11
720575940624516391,right,T5d,348,3,14,4,10
720575940624741371,right,T5d,349,-5,-14,-2,-12
720575940623853309,right,T5d,350,1,15,6,9
720575940623090884,right,T5d,351,-1,-17,-8,-9
720575940625227708,right,T5d,352,-2,28,16,12
720575940628775952,right,T5d,353,2,24,10,14
720575940621446772,right,T5d,355,-7,-6,4,-10
720575940618787229,right,T5d,356,0,22,11,11
720575940613653394,right,T5d,357,4,17,4,13
720575940605500862,right,T5d,358,-3,17,11,6
720575940619839821,right,T5d,359,2,23,9,14
720575940628992330,right,T5d,360,-5,19,14,5
720575940634716058,right,T5d,361,0,-7,-4,-3
720575940618229312,right,T5d,362,2,-20,-12,-8
720575940624867571,right,T5d,363,7,-4,-9,5
720575940617657205,right,T5d,364,4,4,-2,6
720575940608562185,right,T5d,365,4,7,-1,8
720575940642641037,right,T5d,367,-6,-15,-2,-13
720575940622390810,right,T5d,368,-4,-20,-6,-14
720575940623859463,right,T5d,369,5,-5,-8,3
720575940645457262,right,T5d,370,-3,21,13,8
720575940614045858,right,T5d,371,6,-5,-9,4
720575940631401064,right,T5d,372,1,-2,-2,0
720575940645448996,right,T5d,373,1,-21,-12,-9
720575940637094256,right,T5d,374,2,13,4,9
720575940638648553,right,T5d,375,-6,7,9,-2
720575940631290410,right,T5d,377,0,7,3,4
720575940639592611,right,T5d,378,-3,18,12,6
720575940626122780,right,T5d,379,3,-17,-12,-5
720575940632872670,right,T5d,380,-1,29,15,14
720575940620148416,right,T5d,382,3,-6,-6,0
720575940633704217,right,T5d,383,-6,11,11,0
720575940626689917,right,T5d,384,-6,-2,5,-7
720575940651801590,right,T5d,385,-3,-18,-6,-12
720575940641100021,right,T5d,386,-6,19,15,4
720575940615142047,right,T5d,387,-1,-15,-7,-8
720575940639405885,right,T5d,388,3,19,6,13
720575940632453459,right,T5d,391,4,-3,-6,3
720575940625674533,right,T5d,392,-4,7,7,0
720575940623306198,right,T5d,393,-1,22,12,10
720575940632264775,right,T5d,394,-7,-8,3,-11
720575940643786144,right,T5d,395,0,-22,-11,-11
720575940633784986,right,T5d,396,-1,10,6,4
720575940625044068,right,T5d,397,-3,-19,-7,-12
720575940630802373,right,T5d,398,-3,22,14,8
720575940631446570,right,T5d,401,-2,-19,-8,-11
720575940628881660,right,T5d,402,3,26,10,16
720575940621776842,right,T5d,403,-2,-12,-4,-8
720575940629821483,right,T5d,404,-1,20,11,9
720575940616528145,right,T5d,405,3,10,2,8
720575940643436704,right,T5d,406,1,-25,-14,-11
720575940610970586,right,T5d,407,-5,-10,0,-10
720575940623724873,right,T5d,408,-6,-4,4,-8
720575940614283426,right,T5d,409,0,-3,-2,-1
720575940613226221,right,T5d,410,-2,-2,1,-3
720575940655389089,right,T5d,411,-5,-19,-5,-14
720575940624917847,right,T5d,412,-6,21,16,5
720575940627038010,right,T5d,413,-2,-7,-2,-5
720575940623363533,right,T5d,414,4,21,6,15
720575940627266566,right,T5d,415,6,12,0,12
720575940626993470,right,T5d,416,3,-8,-7,-1
720575940627135625,right,T5d,417,-6,-10,1,-11
720575940616109825,right,T5d,418,-2,15,9,6
720575940612360755,right,T5d,419,-3,-11,-3,-8
720575940645524846,right,T5d,420,6,-3,-8,5
720575940619221809,right,T5d,421,-1,12,7,5
720575940646877236,right,T5d,423,3,-18,-12,-6
720575940611832538,right,T5d,424,-3,-2,2,-4
720575940630582779,right,T5d,425,3,20,7,13
720575940608244316,right,T5d,426,-3,0,3,-3
720575940628624683,right,T5d,427,5,-18,-14,-4
720575940643671456,right,T5d,428,-2,23,13,10
720575940644957640,right,T5d,429,-2,14,9,5
720575940625754942,right,T5d,430,-3,-7,-1,-6
720575940631624760,right,T5d,431,-2,-10,-3,-7
720575940613756778,right,T5d,432,-5,7,8,-1
720575940624487954,right,T5d,433,0,-8,-4,-4
720575940625953598,right,T5d,434,-3,7,6,1
720575940623523293,right,T5d,435,5,-17,-14,-3
720575940617387035,right,T5d,436,0,-15,-8,-7
720575940634781082,right,T5d,437,-3,12,9,3
720575940646291822,right,T5d,438,2,27,11,16
720575940613601576,right,T5d,439,-3,-9,-2,-7
720575940605931180,right,T5d,440,1,23,10,13
720575940612489166,right,T5d,441,3,-16,-11,-5
720575940640846208,right,T5d,442,-5,25,17,8
720575940636237198,right,T5d,444,4,-10,-9,-1
720575940628539907,right,T5d,445,-2,8,6,2
720575940646527028,right,T5d,446,2,-14,-9,-5
720575940627511568,right,T5d,447,-1,2,2,0
720575940630590590,right,T5d,448,0,30,15,15
720575940626208850,right,T5d,449,6,-16,-14,-2
720575940654910113,right,T5d,450,2,-9,-7,-2
720575940622079612,right,T5d,451,4,20,6,14
720575940616205707,right,T5d,452,1,-9,-6,-3
720575940614552470,right,T5d,454,5,-12,-11,-1
720575940627579934,right,T5d,456,0,21,10,11
720575940627770344,right,T5d,457,-2,17,10,7
720575940630971599,right,T5d,459,5,-3,-7,4
720575940611523938,right,T5d,460,-3,-20,-7,-13
720575940620336208,right,T5d,461,7,-5,-10,5
720575940621521396,right,T5d,462,-1,18,10,8
720575940623610090,right,T5d,463,5,17,3,14
720575940637881919,right,T5d,464,4,0,-4,4
720575940640505552,right,T5d,465,3,0,-3,3
720575940619466772,right,T5d,466,1,14,6,8
720575940626333954,right,T5d,467,-2,-20,-8,-12
720575940625959780,right,T5d,468,-3,11,8,3
720575940644400164,right,T5d,469,-7,13,13,0
720575940629622910,right,T5d,470,4,-9,-9,0
720575940627407125,right,T5d,471,3,-26,-16,-10
720575940619868795,right,T5d,472,1,25,11,14
720575940632309156,right,T5d,473,-4,23,15,8
720575940631251743,right,T5d,474,-3,-17,-6,-11
720575940625649594,right,T5d,475,-4,-1,3,-4
720575940627100170,right,T5d,476,-1,15,8,7
720575940638861365,right,T5d,477,-3,2,4,-2
720575940615693766,right,T5d,479,-2,10,7,3
720575940635666031,right,T5d,480,3,-19,-13,-6
720575940604487968,right,T5d,481,4,-8,-8,0
720575940608947651,right,T5d,482,1,17,7,10
720575940623353226,right,T5d,483,2,-7,-6,-1
720575940635414708,right,T5d,484,3,-9,-8,-1
720575940618097482,right,T5d,485,-3,-3,1,-4
720575940627254020,right,T5d,486,0,1,0,1
720575940614300994,right,T5d,487,1,-1,-2,1
720575940609835332,right,T5d,488,7,5,-5,10
720575940621696094,right,T5d,489,-3,10,8,2
720575940627418184,right,T5d,490,-5,6,8,-2
720575940613997265,right,T5d,491,7,-1,-8,7
720575940639215950,right,T5d,492,-7,-2,6,-8
720575940625426832,right,T5d,493,-3,23,14,9
720575940617531478,right,T5d,494,0,29,14,15
720575940621794586,right,T5d,495,4,5,-2,7
720575940626979252,right,T5d,497,6,1,-6,7
720575940620551776,right,T5d,498,6,10,-1,11
720575940617171985,right,T5d,499,5,10,0,10
720575940624905616,right,T5d,500,7,-8,-11,3
720575940627682577,right,T5d,501,1,2,0,2
720575940638581080,right,T5d,502,5,8,-1,9
720575940614395885,right,T5d,503,3,17,5,12
720575940624114923,right,T5d,504,-2,9,6,3
720575940633185363,right,T5d,506,1,-12,-7,-5
720575940610742882,right,T5d,507,-5,-12,-1,-11
720575940617250489,right,T5d,508,-5,11,10,1
720575940613925073,right,T5d,509,-4,10,9,1
720575940629633015,right,T5d,510,-2,11,7,4
720575940641639899,right,T5d,511,5,-11,-11,0
720575940623502572,right,T5d,512,6,0,-6,6
720575940610732386,right,T5d,513,-4,-13,-3,-10
720575940614689938,right,T5d,514,-4,-10,-1,-9
720575940649861753,right,T5d,515,-8,-7,4,-11
720575940639765693,right,T5d,517,6,3,-5,8
720575940630683692,right,T5d,518,-4,22,15,7
720575940611961306,right,T5d,520,-2,-22,-9,-13
720575940627097118,right,T5d,521,6,-9,-11,2
720575940621608993,right,T5d,522,-4,0,4,-4
720575940606862978,right,T5d,523,2,14,5,9
720575940614582397,right,T5d,524,4,-20,-14,-6
720575940631550520,right,T5d,525,-1,-20,-9,-11
720575940627466748,right,T5d,526,0,-10,-5,-5
720575940614106791,right,T5d,527,-4,-8,0,-8
720575940626609277,right,T5d,528,2,7,1,6
720575940624194378,right,T5d,529,2,-2,-3,1
720575940610731618,right,T5d,530,-3,-13,-4,-9
720575940624347210,right,T5d,531,1,0,-1,1
720575940627521679,right,T5d,532,-8,7,11,-4
720575940621873610,right,T5d,533,0,-16,-8,-8
720575940633777247,right,T5d,534,3,2,-2,4
720575940645020526,right,T5d,536,3,4,-1,5
720575940620768347,right,T5d,537,0,-23,-12,-11
720575940646492212,right,T5d,538,-4,1,4,-3
720575940618400216,right,T5d,539,-6,15,13,2
720575940625770073,right,T5d,540,-2,-9,-3,-6
720575940659893633,right,T5d,541,-4,14,11,3
720575940624432615,right,T5d,543,-1,-4,-1,-3
720575940627062274,right,T5d,544,3,-13,-10,-3
720575940624953784,right,T5d,545,5,11,0,11
720575940624207347,right,T5d,546,3,6,0,6
720575940644937672,right,T5d,547,-1,21,11,10
720575940624921274,right,T5d,548,1,-16,-9,-7
720575940627819931,right,T5d,549,0,-9,-5,-4
720575940621466236,right,T5d,550,-2,3,3,0
720575940605738417,right,T5d,551,-4,-9,-1,-8
720575940638639924,right,T5d,552,4,-1,-5,4
720575940639617443,right,T5d,553,-3,16,11,5
720575940611556757,right,T5d,555,-4,9,8,1
720575940623937724,right,T5d,556,0,10,5,5
720575940620932417,right,T5d,557,6,-10,-11,1
720575940624136636,right,T5d,558,-4,-21,-7,-14
720575940617442022,right,T5d,559,-6,22,17,5
720575940624530151,right,T5d,560,-7,14,14,0
720575940623153546,right,T5d,561,5,7,-2,9
720575940611746995,right,T5d,562,-5,-2,4,-6
720575940642343157,right,T5d,563,5,-13,-12,-1
720575940608246281,right,T5d,564,3,-23,-15,-8
720575940620662619,right,T5d,565,0,-26,-13,-13
720575940639646323,right,T5d,566,5,-8,-9,1
720575940631347218,right,T5d,567,-2,22,13,9
720575940614033887,right,T5d,568,-6,-8,2,-10
720575940627834511,right,T5d,569,6,6,-3,9
720575940619827277,right,T5d,570,2,25,10,15
720575940621972938,right,T5d,571,0,-14,-7,-7
720575940633159650,right,T5d,572,-8,3,9,-6
720575940605334886,right,T5d,573,4,14,3,11
720575940636880240,right,T5d,574,-6,5,8,-3
720575940620445536,right,T5d,575,6,9,-2,11
720575940610195139,right,T5d,576,0,28,14,14
720575940631111936,right,T5d,577,5,-14,-12,-2
720575940637765951,right,T5d,578,4,-11,-10,-1
720575940635344052,right,T5d,579,-3,-10,-2,-8
720575940617807650,right,T5d,580,-2,-23,-10,-13
720575940612055219,right,T5d,581,3,9,1,8
720575940661041537,right,T5d,582,-1,23,12,11
720575940643482784,right,T5d,583,3,-25,-16,-9
720575940619825485,right,T5d,584,4,23,7,16
720575940606986418,right,T5d,586,2,18,7,11
720575940640970997,right,T5d,587,4,22,7,15
720575940631108805,right,T5d,588,1,4,1,3
720575940622081448,right,T5d,589,-1,-5,-2,-3
720575940606855810,right,T5d,590,1,9,3,6
720575940626557839,right,T5d,591,3,-3,-5,2
720575940644671255,right,T5d,593,3,-14,-10,-4
720575940605712486,right,T5d,594,7,-16,-15,-1
720575940625386317,right,T5d,596,-4,-16,-4,-12
720575940627909361,right,T5d,597,4,1,-4,5
720575940615788603,right,T5d,598,2,-18,-11,-7
720575940617636609,right,T5d,599,-1,9,5,4
720575940639544179,right,T5d,600,3,-10,-8,-2
720575940628681259,right,T5d,601,1,16,7,9
720575940619616080,right,T5d,602,4,-2,-5,3
720575940637000590,right,T5d,603,-3,-23,-9,-14
720575940610238510,right,T5d,605,3,15,4,11
720575940608041923,right,T5d,606,-1,-19,-9,-10
720575940644787310,right,T5d,607,1,18,8,10
720575940636733582,right,T5d,608,1,10,4,6
720575940629243191,right,T5d,609,-2,0,2,-2
720575940612931480,right,T5d,610,2,-23,-14,-9
720575940626344741,right,T5d,611,-1,-18,-8,-10
720575940639481944,right,T5d,614,-2,-8,-2,-6
720575940633352127,right,T5d,615,-7,-7,3,-10
720575940619438795,right,T5d,616,-3,15,10,5
720575940614176066,right,T5d,617,-2,-17,-7,-10
720575940613570326,right,T5d,618,-1,24,13,11
720575940619367838,right,T5d,620,7,1,-7,8
720575940630971136,right,T5d,621,1,24,11,13
720575940625344014,right,T5d,622,-5,20,15,5
720575940630390142,right,T5d,623,1,13,5,8
720575940637760309,right,T5d,624,1,-17,-10,-7
720575940612115685,right,T5d,625,-2,24,14,10
720575940620370347,right,T5d,626,-5,-8,1,-9
720575940624167143,right,T5d,627,0,-1,-1,0
720575940621736205,right,T5d,628,0,0,0,0
720575940612081777,right,T5d,629,4,24,8,16
720575940608535876,right,T5d,630,4,8,0,8
720575940643192205,right,T5d,631,1,26,12,14
720575940618627669,right,T5d,632,3,-20,-13,-7
720575940631563205,right,T5d,633,-1,-24,-11,-13
720575940622128586,right,T5d,634,-3,-15,-5,-10
720575940615987131,right,T5d,635,6,-6,-9,3
720575940610811746,right,T5d,636,0,6,3,3
720575940630543055,right,T5d,637,3,-21,-14,-7
720575940629863680,right,T5d,638,-1,7,4,3
720575940623892041,right,T5d,639,-4,19,13,6
720575940618664533,right,T5d,640,-1,-16,-7,-9
720575940618654282,right,T5d,641,-8,-5,5,-10
720575940635870576,right,T5d,642,-5,-11,-1,-10
720575940621378725,right,T5d,643,6,14,1,13
720575940627149322,right,T5d,644,-6,18,15,3
720575940629260803,right,T5d,645,-4,27,17,10
720575940623798931,right,T5d,647,-4,-7,0,-7
720575940645538356,right,T5d,648,1,7,2,5
720575940605336422,right,T5d,649,-1,5,3,2
720575940609361621,right,T5d,650,-3,-25,-10,-15
720575940627994865,right,T5d,651,-4,-5,1,-6
720575940626063292,right,T5d,653,-6,-12,0,-12
720575940619670101,right,T5d,654,-3,8,7,1
720575940635164011,right,T5d,655,6,-1,-7,6
720575940621169228,right,T5d,656,0,-11,-6,-5
720575940622785560,right,T5d,658,1,20,9,11
720575940627456529,right,T5d,659,-4,-6,1,-7
720575940615490450,right,T5d,660,2,28,12,16
720575940643752392,right,T5d,661,-3,14,10,4
720575940600866569,right,T5d,662,2,-1,-3,2
720575940644684823,right,T5d,663,0,8,4,4
720575940629758330,right,T5d,664,1,-27,-15,-12
720575940620892193,right,T5d,665,7,-2,-8,6
720575940615580831,right,T5d,667,1,-28,-15,-13
720575940640567760,right,T5d,668,1,19,8,11
720575940629791232,right,T5d,669,4,-16,-12,-4
720575940622599267,right,T5d,670,5,5,-3,8
720575940622628702,right,T5d,671,-4,-23,-8,-15
720575940630654927,right,T5d,672,-8,11,13,-2
720575940616906641,right,T5d,673,2,5,0,5
720575940626506716,right,T5d,674,-4,-14,-3,-11
720575940636824750,right,T5d,676,-3,-21,-8,-13
720575940625811518,right,T5d,677,0,11,5,6
720575940632850643,right,T5d,678,3,-7,-7,0
720575940645786222,right,T5d,679,4,18,5,13
720575940636918639,right,T5d,680,-1,25,13,12
720575940631007051,right,T5d,681,-2,-21,-9,-12
720575940621132108,right,T5d,682,6,-8,-10,2
720575940627985905,right,T5d,683,2,6,1,5
720575940607040178,right,T5d,684,-6,17,14,3
720575940622067572,right,T5d,685,-5,-9,0,-9
720575940621828272,right,T5d,687,-6,-3,4,-7
720575940615658508,right,T5d,688,-7,10,12,-2
720575940623869769,right,T5d,689,-2,18,11,7
720575940605559328,right,T5d,691,-9,4,11,-7
720575940632709068,right,T5d,692,-4,24,16,8
720575940628869431,right,T5d,693,-3,25,15,10
720575940632091812,right,T5d,694,4,3,-3,6
720575940611773282,right,T5d,695,-6,10,11,-1
720575940634242782,right,T5d,696,-2,16,10,6
720575940632095313,right,T5d,697,1,-22,-12,-10
720575940628887375,right,T5d,698,6,-7,-10,3
720575940630834191,right,T5d,699,-5,0,5,-5
720575940617311761,right,T5d,700,5,15,2,13
720575940637463262,right,T5d,701,0,-4,-2,-2
720575940640851584,right,T5d,702,-5,23,16,7
720575940613294632,right,T5d,703,-3,1,3,-2
720575940614833002,right,T5d,704,-7,8,11,-3
720575940624127219,right,T5d,705,1,1,-1,2
720575940626798778,right,T5d,707,-2,25,14,11
720575940627763855,right,T5d,709,-2,-24,-10,-14
720575940630903948,right,T5d,711,-1,19,10,9
720575940644744727,right,T5d,712,-7,12,13,-1
720575940616921089,right,T5d,713,-6,16,14,2
720575940612909265,right,T5d,714,5,12,1,11
720575940631701608,right,T5d,715,4,10,1,9
720575940636067191,right,T5d,716,4,-6,-7,1
720575940620824667,right,T5d,717,2,-22,-13,-9
720575940620805824,right,T5d,718,-5,24,17,7
720575940627397507,right,T5d,719,1,27,12,15
720575940643773128,right,T5d,720,-5,21,15,6
720575940620102576,right,T5d,721,5,13,1,12
720575940628180935,right,T5d,722,6,-15,-14,-1
720575940616516235,right,T5d,723,-2,-11,-4,-7
720575940625558160,right,T5d,724,4,2,-3,5
720575940626241555,right,T5d,725,-3,-24,-9,-15
720575940620553125,right,T5d,726,2,-28,-16,-12
720575940612561561,right,T5d,728,7,12,-1,13
720575940630905415,right,T5d,729,-3,29,17,12
720575940621561328,right,T5d,730,7,0,-7,7
720575940608405515,right,T5d,731,-6,9,10,-1
720575940614014179,right,T5d,732,-3,6,6,0
720575940629987575,right,T5d,733,-5,-17,-4,-13
720575940638562356,right,T5d,734,2,0,-2,2
720575940621548276,right,T5d,735,1,-23,-13,-10
720575940620840102,right,T5d,736,-8,1,8,-7
720575940626497284,right,T5d,737,0,19,9,10
720575940624189479,right,T5d,738,-3,13,9,4
720575940604704940,right,T5d,739,-7,2,8,-6
720575940627980905,right,T5d,740,2,-8,-6,-2
720575940623036618,right,T5d,741,-2,-14,-5,-9
720575940616828172,right,T5d,742,-4,11,9,2
720575940628316989,right,T5d,744,-4,25,16,9
720575940637873471,right,T5d,745,0,13,6,7
720575940637728858,right,T5d,746,-3,3,4,-1
720575940623368887,right,T5d,747,0,2,1,1
720575940618813563,right,T5d,748,-4,20,14,6
720575940642940724,right,T5d,749,-2,1,2,-1
720575940613042802,right,T5d,750,4,-24,-16,-8
720575940643808535,right,T5d,751,1,6,2,4
720575940625956396,right,T5d,752,-2,7,5,2
720575940634974103,right,T5d,753,-3,24,15,9
720575940622290954,right,T5d,754,-1,-13,-6,-7
720575940623972605,right,T5d,755,4,19,5,14
720575940623149192,right,T5d,756,5,20,5,15
720575940637541773,right,T5d,757,0,-6,-3,-3
720575940612072677,right,T5d,758,5,-1,-6,5
720575940621454256,right,T5d,759,7,14,0,14
720575940614398370,right,T5d,760,0,17,8,9
720575940644428488,right,T5d,761,-4,-18,-5,-13
720575940621798494,right,T5d,762,0,14,7,7
720575940637772772,right,T5d,763,-5,14,12,2
720575940617689561,right,T5d,764,-8,-6,5,-11
720575940636865904,right,T5d,765,-3,9,7,2
720575940660329601,right,T5d,766,2,-4,-4,0
720575940620815124,right,T5d,767,1,28,13,15
720575940628467243,right,T5d,768,3,5,-1,6
720575940622686819,right,T5d,770,5,4,-3,7
720575940616194772,right,T5d,772,1,12,5,7
720575940626061756,right,T5d,773,5,-19,-15,-4
720575940619860301,right,T5d,775,5,22,6,16
720575940625257805,right,T5d,776,5,21,5,16
720575940608486921,right,T5d,778,4,25,8,17
720575940631003192,right,T5d,780,-6,25,18,7
720575940627231006,right,T5d,781,-5,26,18,8
720575940645628695,right,T5d,782,-5,27,18,9
720575940616481766,right,T5d,783,-4,28,18,10
720575940627571773,right,T5d,784,-4,29,18,11
720575940609208412,right,T5d,786,-2,30,17,13
720575940615564354,right,T5d,787,3,28,11,17
720575940619890136,right,T5d,790,-2,-27,-12,-15
720575940640766004,right,T5d,792,8,2,-7,9
720575940627086681,right,T5d,796,4,26,9,17
720575940619804144,right,Tm1,1,-6,13,12,1
720575940629500747,right,Tm1,2,-8,2,9,-7
720575940610239790,right,Tm1,3,6,-12,-12,0
720575940634233712,right,Tm1,4,-5,-21,-6,-15
720575940618007877,right,Tm1,5,-1,16,9,7
720575940617474777,right,Tm1,6,-2,-4,0,-4
720575940616603787,right,Tm1,7,-6,-6,3,-9
720575940617161243,right,Tm1,8,-4,26,17,9
720575940633671469,right,Tm1,9,4,9,0,9
720575940659904385,right,Tm1,10,5,-15,-13,-2
720575940614365343,right,Tm1,11,7,-14,-14,0
720575940622368589,right,Tm1,12,-7,9,11,-2
720575940624379912,right,Tm1,13,-1,-26,-12,-14
720575940619724248,right,Tm1,14,0,-27,-14,-13
720575940609482616,right,Tm1,15,2,-3,-4,1
720575940632682444,right,Tm1,16,-2,-16,-6,-10
720575940620888865,right,Tm1,17,1,-5,-4,-1
720575940637794281,right,Tm1,18,5,-16,-13,-3
720575940605179849,right,Tm1,19,-7,17,15,2
720575940625541936,right,Tm1,20,3,-11,-9,-2
720575940637734372,right,Tm1,21,-2,19,11,8
720575940622402742,right,Tm1,22,-1,3,2,1
720575940623364649,right,Tm1,23,-3,-16,-5,-11
720575940642661024,right,Tm1,24,-1,-10,-4,-6
720575940644820168,right,Tm1,25,-9,3,10,-7
720575940620297793,right,Tm1,26,1,-3,-3,0
720575940628577960,right,Tm1,27,0,-25,-13,-12
720575940616414523,right,Tm1,29,-1,-3,-1,-2
720575940614164655,right,Tm1,30,6,16,2,14
720575940606824834,right,Tm1,31,0,16,8,8
720575940619576661,right,Tm1,32,0,12,6,6
720575940616351686,right,Tm1,33,3,18,6,12
720575940622999245,right,Tm1,34,6,18,3,15
720575940616503739,right,Tm1,35,1,-24,-13,-11
720575940626924184,right,Tm1,36,6,8,-2,10
720575940635947438,right,Tm1,37,1,5,1,4
720575940632070829,right,Tm1,38,0,-2,-1,-1
720575940605816422,right,Tm1,39,0,20,10,10
720575940626211621,right,Tm1,40,-2,-6,-1,-5
720575940629233884,right,Tm1,41,-3,28,17,11
720575940622605388,right,Tm1,42,-1,14,8,6
720575940621199966,right,Tm1,43,-5,18,14,4
720575940625875282,right,Tm1,44,5,-10,-10,0
720575940619173997,right,Tm1,45,-5,-1,4,-5
720575940615118731,right,Tm1,46,-5,15,12,3
720575940624525630,right,Tm1,47,-9,-1,8,-9
720575940630274663,right,Tm1,48,-4,-22,-7,-15
720575940638748093,right,Tm1,49,4,-4,-6,2
720575940620149627,right,Tm1,50,-2,21,12,9
720575940627269950,right,Tm1,51,0,-19,-10,-9
720575940631344914,right,Tm1,52,-1,-22,-10,-12
720575940629801770,right,Tm1,53,5,14,2,12
720575940620078196,right,Tm1,54,-4,3,5,-2
720575940623363050,right,Tm1,55,-4,-11,-2,-9
720575940612131058,right,Tm1,56,1,-13,-8,-5
720575940619041752,right,Tm1,57,6,-11,-12,1
720575940624616426,right,Tm1,58,3,12,3,9
720575940610229346,right,Tm1,59,-2,2,3,-1
720575940616638806,right,Tm1,60,-8,8,12,-4
720575940621326104,right,Tm1,61,-4,-4,2,-6
720575940620587224,right,Tm1,62,0,-29,-15,-14
720575940606441150,right,Tm1,63,4,12,2,10
720575940623925175,right,Tm1,64,4,-23,-16,-7
720575940621338038,right,Tm1,65,-1,28,15,13
720575940615842098,right,Tm1,66,2,15,5,10
720575940628535356,right,Tm1,67,-2,-13,-5,-8
720575940627304213,right,Tm1,68,3,16,5,11
720575940604541798,right,Tm1,70,-4,21,14,7
720575940635579255,right,Tm1,71,-2,-3,0,-3
720575940638211930,right,Tm1,72,0,-28,-14,-14
720575940624135242,right,Tm1,73,2,2,-1,3
720575940635648367,right,Tm1,74,-1,-9,-4,-5
720575940618089045,right,Tm1,75,-6,14,13,1
720575940626012493,right,Tm1,76,-3,-4,1,-5
720575940628144745,right,Tm1,77,2,-5,-5,0
720575940613069549,right,Tm1,78,2,20,8,12
720575940629673436,right,Tm1,79,2,1,-2,3
720575940635557271,right,Tm1,80,4,13,2,11
720575940610714578,right,Tm1,81,6,-2,-7,5
720575940624451172,right,Tm1,82,-7,7,10,-3
720575940634235036,right,Tm1,83,2,-21,-13,-8
720575940605152177,right,Tm1,84,-2,12,8,4
720575940627119119,right,Tm1,85,4,-22,-15,-7
720575940614829023,right,Tm1,86,-5,-7,1,-8
720575940622563077,right,Tm1,87,1,11,4,7
720575940624850412,right,Tm1,89,1,-19,-11,-8
720575940627248380,right,Tm1,90,-4,5,6,-1
720575940622827658,right,Tm1,91,-1,6,4,2
720575940635174648,right,Tm1,93,-6,3,7,-4
720575940630982139,right,Tm1,94,5,18,4,14
720575940627152911,right,Tm1,95,4,-21,-15,-6
720575940640270976,right,Tm1,96,1,-10,-6,-4
720575940629279744,right,Tm1,97,-5,2,6,-4
720575940635115103,right,Tm1,98,-1,-12,-5,-7
720575940633545517,right,Tm1,99,4,15,3,12
720575940632231394,right,Tm1,100,2,-10,-7,-3
720575940612287027,right,Tm1,101,-7,6,10,-4
720575940617373248,right,Tm1,102,3,13,3,10
720575940640734883,right,Tm1,103,7,9,-3,12
720575940618429414,right,Tm1,104,-1,-27,-13,-14
720575940604151520,right,Tm1,105,3,22,8,14
720575940630377697,right,Tm1,106,-7,11,12,-1
720575940638857542,right,Tm1,107,8,-2,-9,7
720575940626018096,right,Tm1,108,-3,-12,-3,-9
720575940629894160,right,Tm1,109,4,-5,-7,2
720575940641800589,right,Tm1,110,-7,0,7,-7
720575940621149761,right,Tm1,111,2,-24,-14,-10
720575940630930735,right,Tm1,112,-6,1,6,-5
720575940622943587,right,Tm1,113,-2,4,4,0
720575940631716399,right,Tm1,114,2,-13,-9,-4
720575940623465096,right,Tm1,115,-4,2,5,-3
720575940635790840,right,Tm1,116,-1,-8,-3,-5
720575940622520575,right,Tm1,117,-8,-2,7,-9
720575940609566276,right,Tm1,118,3,1,-3,4
720575940629345335,right,Tm1,119,-2,6,5,1
720575940628746746,right,Tm1,120,-1,-1,0,-1
720575940610650853,right,Tm1,121,-8,4,10,-6
720575940628085322,right,Tm1,122,-5,9,9,0
720575940628890998,right,Tm1,123,-8,10,13,-3
720575940621354667,right,Tm1,124,1,-7,-5,-2
720575940649454201,right,Tm1,125,5,9,-1,10
720575940629211258,right,Tm1,126,3,11,2,9
720575940631146026,right,Tm1,127,0,15,7,8
720575940622990118,right,Tm1,128,3,-22,-14,-8
720575940636790158,right,Tm1,129,0,-13,-7,-6
720575940628172796,right,Tm1,130,2,12,4,8
720575940611295510,right,Tm1,131,-6,20,16,4
720575940617503115,right,Tm1,132,2,4,0,4
720575940636346469,right,Tm1,133,-3,20,13,7
720575940618194461,right,Tm1,134,-5,-18,-4,-14
720575940647521156,right,Tm1,135,-3,-22,-8,-14
720575940621820513,right,Tm1,136,0,3,1,2
720575940633159891,right,Tm1,137,5,-7,-9,2
720575940608883465,right,Tm1,138,0,27,13,14
720575940617830749,right,Tm1,139,1,-14,-8,-6
720575940625143795,right,Tm1,140,3,8,1,7
720575940619363700,right,Tm1,141,5,-23,-17,-6
720575940633656801,right,Tm1,142,-2,-18,-7,-11
720575940636726117,right,Tm1,143,-4,16,12,4
720575940626951769,right,Tm1,144,7,-11,-13,2
720575940647708468,right,Tm1,145,0,4,2,2
720575940607489970,right,Tm1,146,1,-6,-4,-2
720575940623389162,right,Tm1,147,1,21,9,12
720575940616149249,right,Tm1,148,-7,-11,1,-12
720575940617601570,right,Tm1,149,6,-14,-13,-1
720575940638839529,right,Tm1,150,-8,5,10,-5
720575940630138368,right,Tm1,151,-3,-14,-4,-10
720575940621815462,right,Tm1,152,3,-15,-11,-4
720575940634740335,right,Tm1,153,8,0,-8,8
720575940626100313,right,Tm1,154,-8,0,8,-8
720575940617430356,right,Tm1,155,-8,13,14,-1
720575940621958977,right,Tm1,156,-9,1,9,-8
720575940622329769,right,Tm1,157,-1,-7,-3,-4
720575940612429938,right,Tm1,158,3,-5,-6,1
720575940624844071,right,Tm1,159,7,7,-4,11
720575940630046684,right,Tm1,160,-2,20,12,8
720575940646602548,right,Tm1,161,4,-14,-11,-3
720575940619273419,right,Tm1,162,-4,-2,3,-5
720575940615923942,right,Tm1,163,-9,7,12,-5
720575940630103759,right,Tm1,164,-1,-2,0,-2
720575940624448338,right,Tm1,165,4,16,4,12
720575940625361552,right,Tm1,166,0,18,9,9
720575940638947910,right,Tm1,167,0,-17,-9,-8
720575940629933532,right,Tm1,168,-1,17,9,8
720575940629431399,right,Tm1,169,0,-18,-9,-9
720575940629476683,right,Tm1,170,-5,1,5,-4
720575940627070991,right,Tm1,171,6,-20,-16,-4
720575940611880666,right,Tm1,172,1,22,10,12
720575940621015888,right,Tm1,173,2,-25,-15,-10
720575940618745839,right,Tm1,174,4,-15,-12,-3
720575940610791026,right,Tm1,175,-6,-7,2,-9
720575940611401109,right,Tm1,176,-2,13,8,5
720575940634248639,right,Tm1,177,-2,-1,1,-2
720575940622998822,right,Tm1,178,2,11,3,8
720575940627666462,right,Tm1,179,-5,-16,-3,-13
720575940629842882,right,Tm1,180,2,-27,-16,-11
720575940621249445,right,Tm1,181,1,-4,-3,-1
720575940636138853,right,Tm1,182,7,-10,-12,2
720575940627430994,right,Tm1,183,-5,-15,-3,-12
720575940640994805,right,Tm1,184,-6,-5,3,-8
720575940630559788,right,Tm1,185,2,-11,-8,-3
720575940626245932,right,Tm1,186,-1,26,14,12
720575940612194201,right,Tm1,187,3,21,7,14
720575940635066798,right,Tm1,188,-5,17,13,4
720575940623670212,right,Tm1,189,6,13,0,13
720575940632810721,right,Tm1,190,-3,-5,0,-5
720575940641655515,right,Tm1,191,-1,-11,-5,-6
720575940632072729,right,Tm1,193,-5,4,7,-3
720575940636527790,right,Tm1,194,0,-5,-3,-2
720575940623462804,right,Tm1,195,-3,-1,2,-3
720575940604885350,right,Tm1,196,-1,8,5,3
720575940630085676,right,Tm1,197,0,-20,-10,-10
720575940612923955,right,Tm1,198,6,2,-5,7
720575940639382717,right,Tm1,199,0,-12,-6,-6
720575940609156188,right,Tm1,200,-5,12,11,1
720575940617189755,right,Tm1,201,-8,9,12,-3
720575940631403794,right,Tm1,202,-1,27,14,13
720575940608148489,right,Tm1,203,3,-1,-4,3
720575940644061294,right,Tm1,204,5,-2,-6,4
720575940637587172,right,Tm1,205,5,-6,-8,2
720575940630149719,right,Tm1,206,-3,5,5,0
720575940619723643,right,Tm1,207,1,29,13,16
720575940623469448,right,Tm1,208,5,-21,-16,-5
720575940636861808,right,Tm1,209,-3,-8,-1,-7
720575940624016688,right,Tm1,210,-6,8,10,-2
720575940621966294,right,Tm1,211,-7,-1,6,-7
720575940629939516,right,Tm1,212,2,-16,-10,-6
720575940640460173,right,Tm1,213,3,-4,-5,1
720575940608361737,right,Tm1,214,-5,3,6,-3
720575940610094126,right,Tm1,215,6,7,-3,10
720575940620993968,right,Tm1,216,2,19,7,12
720575940625349680,right,Tm1,219,6,-4,-8,4
720575940637607565,right,Tm1,220,2,-6,-5,-1
720575940631875147,right,Tm1,221,-7,3,8,-5
720575940629931642,right,Tm1,222,-3,26,16,10
720575940626649602,right,Tm1,223,-2,26,15,11
720575940636381040,right,Tm1,224,0,5,2,3
720575940634090210,right,Tm1,225,2,-26,-15,-11
720575940624478695,right,Tm1,226,5,19,4,15
720575940612222760,right,Tm1,227,-7,5,9,-4
720575940620473921,right,Tm1,228,-7,1,7,-6
720575940615077171,right,Tm1,229,5,2,-4,6
720575940620386725,right,Tm1,230,2,9,2,7
720575940624437799,right,Tm1,231,4,-12,-10,-2
720575940627043627,right,Tm1,232,-4,13,10,3
720575940640413757,right,Tm1,233,4,-13,-11,-2
720575940632227501,right,Tm1,234,1,3,0,3
720575940634286999,right,Tm1,235,4,11,1,10
720575940613266984,right,Tm1,236,-1,4,3,1
720575940616361740,right,Tm1,237,-2,27,15,12
720575940631428945,right,Tm1,238,-8,-3,6,-9
720575940610395354,right,Tm1,239,-6,6,9,-3
720575940630787287,right,Tm1,240,-4,-3,2,-5
720575940618542539,right,Tm1,241,2,-17,-11,-6
720575940621852554,right,Tm1,242,-4,6,7,-1
720575940630238927,right,Tm1,243,-1,-21,-10,-11
720575940610116654,right,Tm1,244,-4,-12,-2,-10
720575940639466328,right,Tm1,245,-5,-3,3,-6
720575940623788779,right,Tm1,246,-4,15,11,4
720575940612398515,right,Tm1,247,-4,-15,-4,-11
720575940639939547,right,Tm1,248,-6,0,6,-6
720575940617982438,right,Tm1,249,2,-12,-8,-4
720575940634127770,right,Tm1,250,-1,1,1,0
720575940620417377,right,Tm1,251,-1,-14,-6,-8
720575940612394035,right,Tm1,252,3,23,8,15
720575940622329309,right,Tm1,253,5,16,3,13
720575940630769879,right,Tm1,254,3,-24,-15,-9
720575940605706086,right,Tm1,255,-6,-13,-1,-12
720575940638623046,right,Tm1,256,5,-20,-15,-5
720575940626899987,right,Tm1,257,2,21,8,13
720575940617969053,right,Tm1,258,-4,-17,-5,-12
720575940622509773,right,Tm1,259,-7,-5,4,-9
720575940622170582,right,Tm1,260,-3,19,12,7
720575940643040292,right,Tm1,261,-1,13,7,6
720575940623882825,right,Tm1,262,1,-11,-7,-4
720575940630358124,right,Tm1,263,-3,4,5,-1
720575940628606658,right,Tm1,264,-1,-6,-2,-4
720575940633516825,right,Tm1,265,-6,-1,5,-6
720575940616230815,right,Tm1,266,-1,-25,-12,-13
720575940613942695,right,Tm1,267,-6,2,7,-5
720575940627019944,right,Tm1,268,7,-6,-10,4
720575940617190517,right,Tm1,269,2,-19,-12,-7
720575940630227820,right,Tm1,270,1,-8,-5,-3
720575940629143546,right,Tm1,272,3,-2,-4,2
720575940628096680,right,Tm1,273,-6,23,17,6
720575940628369738,right,Tm1,274,6,4,-4,8
720575940625693284,right,Tm1,275,-8,-1,7,-8
720575940611486131,right,Tm1,276,2,3,-1,4
720575940634942615,right,Tm1,277,7,-3,-9,6
720575940632621278,right,Tm1,278,-5,10,10,0
720575940615130763,right,Tm1,279,-4,8,8,0
720575940629041659,right,Tm1,280,-6,-14,-1,-13
720575940621483363,right,Tm1,281,-9,2,10,-8
720575940613587935,right,Tm1,282,0,26,13,13
720575940623433876,right,Tm1,283,-4,4,6,-2
720575940621146733,right,Tm1,284,0,25,12,13
720575940607815346,right,Tm1,285,6,-18,-15,-3
720575940636516215,right,Tm1,286,0,-24,-12,-12
720575940621394714,right,Tm1,287,-5,13,11,2
720575940611444088,right,Tm1,288,-1,30,16,14
720575940621948637,right,Tm1,289,-1,11,6,5
720575940625281267,right,Tm1,290,5,-24,-17,-7
720575940632486044,right,Tm1,291,7,2,-6,8
720575940640380379,right,Tm1,292,-4,18,13,5
720575940636544174,right,Tm1,293,4,-17,-13,-4
720575940627818877,right,Tm1,294,1,-20,-11,-9
720575940638156772,right,Tm1,295,-2,29,16,13
720575940628617734,right,Tm1,296,1,-18,-10,-8
720575940631506474,right,Tm1,297,7,-9,-12,3
720575940616482955,right,Tm1,298,-5,5,7,-2
720575940627120940,right,Tm1,299,-4,12,10,2
720575940631313219,right,Tm1,300,4,-18,-13,-5
720575940619247963,right,Tm1,301,-5,16,13,3
720575940615457698,right,Tm1,302,2,17,6,11
720575940625480250,right,Tm1,303,-5,22,16,6
720575940613586498,right,Tm1,305,-7,4,9,-5
720575940610123733,right,Tm1,306,3,7,0,7
720575940615755679,right,Tm1,307,5,-25,-18,-7
720575940628833192,right,Tm1,308,-5,8,9,-1
720575940633256087,right,Tm1,309,-6,12,12,0
720575940623638791,right,Tm1,310,2,22,9,13
720575940623223054,right,Tm1,311,-7,15,14,1
720575940611952114,right,Tm1,312,4,-7,-8,1
720575940634074208,right,Tm1,313,7,3,-6,9
720575940632571715,right,Tm1,314,-9,5,11,-6
720575940625824100,right,Tm1,315,-3,-6,0,-6
720575940624530446,right,Tm1,316,5,-4,-7,3
720575940623605833,right,Tm1,317,-5,-4,3,-7
720575940622226608,right,Tm1,318,4,-19,-14,-5
720575940631973580,right,Tm1,319,-2,5,4,1
720575940625977392,right,Tm1,320,-2,-5,-1,-4
720575940631825995,right,Tm1,321,8,4,-6,10
720575940627656956,right,Tm1,322,2,26,11,15
720575940633658849,right,Tm1,323,-7,-13,0,-13
720575940625713907,right,Tm1,324,3,24,9,15
720575940637558591,right,Tm1,325,5,1,-5,6
720575940631485035,right,Tm1,326,2,16,6,10
720575940627367496,right,Tm1,327,5,3,-4,7
720575940627375375,right,Tm1,328,5,-9,-10,1
720575940616994134,right,Tm1,329,0,24,12,12
720575940640876672,right,Tm1,330,3,3,-2,5
720575940619685717,right,Tm1,331,1,-15,-9,-6
720575940611300818,right,Tm1,332,4,-26,-17,-9
720575940646915636,right,Tm1,333,0,-21,-11,-10
720575940629731227,right,Tm1,334,1,-26,-14,-12
720575940631054610,right,Tm1,335,2,8,2,6
720575940626742814,right,Tm1,336,0,23,11,12
720575940639539619,right,Tm1,337,-5,-6,2,-8
720575940621169791,right,Tm1,338,-1,0,1,-1
720575940623699529,right,Tm1,340,-4,17,12,5
720575940622769535,right,Tm1,341,6,-17,-15,-2
720575940619847920,right,Tm1,342,2,-15,-10,-5
720575940630797164,right,Tm1,343,-3,27,16,11
720575940635649016,right,Tm1,344,-2,-15,-6,-9
720575940621220336,right,Tm1,345,3,-12,-9,-3
720575940612766378,right,Tm1,346,-7,-9,2,-11
720575940625468178,right,Tm1,347,-5,-13,-2,-11
720575940627176183,right,Tm1,348,3,14,4,10
720575940624050683,right,Tm1,349,-5,-14,-2,-12
720575940634902111,right,Tm1,350,1,15,6,9
720575940616059846,right,Tm1,351,-1,-17,-8,-9
720575940637593566,right,Tm1,352,-2,28,16,12
720575940611597410,right,Tm1,353,2,24,10,14
720575940613239410,right,Tm1,354,-2,-26,-11,-15
720575940599333574,right,Tm1,355,-7,-6,4,-10
720575940634426905,right,Tm1,356,0,22,11,11
720575940610630098,right,Tm1,357,4,17,4,13
720575940628693248,right,Tm1,358,-3,17,11,6
720575940617756601,right,Tm1,359,2,23,9,14
720575940618672293,right,Tm1,360,-5,19,14,5
720575940629157967,right,Tm1,361,0,-7,-4,-3
720575940614329410,right,Tm1,362,2,-20,-12,-8
720575940628813415,right,Tm1,363,7,-4,-9,5
720575940614960815,right,Tm1,364,4,4,-2,6
720575940645433454,right,Tm1,366,-5,-20,-5,-15
720575940632324433,right,Tm1,367,-6,-15,-2,-13
720575940622949912,right,Tm1,368,-4,-20,-6,-14
720575940620874416,right,Tm1,369,5,-5,-8,3
720575940632564269,right,Tm1,370,-3,21,13,8
720575940619756423,right,Tm1,371,6,-5,-9,4
720575940633632339,right,Tm1,372,1,-2,-2,0
720575940616483131,right,Tm1,373,1,-21,-12,-9
720575940622990121,right,Tm1,374,2,13,4,9
720575940645803799,right,Tm1,375,-6,7,9,-2
720575940623552221,right,Tm1,376,-7,-10,2,-12
720575940632427576,right,Tm1,377,0,7,3,4
720575940621262356,right,Tm1,378,-3,18,12,6
720575940628551848,right,Tm1,379,3,-17,-12,-5
720575940640955088,right,Tm1,380,-1,29,15,14
720575940637489990,right,Tm1,381,-8,-9,3,-12
720575940646442804,right,Tm1,382,3,-6,-6,0
720575940618976750,right,Tm1,383,-6,11,11,0
720575940612283601,right,Tm1,384,-6,-2,5,-7
720575940629765502,right,Tm1,385,-3,-18,-6,-12
720575940613230846,right,Tm1,386,-6,19,15,4
720575940620477376,right,Tm1,387,-1,-15,-7,-8
720575940617536212,right,Tm1,389,-6,-16,-2,-14
720575940629766906,right,Tm1,390,-6,-9,1,-10
720575940639245912,right,Tm1,391,4,-3,-6,3
720575940603884512,right,Tm1,392,-4,7,7,0
720575940623709877,right,Tm1,393,-1,22,12,10
720575940616206386,right,Tm1,394,-7,-8,3,-11
720575940632553892,right,Tm1,395,0,-22,-11,-11
720575940625885571,right,Tm1,396,-1,10,6,4
720575940626535445,right,Tm1,397,-3,-19,-7,-12
720575940626855468,right,Tm1,398,-3,22,14,8
720575940627888296,right,Tm1,399,-4,-24,-8,-16
720575940631982167,right,Tm1,400,1,-29,-16,-13
720575940633874899,right,Tm1,401,-2,-19,-8,-11
720575940630271292,right,Tm1,402,3,26,10,16
720575940613803571,right,Tm1,403,-2,-12,-4,-8
720575940614355507,right,Tm1,404,-1,20,11,9
720575940611118030,right,Tm1,405,3,10,2,8
720575940615222890,right,Tm1,406,1,-25,-14,-11
720575940622963299,right,Tm1,407,-5,-10,0,-10
720575940619861814,right,Tm1,408,-6,-4,4,-8
720575940624321468,right,Tm1,409,0,-3,-2,-1
720575940621468854,right,Tm1,410,-2,-2,1,-3
720575940624302075,right,Tm1,411,-5,-19,-5,-14
720575940637221173,right,Tm1,412,-6,21,16,5
720575940618368925,right,Tm1,413,-2,-7,-2,-5
720575940619559600,right,Tm1,414,4,21,6,15
720575940628284267,right,Tm1,415,6,12,0,12
720575940620872641,right,Tm1,416,3,-8,-7,-1
720575940626080570,right,Tm1,417,-6,-10,1,-11
720575940624399591,right,Tm1,418,-2,15,9,6
720575940645119267,right,Tm1,419,-3,-11,-3,-8
720575940626739722,right,Tm1,420,6,-3,-8,5
720575940617830360,right,Tm1,421,-1,12,7,5
720575940633816601,right,Tm1,422,-7,-4,5,-9
720575940635458228,right,Tm1,423,3,-18,-12,-6
720575940608839435,right,Tm1,424,-3,-2,2,-4
720575940643803415,right,Tm1,425,3,20,7,13
720575940620457045,right,Tm1,426,-3,0,3,-3
720575940607677826,right,Tm1,427,5,-18,-14,-4
720575940614334114,right,Tm1,428,-2,23,13,10
720575940628425475,right,Tm1,429,-2,14,9,5
720575940625250795,right,Tm1,430,-3,-7,-1,-6
720575940627282705,right,Tm1,431,-2,-10,-3,-7
720575940630385270,right,Tm1,432,-5,7,8,-1
720575940610654050,right,Tm1,433,0,-8,-4,-4
720575940629148775,right,Tm1,434,-3,7,6,1
720575940605825452,right,Tm1,435,5,-17,-14,-3
720575940622655702,right,Tm1,436,0,-15,-8,-7
720575940637205390,right,Tm1,437,-3,12,9,3
720575940627938820,right,Tm1,438,2,27,11,16
720575940613253799,right,Tm1,439,-3,-9,-2,-7
720575940619266763,right,Tm1,440,1,23,10,13
720575940615589051,right,Tm1,441,3,-16,-11,-5
720575940630562268,right,Tm1,442,-5,25,17,8
720575940640401293,right,Tm1,443,-6,4,8,-4
720575940619425877,right,Tm1,444,4,-10,-9,-1
720575940632786914,right,Tm1,445,-2,8,6,2
720575940643812296,right,Tm1,446,2,-14,-9,-5
720575940621513036,right,Tm1,447,-1,2,2,0
720575940627201308,right,Tm1,448,0,30,15,15
720575940627482639,right,Tm1,449,6,-16,-14,-2
720575940619572974,right,Tm1,450,2,-9,-7,-2
720575940650074233,right,Tm1,451,4,20,6,14
720575940616477323,right,Tm1,452,1,-9,-6,-3
720575940630099959,right,Tm1,453,3,25,9,16
720575940612063667,right,Tm1,454,5,-12,-11,-1
720575940622625494,right,Tm1,455,7,-7,-11,4
720575940638865597,right,Tm1,456,0,21,10,11
720575940633146157,right,Tm1,457,-2,17,10,7
720575940641659444,right,Tm1,458,5,0,-5,5
720575940643694103,right,Tm1,459,5,-3,-7,4
720575940612379634,right,Tm1,460,-3,-20,-7,-13
720575940629984706,right,Tm1,461,7,-5,-10,5
720575940616652630,right,Tm1,462,-1,18,10,8
720575940610303857,right,Tm1,463,5,17,3,14
720575940612779493,right,Tm1,464,4,0,-4,4
720575940625807034,right,Tm1,465,3,0,-3,3
720575940624300471,right,Tm1,466,1,14,6,8
720575940615607106,right,Tm1,467,-2,-20,-8,-12
720575940620324929,right,Tm1,468,-3,11,8,3
720575940631025980,right,Tm1,469,-7,13,13,0
720575940632152524,right,Tm1,470,4,-9,-9,0
720575940620280411,right,Tm1,471,3,-26,-16,-10
720575940634222361,right,Tm1,472,1,25,11,14
720575940613300246,right,Tm1,473,-4,23,15,8
720575940626684803,right,Tm1,474,-3,-17,-6,-11
720575940604094240,right,Tm1,475,-4,-1,3,-4
720575940626386476,right,Tm1,476,-1,15,8,7
720575940612151193,right,Tm1,477,-3,2,4,-2
720575940632735710,right,Tm1,478,-7,16,15,1
720575940615130931,right,Tm1,479,-2,10,7,3
720575940634448866,right,Tm1,480,3,-19,-13,-6
720575940620000960,right,Tm1,481,4,-8,-8,0
720575940616819771,right,Tm1,482,1,17,7,10
720575940631187364,right,Tm1,483,2,-7,-6,-1
720575940618156504,right,Tm1,484,3,-9,-8,-1
720575940642888333,right,Tm1,485,-3,-3,1,-4
720575940644140567,right,Tm1,486,0,1,0,1
720575940642870068,right,Tm1,487,1,-1,-2,1
720575940638177508,right,Tm1,488,7,5,-5,10
720575940632845538,right,Tm1,489,-3,10,8,2
720575940615440530,right,Tm1,490,-5,6,8,-2
720575940631978041,right,Tm1,491,7,-1,-8,7
720575940614212498,right,Tm1,492,-7,-2,6,-8
720575940620713387,right,Tm1,493,-3,23,14,9
720575940620976493,right,Tm1,494,0,29,14,15
720575940623959787,right,Tm1,497,6,1,-6,7
720575940625038087,right,Tm1,498,6,10,-1,11
720575940624319157,right,Tm1,499,5,10,0,10
720575940631025724,right,Tm1,500,7,-8,-11,3
720575940619789227,right,Tm1,501,1,2,0,2
720575940630341750,right,Tm1,502,5,8,-1,9
720575940622727885,right,Tm1,503,3,17,5,12
720575940653088246,right,Tm1,504,-2,9,6,3
720575940660287617,right,Tm1,505,6,-22,-17,-5
720575940626352228,right,Tm1,506,1,-12,-7,-5
720575940622456589,right,Tm1,507,-5,-12,-1,-11
720575940629899324,right,Tm1,508,-5,11,10,1
720575940627151148,right,Tm1,509,-4,10,9,1
720575940613062952,right,Tm1,510,-2,11,7,4
720575940628661903,right,Tm1,511,5,-11,-11,0
720575940630336727,right,Tm1,512,6,0,-6,6
720575940615078654,right,Tm1,513,-4,-13,-3,-10
720575940626808350,right,Tm1,514,-4,-10,-1,-9
720575940626449508,right,Tm1,515,-8,-7,4,-11
720575940626252388,right,Tm1,516,7,-18,-16,-2
720575940613134745,right,Tm1,517,6,3,-5,8
720575940618542134,right,Tm1,518,-4,22,15,7
720575940631562124,right,Tm1,519,-5,-5,2,-7
720575940616866443,right,Tm1,520,-2,-22,-9,-13
720575940625809789,right,Tm1,521,6,-9,-11,2
720575940629267834,right,Tm1,522,-4,0,4,-4
720575940623749355,right,Tm1,523,2,14,5,9
720575940620520724,right,Tm1,524,4,-20,-14,-6
720575940631972920,right,Tm1,525,-1,-20,-9,-11
720575940619016001,right,Tm1,526,0,-10,-5,-5
720575940631602340,right,Tm1,527,-4,-8,0,-8
720575940618896385,right,Tm1,529,2,-2,-3,1
720575940628048872,right,Tm1,530,-3,-13,-4,-9
720575940625406188,right,Tm1,531,1,0,-1,1
720575940653353889,right,Tm1,532,-8,7,11,-4
720575940617318971,right,Tm1,533,0,-16,-8,-8
720575940624972617,right,Tm1,534,3,2,-2,4
720575940607060425,right,Tm1,535,8,-4,-10,6
720575940642403291,right,Tm1,536,3,4,-1,5
720575940620814171,right,Tm1,537,0,-23,-12,-11
720575940624039108,right,Tm1,538,-4,1,4,-3
720575940629559570,right,Tm1,539,-6,15,13,2
720575940617223097,right,Tm1,540,-2,-9,-3,-6
720575940627009290,right,Tm1,541,-4,14,11,3
720575940626039228,right,Tm1,542,6,-13,-13,0
720575940634722400,right,Tm1,543,-1,-4,-1,-3
720575940616455746,right,Tm1,544,3,-13,-10,-3
720575940628093512,right,Tm1,545,5,11,0,11
720575940609834564,right,Tm1,546,3,6,0,6
720575940625265959,right,Tm1,547,-1,21,11,10
720575940640255104,right,Tm1,548,1,-16,-9,-7
720575940619250334,right,Tm1,549,0,-9,-5,-4
720575940635695864,right,Tm1,550,-2,3,3,0
720575940617451238,right,Tm1,551,-4,-9,-1,-8
720575940613299222,right,Tm1,552,4,-1,-5,4
720575940627774952,right,Tm1,553,-3,16,11,5
720575940620473185,right,Tm1,554,-9,-3,7,-10
720575940627156524,right,Tm1,555,-4,9,8,1
720575940619908187,right,Tm1,556,0,10,5,5
720575940649442169,right,Tm1,557,6,-10,-11,1
720575940623656935,right,Tm1,558,-4,-21,-7,-14
720575940610989937,right,Tm1,559,-6,22,17,5
720575940626913798,right,Tm1,560,-7,14,14,0
720575940622273974,right,Tm1,561,5,7,-2,9
720575940621200884,right,Tm1,562,-5,-2,4,-6
720575940637328350,right,Tm1,563,5,-13,-12,-1
720575940628102199,right,Tm1,564,3,-23,-15,-8
720575940623252950,right,Tm1,565,0,-26,-13,-13
720575940624668942,right,Tm1,566,5,-8,-9,1
720575940659464577,right,Tm1,567,-2,22,13,9
720575940634329811,right,Tm1,568,-6,-8,2,-10
720575940632750403,right,Tm1,569,6,6,-3,9
720575940617195449,right,Tm1,570,2,25,10,15
720575940621896072,right,Tm1,571,0,-14,-7,-7
720575940627437511,right,Tm1,572,-8,3,9,-6
720575940620911837,right,Tm1,573,4,14,3,11
720575940627486809,right,Tm1,574,-6,5,8,-3
720575940629730298,right,Tm1,575,6,9,-2,11
720575940627479836,right,Tm1,576,0,28,14,14
720575940625432819,right,Tm1,577,5,-14,-12,-2
720575940613687859,right,Tm1,578,4,-11,-10,-1
720575940616423366,right,Tm1,579,-3,-10,-2,-8
720575940616117772,right,Tm1,580,-2,-23,-10,-13
720575940607941298,right,Tm1,581,3,9,1,8
720575940608195339,right,Tm1,582,-1,23,12,11
720575940624175623,right,Tm1,583,3,-25,-16,-9
720575940628294218,right,Tm1,584,4,23,7,16
720575940625011785,right,Tm1,585,-1,-23,-11,-12
720575940612600529,right,Tm1,586,2,18,7,11
720575940617570193,right,Tm1,587,4,22,7,15
720575940642773300,right,Tm1,588,1,4,1,3
720575940627644412,right,Tm1,589,-1,-5,-2,-3
720575940620651174,right,Tm1,590,1,9,3,6
720575940611306962,right,Tm1,591,3,-3,-5,2
720575940631193404,right,Tm1,592,3,-28,-17,-11
720575940613193965,right,Tm1,593,3,-14,-10,-4
720575940627481871,right,Tm1,594,7,-16,-15,-1
720575940626079269,right,Tm1,595,7,-12,-13,1
720575940621462388,right,Tm1,596,-4,-16,-4,-12
720575940617148509,right,Tm1,597,4,1,-4,5
720575940619972884,right,Tm1,598,2,-18,-11,-7
720575940620991878,right,Tm1,599,-1,9,5,4
720575940638727613,right,Tm1,600,3,-10,-8,-2
720575940627161591,right,Tm1,601,1,16,7,9
720575940618363515,right,Tm1,602,4,-2,-5,3
720575940612975786,right,Tm1,603,-3,-23,-9,-14
720575940615539359,right,Tm1,604,-6,-17,-3,-14
720575940620573264,right,Tm1,605,3,15,4,11
720575940613369827,right,Tm1,606,-1,-19,-9,-10
720575940621332102,right,Tm1,607,1,18,8,10
720575940619139382,right,Tm1,608,1,10,4,6
720575940616746845,right,Tm1,609,-2,0,2,-2
720575940631987852,right,Tm1,610,2,-23,-14,-9
720575940629263003,right,Tm1,611,-1,-18,-8,-10
720575940615099242,right,Tm1,612,-3,-26,-10,-16
720575940633222495,right,Tm1,613,-8,-4,6,-10
720575940638248670,right,Tm1,614,-2,-8,-2,-6
720575940625985072,right,Tm1,615,-7,-7,3,-10
720575940605709740,right,Tm1,616,-3,15,10,5
720575940619761287,right,Tm1,617,-2,-17,-7,-10
720575940634579135,right,Tm1,618,-1,24,13,11
720575940622739463,right,Tm1,619,-4,-19,-6,-13
720575940617711505,right,Tm1,620,7,1,-7,8
720575940633875117,right,Tm1,621,1,24,11,13
720575940621244003,right,Tm1,622,-5,20,15,5
720575940629521534,right,Tm1,623,1,13,5,8
720575940621092372,right,Tm1,624,1,-17,-10,-7
720575940625701612,right,Tm1,625,-2,24,14,10
720575940631762145,right,Tm1,626,-5,-8,1,-9
720575940631593041,right,Tm1,627,0,-1,-1,0
720575940627387644,right,Tm1,628,0,0,0,0
720575940632236600,right,Tm1,629,4,24,8,16
720575940645464599,right,Tm1,630,4,8,0,8
720575940643191949,right,Tm1,631,1,26,12,14
720575940623365523,right,Tm1,632,3,-20,-13,-7
720575940611419598,right,Tm1,633,-1,-24,-11,-13
720575940613916847,right,Tm1,634,-3,-15,-5,-10
720575940611832282,right,Tm1,635,6,-6,-9,3
720575940629759787,right,Tm1,636,0,6,3,3
720575940606792113,right,Tm1,637,3,-21,-14,-7
720575940614574061,right,Tm1,638,-1,7,4,3
720575940621807598,right,Tm1,639,-4,19,13,6
720575940631501615,right,Tm1,640,-1,-16,-7,-9
720575940631110995,right,Tm1,641,-8,-5,5,-10
720575940617901268,right,Tm1,642,-5,-11,-1,-10
720575940627181047,right,Tm1,643,6,14,1,13
720575940627027289,right,Tm1,644,-6,18,15,3
720575940647640196,right,Tm1,645,-4,27,17,10
720575940635089515,right,Tm1,646,6,17,2,15
720575940618377521,right,Tm1,647,-4,-7,0,-7
720575940628074089,right,Tm1,648,1,7,2,5
720575940622134960,right,Tm1,649,-1,5,3,2
720575940626033422,right,Tm1,650,-3,-25,-10,-15
720575940615781593,right,Tm1,651,-4,-5,1,-6
720575940626907919,right,Tm1,652,-6,-11,0,-11
720575940622957923,right,Tm1,653,-6,-12,0,-12
720575940626392869,right,Tm1,654,-3,8,7,1
720575940641560628,right,Tm1,655,6,-1,-7,6
720575940621904041,right,Tm1,656,0,-11,-6,-5
720575940642800072,right,Tm1,658,1,20,9,11
720575940626649000,right,Tm1,659,-4,-6,1,-7
720575940628906540,right,Tm1,660,2,28,12,16
720575940615981173,right,Tm1,661,-3,14,10,4
720575940618724893,right,Tm1,662,2,-1,-3,2
720575940618750491,right,Tm1,664,1,-27,-15,-12
720575940620248235,right,Tm1,665,7,-2,-8,6
720575940626595612,right,Tm1,666,7,-13,-14,1
720575940621934445,right,Tm1,667,1,-28,-15,-13
720575940636487342,right,Tm1,668,1,19,8,11
720575940629773655,right,Tm1,669,4,-16,-12,-4
720575940619709745,right,Tm1,671,-4,-23,-8,-15
720575940633309082,right,Tm1,672,-8,11,13,-2
720575940627951528,right,Tm1,673,2,5,0,5
720575940637108446,right,Tm1,674,-4,-14,-3,-11
720575940618689349,right,Tm1,675,-7,19,16,3
720575940626643843,right,Tm1,676,-3,-21,-8,-13
720575940643841844,right,Tm1,677,0,11,5,6
720575940610428402,right,Tm1,678,3,-7,-7,0
720575940634181587,right,Tm1,679,4,18,5,13
720575940620523540,right,Tm1,680,-1,25,13,12
720575940611345834,right,Tm1,681,-2,-21,-9,-12
720575940604895148,right,Tm1,682,6,-8,-10,2
720575940624813129,right,Tm1,683,2,6,1,5
720575940610647210,right,Tm1,684,-6,17,14,3
720575940627630123,right,Tm1,685,-5,-9,0,-9
720575940614762914,right,Tm1,686,5,-22,-16,-6
720575940614529386,right,Tm1,687,-6,-3,4,-7
720575940613601346,right,Tm1,688,-7,10,12,-2
720575940633415822,right,Tm1,689,-2,18,11,7
720575940631049803,right,Tm1,690,-7,-3,5,-8
720575940625658899,right,Tm1,691,-9,4,11,-7
720575940630698690,right,Tm1,692,-4,24,16,8
720575940620263558,right,Tm1,693,-3,25,15,10
720575940619527245,right,Tm1,695,-6,10,11,-1
720575940629849148,right,Tm1,696,-2,16,10,6
720575940625017863,right,Tm1,697,1,-22,-12,-10
720575940634620863,right,Tm1,698,6,-7,-10,3
720575940629020154,right,Tm1,699,-5,0,5,-5
720575940633128674,right,Tm1,700,5,15,2,13
720575940632033197,right,Tm1,701,0,-4,-2,-2
720575940616296498,right,Tm1,702,-5,23,16,7
720575940627176452,right,Tm1,703,-3,1,3,-2
720575940623570765,right,Tm1,704,-7,8,11,-3
720575940607931401,right,Tm1,705,1,1,-1,2
720575940624682852,right,Tm1,706,-7,-12,1,-13
720575940625129148,right,Tm1,707,-2,25,14,11
720575940629670394,right,Tm1,708,-4,-25,-9,-16
720575940636733040,right,Tm1,709,-2,-24,-10,-14
720575940634888599,right,Tm1,710,4,-25,-17,-8
720575940648375940,right,Tm1,711,-1,19,10,9
720575940626087980,right,Tm1,712,-7,12,13,-1
720575940604839084,right,Tm1,713,-6,16,14,2
720575940614209703,right,Tm1,714,5,12,1,11
720575940615760569,right,Tm1,715,4,10,1,9
720575940637228429,right,Tm1,716,4,-6,-7,1
720575940617368925,right,Tm1,717,2,-22,-13,-9
720575940616867894,right,Tm1,718,-5,24,17,7
720575940630729410,right,Tm1,719,1,27,12,15
720575940626447366,right,Tm1,720,-5,21,15,6
720575940621526810,right,Tm1,721,5,13,1,12
720575940616134924,right,Tm1,722,6,-15,-14,-1
720575940639798643,right,Tm1,723,-2,-11,-4,-7
720575940634426393,right,Tm1,724,4,2,-3,5
720575940640262272,right,Tm1,725,-3,-24,-9,-15
720575940630698618,right,Tm1,726,2,-28,-16,-12
720575940629868587,right,Tm1,727,7,6,-4,10
720575940615761803,right,Tm1,729,-3,29,17,12
720575940641585460,right,Tm1,730,7,0,-7,7
720575940633142682,right,Tm1,731,-6,9,10,-1
720575940627380841,right,Tm1,732,-3,6,6,0
720575940638139364,right,Tm1,733,-5,-17,-4,-13
720575940604009062,right,Tm1,734,2,0,-2,2
720575940619153822,right,Tm1,735,1,-23,-13,-10
720575940621321864,right,Tm1,736,-8,1,8,-7
720575940627887354,right,Tm1,737,0,19,9,10
720575940621476357,right,Tm1,738,-3,13,9,4
720575940631973324,right,Tm1,739,-7,2,8,-6
720575940613586403,right,Tm1,740,2,-8,-6,-2
720575940624084917,right,Tm1,741,-2,-14,-5,-9
720575940627096876,right,Tm1,742,-4,11,9,2
720575940632783012,right,Tm1,743,6,-19,-16,-3
720575940621138902,right,Tm1,744,-4,25,16,9
720575940627390095,right,Tm1,745,0,13,6,7
720575940643559972,right,Tm1,746,-3,3,4,-1
720575940619104541,right,Tm1,747,0,2,1,1
720575940634867342,right,Tm1,748,-4,20,14,6
720575940613830306,right,Tm1,749,-2,1,2,-1
720575940633848802,right,Tm1,750,4,-24,-16,-8
720575940613315606,right,Tm1,751,1,6,2,4
720575940624823881,right,Tm1,752,-2,7,5,2
720575940605324204,right,Tm1,753,-3,24,15,9
720575940628641730,right,Tm1,754,-1,-13,-6,-7
720575940633206483,right,Tm1,755,4,19,5,14
720575940627902716,right,Tm1,756,5,20,5,15
720575940652102134,right,Tm1,757,0,-6,-3,-3
720575940631116074,right,Tm1,758,5,-1,-6,5
720575940632600647,right,Tm1,759,7,14,0,14
720575940626170440,right,Tm1,760,0,17,8,9
720575940617915938,right,Tm1,761,-4,-18,-5,-13
720575940621757005,right,Tm1,762,0,14,7,7
720575940618384293,right,Tm1,763,-5,14,12,2
720575940630550575,right,Tm1,764,-8,-6,5,-11
720575940626434604,right,Tm1,765,-3,9,7,2
720575940619114545,right,Tm1,766,2,-4,-4,0
720575940623583428,right,Tm1,767,1,28,13,15
720575940630918620,right,Tm1,768,3,5,-1,6
720575940634296089,right,Tm1,769,4,-27,-18,-9
720575940612944819,right,Tm1,770,5,4,-3,7
720575940628555536,right,Tm1,771,3,-27,-17,-10
720575940636870318,right,Tm1,772,1,12,5,7
720575940612294835,right,Tm1,773,5,-19,-15,-4
720575940606360962,right,Tm1,774,-8,6,11,-5
720575940641287413,right,Tm1,775,5,22,6,16
720575940617347414,right,Tm1,778,4,25,8,17
720575940622459376,right,Tm1,779,5,24,7,17
720575940617608539,right,Tm1,780,-6,25,18,7
720575940617505492,right,Tm1,781,-5,26,18,8
720575940623078732,right,Tm1,782,-5,27,18,9
720575940622761054,right,Tm1,783,-4,28,18,10
720575940622956509,right,Tm1,784,-4,29,18,11
720575940628400400,right,Tm1,786,-2,30,17,13
720575940638610502,right,Tm1,787,3,28,11,17
720575940620074832,right,Tm1,788,3,27,10,17
720575940642417805,right,Tm1,789,-3,-27,-11,-16
720575940618695965,right,Tm1,790,-2,-27,-12,-15
720575940630672581,right,Tm1,791,-1,-28,-13,-15
720575940643757216,right,Tm1,792,8,2,-7,9
720575940616958038,right,Tm1,793,8,-6,-11,5
720575940616566726,right,Tm1,794,5,-26,-18,-8
720575940648649092,right,Tm1,795,6,-21,-17,-4
720575940624638391,right,Tm1,796,4,26,9,17
720575940620244741,right,Tm2,1,-6,13,12,1
720575940630760223,right,Tm2,2,-8,2,9,-7
720575940624224949,right,Tm2,3,6,-12,-12,0
720575940612187866,right,Tm2,4,-5,-21,-6,-15
720575940612251877,right,Tm2,5,-1,16,9,7
720575940605913004,right,Tm2,6,-2,-4,0,-4
720575940624898540,right,Tm2,7,-6,-6,3,-9
720575940635815287,right,Tm2,8,-4,26,17,9
720575940611189454,right,Tm2,9,4,9,0,9
720575940645122583,right,Tm2,10,5,-15,-13,-2
720575940638074340,right,Tm2,11,7,-14,-14,0
720575940622960684,right,Tm2,12,-7,9,11,-2
720575940637647332,right,Tm2,13,-1,-26,-12,-14
720575940628581120,right,Tm2,14,0,-27,-14,-13
720575940624331082,right,Tm2,15,2,-3,-4,1
720575940622708151,right,Tm2,16,-2,-16,-6,-10
720575940615784507,right,Tm2,17,1,-5,-4,-1
720575940614053482,right,Tm2,18,5,-16,-13,-3
720575940613149034,right,Tm2,19,-7,17,15,2
720575940611702478,right,Tm2,20,3,-11,-9,-2
720575940647681668,right,Tm2,21,-2,19,11,8
720575940637262143,right,Tm2,22,-1,3,2,1
720575940647468164,right,Tm2,23,-3,-16,-5,-11
720575940623850008,right,Tm2,24,-1,-10,-4,-6
720575940637176885,right,Tm2,25,-9,3,10,-7
720575940611083413,right,Tm2,26,1,-3,-3,0
720575940630796908,right,Tm2,27,0,-25,-13,-12
720575940613740455,right,Tm2,29,-1,-3,-1,-2
720575940620874223,right,Tm2,30,6,16,2,14
720575940608129628,right,Tm2,31,0,16,8,8
720575940622689612,right,Tm2,33,3,18,6,12
720575940619218113,right,Tm2,34,6,18,3,15
720575940617922772,right,Tm2,35,1,-24,-13,-11
720575940621194245,right,Tm2,37,1,5,1,4
720575940631295336,right,Tm2,38,0,-2,-1,-1
720575940623538729,right,Tm2,39,0,20,10,10
720575940638345542,right,Tm2,40,-2,-6,-1,-5
720575940620810177,right,Tm2,41,-3,28,17,11
720575940626365740,right,Tm2,42,-1,14,8,6
720575940616899670,right,Tm2,43,-5,18,14,4
720575940621928547,right,Tm2,44,5,-10,-10,0
720575940614240819,right,Tm2,45,-5,-1,4,-5
720575940619389249,right,Tm2,46,-5,15,12,3
720575940631659475,right,Tm2,47,-9,-1,8,-9
720575940634196592,right,Tm2,48,-4,-22,-7,-15
720575940604685740,right,Tm2,49,4,-4,-6,2
720575940604038880,right,Tm2,50,-2,21,12,9
720575940618040025,right,Tm2,51,0,-19,-10,-9
720575940624001032,right,Tm2,52,-1,-22,-10,-12
720575940627175415,right,Tm2,53,5,14,2,12
720575940631715671,right,Tm2,54,-4,3,5,-2
720575940623554963,right,Tm2,55,-4,-11,-2,-9
720575940617651156,right,Tm2,56,1,-13,-8,-5
720575940617843483,right,Tm2,57,6,-11,-12,1
720575940635195290,right,Tm2,58,3,12,3,9
720575940626801169,right,Tm2,59,-2,2,3,-1
720575940619430320,right,Tm2,60,-8,8,12,-4
720575940622095092,right,Tm2,61,-4,-4,2,-6
720575940636880782,right,Tm2,62,0,-29,-15,-14
720575940628349639,right,Tm2,63,4,12,2,10
720575940619325819,right,Tm2,64,4,-23,-16,-7
720575940615189043,right,Tm2,65,-1,28,15,13
720575940633124252,right,Tm2,66,2,15,5,10
720575940617470681,right,Tm2,67,-2,-13,-5,-8
720575940641435893,right,Tm2,68,3,16,5,11
720575940613635442,right,Tm2,69,1,8,3,5
720575940626903340,right,Tm2,70,-4,21,14,7
720575940613425361,right,Tm2,71,-2,-3,0,-3
720575940618074041,right,Tm2,72,0,-28,-14,-14
720575940610537678,right,Tm2,73,2,2,-1,3
720575940621914236,right,Tm2,74,-1,-9,-4,-5
720575940626489416,right,Tm2,75,-6,14,13,1
720575940641310939,right,Tm2,76,-3,-4,1,-5
720575940624538189,right,Tm2,77,2,-5,-5,0
720575940626284944,right,Tm2,78,2,20,8,12
720575940628456295,right,Tm2,79,2,1,-2,3
720575940627175927,right,Tm2,80,4,13,2,11
720575940612069745,right,Tm2,81,6,-2,-7,5
720575940628585948,right,Tm2,82,-7,7,10,-3
720575940621714345,right,Tm2,83,2,-21,-13,-8
720575940624950349,right,Tm2,84,-2,12,8,4
720575940627186813,right,Tm2,85,4,-22,-15,-7
720575940618796352,right,Tm2,86,-5,-7,1,-8
720575940623725261,right,Tm2,87,1,11,4,7
720575940632361999,right,Tm2,88,7,4,-5,9
720575940612499186,right,Tm2,89,1,-19,-11,-8
720575940637323829,right,Tm2,90,-4,5,6,-1
720575940620732342,right,Tm2,91,-1,6,4,2
720575940642185691,right,Tm2,92,0,9,4,5
720575940644945608,right,Tm2,93,-6,3,7,-4
720575940623093784,right,Tm2,94,5,18,4,14
720575940627145231,right,Tm2,95,4,-21,-15,-6
720575940612119258,right,Tm2,96,1,-10,-6,-4
720575940617198822,right,Tm2,97,-5,2,6,-4
720575940624507829,right,Tm2,98,-1,-12,-5,-7
720575940623124323,right,Tm2,99,4,15,3,12
720575940616378811,right,Tm2,100,2,-10,-7,-3
720575940629149804,right,Tm2,101,-7,6,10,-4
720575940626623076,right,Tm2,102,3,13,3,10
720575940636729486,right,Tm2,104,-1,-27,-13,-14
720575940619986123,right,Tm2,105,3,22,8,14
720575940631048749,right,Tm2,106,-7,11,12,-1
720575940615006943,right,Tm2,107,8,-2,-9,7
720575940660305793,right,Tm2,108,-3,-12,-3,-9
720575940611863219,right,Tm2,109,4,-5,-7,2
720575940605913516,right,Tm2,110,-7,0,7,-7
720575940622667703,right,Tm2,111,2,-24,-14,-10
720575940628692679,right,Tm2,112,-6,1,6,-5
720575940627422919,right,Tm2,113,-2,4,4,0
720575940619288478,right,Tm2,115,-4,2,5,-3
720575940636211557,right,Tm2,116,-1,-8,-3,-5
720575940632254233,right,Tm2,117,-8,-2,7,-9
720575940639878259,right,Tm2,118,3,1,-3,4
720575940617750411,right,Tm2,119,-2,6,5,1
720575940628177743,right,Tm2,120,-1,-1,0,-1
720575940627633863,right,Tm2,121,-8,4,10,-6
720575940627127596,right,Tm2,122,-5,9,9,0
720575940633135070,right,Tm2,123,-8,10,13,-3
720575940633160418,right,Tm2,124,1,-7,-5,-2
720575940659637889,right,Tm2,125,5,9,-1,10
720575940631395128,right,Tm2,127,0,15,7,8
720575940625770644,right,Tm2,128,3,-22,-14,-8
720575940627768453,right,Tm2,129,0,-13,-7,-6
720575940637583216,right,Tm2,130,2,12,4,8
720575940619345473,right,Tm2,131,-6,20,16,4
720575940620021662,right,Tm2,132,2,4,0,4
720575940615751839,right,Tm2,133,-3,20,13,7
720575940612378610,right,Tm2,134,-5,-18,-4,-14
720575940625121428,right,Tm2,135,-3,-22,-8,-14
720575940624071975,right,Tm2,136,0,3,1,2
720575940632818259,right,Tm2,137,5,-7,-9,2
720575940622364961,right,Tm2,138,0,27,13,14
720575940616133493,right,Tm2,139,1,-14,-8,-6
720575940638153328,right,Tm2,140,3,8,1,7
720575940612080738,right,Tm2,142,-2,-18,-7,-11
720575940604183654,right,Tm2,143,-4,16,12,4
720575940620682991,right,Tm2,144,7,-11,-13,2
720575940632731752,right,Tm2,145,0,4,2,2
720575940630306871,right,Tm2,146,1,-6,-4,-2
720575940611829477,right,Tm2,147,1,21,9,12
720575940616310066,right,Tm2,148,-7,-11,1,-12
720575940624819948,right,Tm2,149,6,-14,-13,-1
720575940611115030,right,Tm2,150,-8,5,10,-5
720575940628687272,right,Tm2,151,-3,-14,-4,-10
720575940631656791,right,Tm2,152,3,-15,-11,-4
720575940621078182,right,Tm2,153,8,0,-8,8
720575940623183544,right,Tm2,154,-8,0,8,-8
720575940623847056,right,Tm2,155,-8,13,14,-1
720575940642975524,right,Tm2,156,-9,1,9,-8
720575940619604359,right,Tm2,157,-1,-7,-3,-4
720575940608453077,right,Tm2,158,3,-5,-6,1
720575940616370700,right,Tm2,159,7,7,-4,11
720575940638324201,right,Tm2,160,-2,20,12,8
720575940622687002,right,Tm2,161,4,-14,-11,-3
720575940620467365,right,Tm2,162,-4,-2,3,-5
720575940616273947,right,Tm2,163,-9,7,12,-5
720575940636091760,right,Tm2,164,-1,-2,0,-2
720575940616367389,right,Tm2,165,4,16,4,12
720575940623256873,right,Tm2,166,0,18,9,9
720575940631653187,right,Tm2,167,0,-17,-9,-8
720575940632379790,right,Tm2,168,-1,17,9,8
720575940605411040,right,Tm2,169,0,-18,-9,-9
720575940638291007,right,Tm2,170,-5,1,5,-4
720575940635276127,right,Tm2,171,6,-20,-16,-4
720575940622743536,right,Tm2,172,1,22,10,12
720575940634904474,right,Tm2,173,2,-25,-15,-10
720575940627902863,right,Tm2,174,4,-15,-12,-3
720575940616567227,right,Tm2,175,-6,-7,2,-9
720575940615932987,right,Tm2,176,-2,13,8,5
720575940606632224,right,Tm2,177,-2,-1,1,-2
720575940615780725,right,Tm2,178,2,11,3,8
720575940634815639,right,Tm2,179,-5,-16,-3,-13
720575940625082953,right,Tm2,180,2,-27,-16,-11
720575940617035732,right,Tm2,181,1,-4,-3,-1
720575940628019204,right,Tm2,182,7,-10,-12,2
720575940629024087,right,Tm2,183,-5,-15,-3,-12
720575940637349598,right,Tm2,184,-6,-5,3,-8
720575940639421117,right,Tm2,185,2,-11,-8,-3
720575940615716418,right,Tm2,186,-1,26,14,12
720575940620417963,right,Tm2,187,3,21,7,14
720575940608305756,right,Tm2,188,-5,17,13,4
720575940610725874,right,Tm2,189,6,13,0,13
720575940621622652,right,Tm2,190,-3,-5,0,-5
720575940636202382,right,Tm2,191,-1,-11,-5,-6
720575940624811755,right,Tm2,192,7,10,-2,12
720575940630153068,right,Tm2,193,-5,4,7,-3
720575940642612621,right,Tm2,194,0,-5,-3,-2
720575940635204088,right,Tm2,195,-3,-1,2,-3
720575940626449964,right,Tm2,196,-1,8,5,3
720575940630212567,right,Tm2,197,0,-20,-10,-10
720575940609970642,right,Tm2,198,6,2,-5,7
720575940626794021,right,Tm2,199,0,-12,-6,-6
720575940627105580,right,Tm2,200,-5,12,11,1
720575940636707930,right,Tm2,201,-8,9,12,-3
720575940632003176,right,Tm2,202,-1,27,14,13
720575940629866563,right,Tm2,203,3,-1,-4,3
720575940622999832,right,Tm2,204,5,-2,-6,4
720575940635553375,right,Tm2,205,5,-6,-8,2
720575940632431391,right,Tm2,206,-3,5,5,0
720575940622372223,right,Tm2,207,1,29,13,16
720575940642486669,right,Tm2,208,5,-21,-16,-5
720575940639591758,right,Tm2,209,-3,-8,-1,-7
720575940645418548,right,Tm2,210,-6,8,10,-2
720575940610379443,right,Tm2,211,-7,-1,6,-7
720575940624342515,right,Tm2,212,2,-16,-10,-6
720575940623747819,right,Tm2,213,3,-4,-5,1
720575940616192373,right,Tm2,214,-5,3,6,-3
720575940618103835,right,Tm2,216,2,19,7,12
720575940624401671,right,Tm2,217,6,15,1,14
720575940631569572,right,Tm2,218,2,10,3,7
720575940623210008,right,Tm2,219,6,-4,-8,4
720575940634868366,right,Tm2,220,2,-6,-5,-1
720575940615127294,right,Tm2,221,-7,3,8,-5
720575940618068288,right,Tm2,222,-3,26,16,10
720575940622462580,right,Tm2,223,-2,26,15,11
720575940631361017,right,Tm2,224,0,5,2,3
720575940637805289,right,Tm2,225,2,-26,-15,-11
720575940629579769,right,Tm2,226,5,19,4,15
720575940615695289,right,Tm2,227,-7,5,9,-4
720575940636376750,right,Tm2,228,-7,1,7,-6
720575940627976776,right,Tm2,229,5,2,-4,6
720575940634707481,right,Tm2,230,2,9,2,7
720575940623902973,right,Tm2,231,4,-12,-10,-2
720575940613323030,right,Tm2,232,-4,13,10,3
720575940624589035,right,Tm2,233,4,-13,-11,-2
720575940638540989,right,Tm2,234,1,3,0,3
720575940614900882,right,Tm2,235,4,11,1,10
720575940620297638,right,Tm2,236,-1,4,3,1
720575940629672442,right,Tm2,237,-2,27,15,12
720575940609601486,right,Tm2,238,-8,-3,6,-9
720575940618055883,right,Tm2,239,-6,6,9,-3
720575940623653002,right,Tm2,240,-4,-3,2,-5
720575940616836469,right,Tm2,241,2,-17,-11,-6
720575940632659552,right,Tm2,242,-4,6,7,-1
720575940640648280,right,Tm2,243,-1,-21,-10,-11
720575940619282590,right,Tm2,244,-4,-12,-2,-10
720575940616153868,right,Tm2,245,-5,-3,3,-6
720575940627106604,right,Tm2,246,-4,15,11,4
720575940647548036,right,Tm2,247,-4,-15,-4,-11
720575940630460665,right,Tm2,248,-6,0,6,-6
720575940622455977,right,Tm2,249,2,-12,-8,-4
720575940620918256,right,Tm2,250,-1,1,1,0
720575940605097132,right,Tm2,251,-1,-14,-6,-8
720575940620860245,right,Tm2,252,3,23,8,15
720575940618142877,right,Tm2,253,5,16,3,13
720575940611849395,right,Tm2,254,3,-24,-15,-9
720575940647380020,right,Tm2,255,-6,-13,-1,-12
720575940626650792,right,Tm2,256,5,-20,-15,-5
720575940621847139,right,Tm2,257,2,21,8,13
720575940622743551,right,Tm2,258,-4,-17,-5,-12
720575940617594769,right,Tm2,259,-7,-5,4,-9
720575940628930663,right,Tm2,260,-3,19,12,7
720575940633094431,right,Tm2,261,-1,13,7,6
720575940620596017,right,Tm2,262,1,-11,-7,-4
720575940616418233,right,Tm2,263,-3,4,5,-1
720575940604498022,right,Tm2,264,-1,-6,-2,-4
720575940639928117,right,Tm2,265,-6,-1,5,-6
720575940624743399,right,Tm2,266,-1,-25,-12,-13
720575940612247922,right,Tm2,267,-6,2,7,-5
720575940633345700,right,Tm2,268,7,-6,-10,4
720575940627661077,right,Tm2,269,2,-19,-12,-7
720575940632434221,right,Tm2,270,1,-8,-5,-3
720575940609851915,right,Tm2,271,4,6,-1,7
720575940642839092,right,Tm2,272,3,-2,-4,2
720575940618752845,right,Tm2,273,-6,23,17,6
720575940628369680,right,Tm2,274,6,4,-4,8
720575940619470256,right,Tm2,275,-8,-1,7,-8
720575940628779002,right,Tm2,276,2,3,-1,4
720575940641518069,right,Tm2,277,7,-3,-9,6
720575940615970790,right,Tm2,278,-5,10,10,0
720575940623287946,right,Tm2,279,-4,8,8,0
720575940641612507,right,Tm2,280,-6,-14,-1,-13
720575940630743511,right,Tm2,281,-9,2,10,-8
720575940632142904,right,Tm2,282,0,26,13,13
720575940610324885,right,Tm2,283,-4,4,6,-2
720575940640453437,right,Tm2,284,0,25,12,13
720575940645166627,right,Tm2,285,6,-18,-15,-3
720575940624413931,right,Tm2,286,0,-24,-12,-12
720575940622982694,right,Tm2,287,-5,13,11,2
720575940629659727,right,Tm2,288,-1,30,16,14
720575940626148733,right,Tm2,289,-1,11,6,5
720575940645593140,right,Tm2,290,5,-24,-17,-7
720575940632969517,right,Tm2,291,7,2,-6,8
720575940625896935,right,Tm2,292,-4,18,13,5
720575940645209623,right,Tm2,293,4,-17,-13,-4
720575940624930999,right,Tm2,294,1,-20,-11,-9
720575940613454450,right,Tm2,296,1,-18,-10,-8
720575940637504397,right,Tm2,297,7,-9,-12,3
720575940630591532,right,Tm2,298,-5,5,7,-2
720575940627117100,right,Tm2,299,-4,12,10,2
720575940638888262,right,Tm2,300,4,-18,-13,-5
720575940630212601,right,Tm2,301,-5,16,13,3
720575940644196808,right,Tm2,302,2,17,6,11
720575940627043344,right,Tm2,303,-5,22,16,6
720575940619158694,right,Tm2,305,-7,4,9,-5
720575940607182722,right,Tm2,307,5,-25,-18,-7
720575940639226431,right,Tm2,308,-5,8,9,-1
720575940639475517,right,Tm2,309,-6,12,12,0
720575940632441415,right,Tm2,310,2,22,9,13
720575940609799410,right,Tm2,311,-7,15,14,1
720575940627305544,right,Tm2,312,4,-7,-8,1
720575940618759734,right,Tm2,313,7,3,-6,9
720575940635189360,right,Tm2,314,-9,5,11,-6
720575940629121274,right,Tm2,315,-3,-6,0,-6
720575940638636510,right,Tm2,316,5,-4,-7,3
720575940612149617,right,Tm2,317,-5,-4,3,-7
720575940629181187,right,Tm2,318,4,-19,-14,-5
720575940631308648,right,Tm2,319,-2,5,4,1
720575940620077990,right,Tm2,320,-2,-5,-1,-4
720575940633614748,right,Tm2,321,8,4,-6,10
720575940613285886,right,Tm2,322,2,26,11,15
720575940605671852,right,Tm2,323,-7,-13,0,-13
720575940622616396,right,Tm2,324,3,24,9,15
720575940623151649,right,Tm2,325,5,1,-5,6
720575940612727722,right,Tm2,326,2,16,6,10
720575940621147233,right,Tm2,327,5,3,-4,7
720575940628235260,right,Tm2,328,5,-9,-10,1
720575940619708888,right,Tm2,329,0,24,12,12
720575940619970683,right,Tm2,330,3,3,-2,5
720575940619734151,right,Tm2,331,1,-15,-9,-6
720575940609377372,right,Tm2,332,4,-26,-17,-9
720575940609717060,right,Tm2,333,0,-21,-11,-10
720575940622881148,right,Tm2,334,1,-26,-14,-12
720575940623729421,right,Tm2,335,2,8,2,6
720575940615731359,right,Tm2,336,0,23,11,12
720575940615704662,right,Tm2,337,-5,-6,2,-8
720575940632698835,right,Tm2,338,-1,0,1,-1
720575940617456345,right,Tm2,339,6,11,-1,12
720575940618450085,right,Tm2,340,-4,17,12,5
720575940628989483,right,Tm2,341,6,-17,-15,-2
720575940632410159,right,Tm2,342,2,-15,-10,-5
720575940634585975,right,Tm2,343,-3,27,16,11
720575940634199777,right,Tm2,344,-2,-15,-6,-9
720575940628389379,right,Tm2,345,3,-12,-9,-3
720575940639945891,right,Tm2,346,-7,-9,2,-11
720575940622962531,right,Tm2,347,-5,-13,-2,-11
720575940615830228,right,Tm2,348,3,14,4,10
720575940624049147,right,Tm2,349,-5,-14,-2,-12
720575940659895937,right,Tm2,350,1,15,6,9
720575940641534349,right,Tm2,351,-1,-17,-8,-9
720575940634290031,right,Tm2,352,-2,28,16,12
720575940639974744,right,Tm2,353,2,24,10,14
720575940621661936,right,Tm2,354,-2,-26,-11,-15
720575940644881188,right,Tm2,355,-7,-6,4,-10
720575940627321981,right,Tm2,356,0,22,11,11
720575940620633547,right,Tm2,357,4,17,4,13
720575940623420651,right,Tm2,358,-3,17,11,6
720575940616821824,right,Tm2,359,2,23,9,14
720575940621611502,right,Tm2,360,-5,19,14,5
720575940617463382,right,Tm2,361,0,-7,-4,-3
720575940612958614,right,Tm2,362,2,-20,-12,-8
720575940624173063,right,Tm2,363,7,-4,-9,5
720575940621082733,right,Tm2,365,4,7,-1,8
720575940636849070,right,Tm2,366,-5,-20,-5,-15
720575940620583302,right,Tm2,367,-6,-15,-2,-13
720575940624301307,right,Tm2,368,-4,-20,-6,-14
720575940617702208,right,Tm2,369,5,-5,-8,3
720575940628215784,right,Tm2,370,-3,21,13,8
720575940637114509,right,Tm2,371,6,-5,-9,4
720575940633155609,right,Tm2,372,1,-2,-2,0
720575940617433371,right,Tm2,373,1,-21,-12,-9
720575940636828558,right,Tm2,374,2,13,4,9
720575940630122870,right,Tm2,375,-6,7,9,-2
720575940618576541,right,Tm2,376,-7,-10,2,-12
720575940639657013,right,Tm2,377,0,7,3,4
720575940649534841,right,Tm2,378,-3,18,12,6
720575940623216141,right,Tm2,379,3,-17,-12,-5
720575940614527742,right,Tm2,380,-1,29,15,14
720575940622653879,right,Tm2,381,-8,-9,3,-12
720575940625048551,right,Tm2,382,3,-6,-6,0
720575940621489407,right,Tm2,383,-6,11,11,0
720575940620174933,right,Tm2,384,-6,-2,5,-7
720575940627458130,right,Tm2,385,-3,-18,-6,-12
720575940645503876,right,Tm2,386,-6,19,15,4
720575940633325779,right,Tm2,387,-1,-15,-7,-8
720575940627373072,right,Tm2,388,3,19,6,13
720575940646674996,right,Tm2,389,-6,-16,-2,-14
720575940647449652,right,Tm2,390,-6,-9,1,-10
720575940612781549,right,Tm2,391,4,-3,-6,3
720575940625196472,right,Tm2,392,-4,7,7,0
720575940630772342,right,Tm2,393,-1,22,12,10
720575940620724673,right,Tm2,394,-7,-8,3,-11
720575940645367406,right,Tm2,395,0,-22,-11,-11
720575940629104578,right,Tm2,396,-1,10,6,4
720575940619067045,right,Tm2,397,-3,-19,-7,-12
720575940615134895,right,Tm2,398,-3,22,14,8
720575940622098202,right,Tm2,399,-4,-24,-8,-16
720575940625825892,right,Tm2,401,-2,-19,-8,-11
720575940627645205,right,Tm2,402,3,26,10,16
720575940617201553,right,Tm2,403,-2,-12,-4,-8
720575940628482247,right,Tm2,404,-1,20,11,9
720575940659519617,right,Tm2,405,3,10,2,8
720575940605859872,right,Tm2,406,1,-25,-14,-11
720575940622268186,right,Tm2,407,-5,-10,0,-10
720575940629948098,right,Tm2,408,-6,-4,4,-8
720575940621375147,right,Tm2,409,0,-3,-2,-1
720575940605147057,right,Tm2,410,-2,-2,1,-3
720575940625029052,right,Tm2,411,-5,-19,-5,-14
720575940633138074,right,Tm2,412,-6,21,16,5
720575940629517818,right,Tm2,413,-2,-7,-2,-5
720575940639947608,right,Tm2,414,4,21,6,15
720575940613864298,right,Tm2,415,6,12,0,12
720575940603268780,right,Tm2,416,3,-8,-7,-1
720575940618059298,right,Tm2,417,-6,-10,1,-11
720575940629051343,right,Tm2,418,-2,15,9,6
720575940620725926,right,Tm2,419,-3,-11,-3,-8
720575940605674249,right,Tm2,420,6,-3,-8,5
720575940626947130,right,Tm2,421,-1,12,7,5
720575940622441852,right,Tm2,422,-7,-4,5,-9
720575940630742359,right,Tm2,423,3,-18,-12,-6
720575940638057050,right,Tm2,424,-3,-2,2,-4
720575940611151480,right,Tm2,425,3,20,7,13
720575940634588607,right,Tm2,426,-3,0,3,-3
720575940620369543,right,Tm2,427,5,-18,-14,-4
720575940631532303,right,Tm2,428,-2,23,13,10
720575940619066095,right,Tm2,429,-2,14,9,5
720575940640452059,right,Tm2,430,-3,-7,-1,-6
720575940624584743,right,Tm2,431,-2,-10,-3,-7
720575940622619371,right,Tm2,432,-5,7,8,-1
720575940644077984,right,Tm2,433,0,-8,-4,-4
720575940632025939,right,Tm2,434,-3,7,6,1
720575940624578539,right,Tm2,435,5,-17,-14,-3
720575940620578548,right,Tm2,436,0,-15,-8,-7
720575940620520557,right,Tm2,437,-3,12,9,3
720575940624822334,right,Tm2,438,2,27,11,16
720575940626066618,right,Tm2,439,-3,-9,-2,-7
720575940618043732,right,Tm2,440,1,23,10,13
720575940629089067,right,Tm2,441,3,-16,-11,-5
720575940643425646,right,Tm2,442,-5,25,17,8
720575940629182716,right,Tm2,443,-6,4,8,-4
720575940606159793,right,Tm2,444,4,-10,-9,-1
720575940658844545,right,Tm2,445,-2,8,6,2
720575940631003254,right,Tm2,446,2,-14,-9,-5
720575940632164397,right,Tm2,447,-1,2,2,0
720575940623081942,right,Tm2,448,0,30,15,15
720575940646699555,right,Tm2,449,6,-16,-14,-2
720575940651039990,right,Tm2,450,2,-9,-7,-2
720575940647210275,right,Tm2,451,4,20,6,14
720575940630838646,right,Tm2,452,1,-9,-6,-3
720575940615413410,right,Tm2,453,3,25,9,16
720575940629636395,right,Tm2,454,5,-12,-11,-1
720575940633316516,right,Tm2,455,7,-7,-11,4
720575940631966019,right,Tm2,456,0,21,10,11
720575940633355468,right,Tm2,457,-2,17,10,7
720575940620250862,right,Tm2,458,5,0,-5,5
720575940628106752,right,Tm2,459,5,-3,-7,4
720575940622484044,right,Tm2,460,-3,-20,-7,-13
720575940625549464,right,Tm2,461,7,-5,-10,5
720575940617685387,right,Tm2,462,-1,18,10,8
720575940622256141,right,Tm2,463,5,17,3,14
720575940637807156,right,Tm2,464,4,0,-4,4
720575940630316428,right,Tm2,465,3,0,-3,3
720575940612990486,right,Tm2,466,1,14,6,8
720575940618025945,right,Tm2,467,-2,-20,-8,-12
720575940619800199,right,Tm2,468,-3,11,8,3
720575940622314317,right,Tm2,469,-7,13,13,0
720575940623133636,right,Tm2,470,4,-9,-9,0
720575940626620004,right,Tm2,471,3,-26,-16,-10
720575940629343643,right,Tm2,472,1,25,11,14
720575940610278980,right,Tm2,473,-4,23,15,8
720575940621968809,right,Tm2,474,-3,-17,-6,-11
720575940626700474,right,Tm2,475,-4,-1,3,-4
720575940616494651,right,Tm2,476,-1,15,8,7
720575940628818791,right,Tm2,477,-3,2,4,-2
720575940624906340,right,Tm2,478,-7,16,15,1
720575940617360059,right,Tm2,479,-2,10,7,3
720575940623389183,right,Tm2,480,3,-19,-13,-6
720575940627455079,right,Tm2,481,4,-8,-8,0
720575940631531279,right,Tm2,482,1,17,7,10
720575940637534349,right,Tm2,483,2,-7,-6,-1
720575940637534605,right,Tm2,484,3,-9,-8,-1
720575940614999967,right,Tm2,485,-3,-3,1,-4
720575940640527861,right,Tm2,486,0,1,0,1
720575940621792147,right,Tm2,487,1,-1,-2,1
720575940631977785,right,Tm2,488,7,5,-5,10
720575940617246097,right,Tm2,489,-3,10,8,2
720575940623475224,right,Tm2,490,-5,6,8,-2
720575940603314656,right,Tm2,491,7,-1,-8,7
720575940620080774,right,Tm2,492,-7,-2,6,-8
720575940614859426,right,Tm2,493,-3,23,14,9
720575940630551670,right,Tm2,494,0,29,14,15
720575940624840974,right,Tm2,497,6,1,-6,7
720575940617779942,right,Tm2,498,6,10,-1,11
720575940620813515,right,Tm2,499,5,10,0,10
720575940633877985,right,Tm2,500,7,-8,-11,3
720575940622595828,right,Tm2,501,1,2,0,2
720575940625318800,right,Tm2,502,5,8,-1,9
720575940626048787,right,Tm2,503,3,17,5,12
720575940637339625,right,Tm2,504,-2,9,6,3
720575940620324555,right,Tm2,505,6,-22,-17,-5
720575940615354811,right,Tm2,506,1,-12,-7,-5
720575940627932693,right,Tm2,507,-5,-12,-1,-11
720575940644656419,right,Tm2,508,-5,11,10,1
720575940618356273,right,Tm2,509,-4,10,9,1
720575940634215578,right,Tm2,510,-2,11,7,4
720575940619167798,right,Tm2,511,5,-11,-11,0
720575940622588969,right,Tm2,512,6,0,-6,6
720575940622674397,right,Tm2,513,-4,-13,-3,-10
720575940608963849,right,Tm2,514,-4,-10,-1,-9
720575940630457303,right,Tm2,515,-8,-7,4,-11
720575940617009350,right,Tm2,516,7,-18,-16,-2
720575940632271268,right,Tm2,517,6,3,-5,8
720575940606407625,right,Tm2,518,-4,22,15,7
720575940638770109,right,Tm2,519,-5,-5,2,-7
720575940617325780,right,Tm2,520,-2,-22,-9,-13
720575940632435783,right,Tm2,521,6,-9,-11,2
720575940617323035,right,Tm2,522,-4,0,4,-4
720575940616115654,right,Tm2,523,2,14,5,9
720575940630097256,right,Tm2,524,4,-20,-14,-6
720575940612832022,right,Tm2,525,-1,-20,-9,-11
720575940618369209,right,Tm2,526,0,-10,-5,-5
720575940625039880,right,Tm2,527,-4,-8,0,-8
720575940623816388,right,Tm2,528,2,7,1,6
720575940625477001,right,Tm2,529,2,-2,-3,1
720575940629831724,right,Tm2,530,-3,-13,-4,-9
720575940614711080,right,Tm2,531,1,0,-1,1
720575940620048148,right,Tm2,532,-8,7,11,-4
720575940638187497,right,Tm2,533,0,-16,-8,-8
720575940620086789,right,Tm2,534,3,2,-2,4
720575940621324148,right,Tm2,535,8,-4,-10,6
720575940616331195,right,Tm2,536,3,4,-1,5
720575940643893192,right,Tm2,537,0,-23,-12,-11
720575940631426375,right,Tm2,538,-4,1,4,-3
720575940650485238,right,Tm2,539,-6,15,13,2
720575940636716912,right,Tm2,540,-2,-9,-3,-6
720575940622085303,right,Tm2,541,-4,14,11,3
720575940631458252,right,Tm2,542,6,-13,-13,0
720575940619845942,right,Tm2,543,-1,-4,-1,-3
720575940640525171,right,Tm2,544,3,-13,-10,-3
720575940611203282,right,Tm2,545,5,11,0,11
720575940628669739,right,Tm2,546,3,6,0,6
720575940627570309,right,Tm2,547,-1,21,11,10
720575940629784475,right,Tm2,548,1,-16,-9,-7
720575940626740093,right,Tm2,549,0,-9,-5,-4
720575940627874216,right,Tm2,550,-2,3,3,0
720575940629746732,right,Tm2,551,-4,-9,-1,-8
720575940644723748,right,Tm2,552,4,-1,-5,4
720575940627041192,right,Tm2,553,-3,16,11,5
720575940627005739,right,Tm2,554,-9,-3,7,-10
720575940632869004,right,Tm2,555,-4,9,8,1
720575940612843250,right,Tm2,556,0,10,5,5
720575940614611111,right,Tm2,557,6,-10,-11,1
720575940630707474,right,Tm2,558,-4,-21,-7,-14
720575940626520876,right,Tm2,559,-6,22,17,5
720575940618517185,right,Tm2,560,-7,14,14,0
720575940612132977,right,Tm2,561,5,7,-2,9
720575940619971008,right,Tm2,562,-5,-2,4,-6
720575940630277888,right,Tm2,563,5,-13,-12,-1
720575940644945096,right,Tm2,564,3,-23,-15,-8
720575940626781072,right,Tm2,565,0,-26,-13,-13
720575940614481873,right,Tm2,566,5,-8,-9,1
720575940629935226,right,Tm2,567,-2,22,13,9
720575940626349498,right,Tm2,568,-6,-8,2,-10
720575940623701896,right,Tm2,569,6,6,-3,9
720575940633000493,right,Tm2,570,2,25,10,15
720575940618271261,right,Tm2,571,0,-14,-7,-7
720575940638268835,right,Tm2,572,-8,3,9,-6
720575940630868524,right,Tm2,573,4,14,3,11
720575940626735141,right,Tm2,574,-6,5,8,-3
720575940621430900,right,Tm2,575,6,9,-2,11
720575940640230259,right,Tm2,576,0,28,14,14
720575940616182796,right,Tm2,577,5,-14,-12,-2
720575940627058009,right,Tm2,578,4,-11,-10,-1
720575940620625172,right,Tm2,579,-3,-10,-2,-8
720575940627019539,right,Tm2,580,-2,-23,-10,-13
720575940609569493,right,Tm2,581,3,9,1,8
720575940640947152,right,Tm2,582,-1,23,12,11
720575940615743298,right,Tm2,583,3,-25,-16,-9
720575940625067703,right,Tm2,584,4,23,7,16
720575940619338053,right,Tm2,585,-1,-23,-11,-12
720575940633253805,right,Tm2,586,2,18,7,11
720575940612387557,right,Tm2,587,4,22,7,15
720575940611562226,right,Tm2,588,1,4,1,3
720575940628612986,right,Tm2,589,-1,-5,-2,-3
720575940606395266,right,Tm2,590,1,9,3,6
720575940619804912,right,Tm2,591,3,-3,-5,2
720575940621223789,right,Tm2,592,3,-28,-17,-11
720575940626886159,right,Tm2,593,3,-14,-10,-4
720575940619438063,right,Tm2,594,7,-16,-15,-1
720575940643615086,right,Tm2,595,7,-12,-13,1
720575940638132964,right,Tm2,596,-4,-16,-4,-12
720575940641659956,right,Tm2,597,4,1,-4,5
720575940627056625,right,Tm2,598,2,-18,-11,-7
720575940631721490,right,Tm2,599,-1,9,5,4
720575940618526365,right,Tm2,600,3,-10,-8,-2
720575940623197976,right,Tm2,601,1,16,7,9
720575940617843229,right,Tm2,602,4,-2,-5,3
720575940621044304,right,Tm2,603,-3,-23,-9,-14
720575940614409634,right,Tm2,604,-6,-17,-3,-14
720575940635170495,right,Tm2,605,3,15,4,11
720575940608964565,right,Tm2,606,-1,-19,-9,-10
720575940640077400,right,Tm2,607,1,18,8,10
720575940619894875,right,Tm2,608,1,10,4,6
720575940627709775,right,Tm2,609,-2,0,2,-2
720575940625661840,right,Tm2,610,2,-23,-14,-9
720575940624692372,right,Tm2,611,-1,-18,-8,-10
720575940611642830,right,Tm2,612,-3,-26,-10,-16
720575940614695029,right,Tm2,613,-8,-4,6,-10
720575940620189888,right,Tm2,614,-2,-8,-2,-6
720575940630418743,right,Tm2,615,-7,-7,3,-10
720575940628972647,right,Tm2,616,-3,15,10,5
720575940620730350,right,Tm2,617,-2,-17,-7,-10
720575940644137416,right,Tm2,618,-1,24,13,11
720575940611131746,right,Tm2,619,-4,-19,-6,-13
720575940631213561,right,Tm2,620,7,1,-7,8
720575940625164327,right,Tm2,621,1,24,11,13
720575940632525534,right,Tm2,622,-5,20,15,5
720575940625041127,right,Tm2,623,1,13,5,8
720575940618531611,right,Tm2,624,1,-17,-10,-7
720575940619873752,right,Tm2,625,-2,24,14,10
720575940629943353,right,Tm2,626,-5,-8,1,-9
720575940631563857,right,Tm2,627,0,-1,-1,0
720575940626468233,right,Tm2,628,0,0,0,0
720575940638132799,right,Tm2,629,4,24,8,16
720575940621118886,right,Tm2,630,4,8,0,8
720575940624518408,right,Tm2,631,1,26,12,14
720575940633894937,right,Tm2,632,3,-20,-13,-7
720575940613572522,right,Tm2,633,-1,-24,-11,-13
720575940631821160,right,Tm2,634,-3,-15,-5,-10
720575940646987396,right,Tm2,635,6,-6,-9,3
720575940632829836,right,Tm2,636,0,6,3,3
720575940612768665,right,Tm2,637,3,-21,-14,-7
720575940633683610,right,Tm2,638,-1,7,4,3
720575940608516107,right,Tm2,639,-4,19,13,6
720575940624693652,right,Tm2,640,-1,-16,-7,-9
720575940625619556,right,Tm2,641,-8,-5,5,-10
720575940624405482,right,Tm2,642,-5,-11,-1,-10
720575940630514769,right,Tm2,643,6,14,1,13
720575940626854735,right,Tm2,644,-6,18,15,3
720575940629125123,right,Tm2,645,-4,27,17,10
720575940612543254,right,Tm2,646,6,17,2,15
720575940625188796,right,Tm2,647,-4,-7,0,-7
720575940621704268,right,Tm2,649,-1,5,3,2
720575940623918591,right,Tm2,650,-3,-25,-10,-15
720575940633473761,right,Tm2,651,-4,-5,1,-6
720575940603495648,right,Tm2,652,-6,-11,0,-11
720575940624689812,right,Tm2,653,-6,-12,0,-12
720575940631396664,right,Tm2,654,-3,8,7,1
720575940630108984,right,Tm2,655,6,-1,-7,6
720575940647731764,right,Tm2,656,0,-11,-6,-5
720575940626146853,right,Tm2,657,-2,-25,-11,-14
720575940617670073,right,Tm2,658,1,20,9,11
720575940637932451,right,Tm2,659,-4,-6,1,-7
720575940634026451,right,Tm2,660,2,28,12,16
720575940627112492,right,Tm2,661,-3,14,10,4
720575940638551860,right,Tm2,662,2,-1,-3,2
720575940605315262,right,Tm2,663,0,8,4,4
720575940628122620,right,Tm2,664,1,-27,-15,-12
720575940618611781,right,Tm2,665,7,-2,-8,6
720575940629912567,right,Tm2,666,7,-13,-14,1
720575940624966414,right,Tm2,667,1,-28,-15,-13
720575940625333292,right,Tm2,668,1,19,8,11
720575940632537681,right,Tm2,669,4,-16,-12,-4
720575940627450962,right,Tm2,671,-4,-23,-8,-15
720575940638138019,right,Tm2,672,-8,11,13,-2
720575940623095748,right,Tm2,674,-4,-14,-3,-11
720575940619379553,right,Tm2,675,-7,19,16,3
720575940608745685,right,Tm2,676,-3,-21,-8,-13
720575940636711310,right,Tm2,677,0,11,5,6
720575940638887750,right,Tm2,678,3,-7,-7,0
720575940618191453,right,Tm2,679,4,18,5,13
720575940630308663,right,Tm2,680,-1,25,13,12
720575940628716795,right,Tm2,681,-2,-21,-9,-12
720575940632888377,right,Tm2,682,6,-8,-10,2
720575940625381449,right,Tm2,683,2,6,1,5
720575940626354193,right,Tm2,684,-6,17,14,3
720575940623151128,right,Tm2,685,-5,-9,0,-9
720575940625375731,right,Tm2,686,5,-22,-16,-6
720575940632897491,right,Tm2,687,-6,-3,4,-7
720575940624087187,right,Tm2,688,-7,10,12,-2
720575940626315052,right,Tm2,689,-2,18,11,7
720575940636818574,right,Tm2,690,-7,-3,5,-8
720575940603893280,right,Tm2,691,-9,4,11,-7
720575940640073816,right,Tm2,692,-4,24,16,8
720575940616912214,right,Tm2,693,-3,25,15,10
720575940626997292,right,Tm2,695,-6,10,11,-1
720575940617667284,right,Tm2,696,-2,16,10,6
720575940621268672,right,Tm2,697,1,-22,-12,-10
720575940626746140,right,Tm2,698,6,-7,-10,3
720575940612291281,right,Tm2,699,-5,0,5,-5
720575940612738010,right,Tm2,700,5,15,2,13
720575940614459390,right,Tm2,701,0,-4,-2,-2
720575940633210975,right,Tm2,702,-5,23,16,7
720575940606011570,right,Tm2,703,-3,1,3,-2
720575940626671633,right,Tm2,704,-7,8,11,-3
720575940626653194,right,Tm2,705,1,1,-1,2
720575940645210391,right,Tm2,707,-2,25,14,11
720575940643775392,right,Tm2,708,-4,-25,-9,-16
720575940636268407,right,Tm2,709,-2,-24,-10,-14
720575940629525498,right,Tm2,710,4,-25,-17,-8
720575940620050123,right,Tm2,711,-1,19,10,9
720575940616320822,right,Tm2,712,-7,12,13,-1
720575940630469740,right,Tm2,713,-6,16,14,2
720575940641497589,right,Tm2,714,5,12,1,11
720575940620069848,right,Tm2,715,4,10,1,9
720575940620533720,right,Tm2,716,4,-6,-7,1
720575940623693962,right,Tm2,717,2,-22,-13,-9
720575940630306924,right,Tm2,718,-5,24,17,7
720575940629976395,right,Tm2,719,1,27,12,15
720575940626901036,right,Tm2,720,-5,21,15,6
720575940627176695,right,Tm2,721,5,13,1,12
720575940621065665,right,Tm2,722,6,-15,-14,-1
720575940610832602,right,Tm2,723,-2,-11,-4,-7
720575940625594189,right,Tm2,724,4,2,-3,5
720575940638217279,right,Tm2,725,-3,-24,-9,-15
720575940618159833,right,Tm2,726,2,-28,-16,-12
720575940628349178,right,Tm2,727,7,6,-4,10
720575940625573936,right,Tm2,728,7,12,-1,13
720575940614717165,right,Tm2,729,-3,29,17,12
720575940633703393,right,Tm2,730,7,0,-7,7
720575940626349767,right,Tm2,731,-6,9,10,-1
720575940619636756,right,Tm2,732,-3,6,6,0
720575940619056037,right,Tm2,733,-5,-17,-4,-13
720575940630695243,right,Tm2,734,2,0,-2,2
720575940626131237,right,Tm2,735,1,-23,-13,-10
720575940633215327,right,Tm2,736,-8,1,8,-7
720575940611434133,right,Tm2,737,0,19,9,10
720575940623765518,right,Tm2,738,-3,13,9,4
720575940623532873,right,Tm2,739,-7,2,8,-6
720575940631372684,right,Tm2,740,2,-8,-6,-2
720575940645437806,right,Tm2,741,-2,-14,-5,-9
720575940627118892,right,Tm2,742,-4,11,9,2
720575940633946137,right,Tm2,743,6,-19,-16,-3
720575940621538036,right,Tm2,744,-4,25,16,9
720575940613646146,right,Tm2,745,0,13,6,7
720575940624327868,right,Tm2,746,-3,3,4,-1
720575940624537608,right,Tm2,747,0,2,1,1
720575940609328226,right,Tm2,748,-4,20,14,6
720575940611580074,right,Tm2,749,-2,1,2,-1
720575940622403819,right,Tm2,750,4,-24,-16,-8
720575940621344902,right,Tm2,751,1,6,2,4
720575940630775511,right,Tm2,752,-2,7,5,2
720575940621178221,right,Tm2,753,-3,24,15,9
720575940631528495,right,Tm2,754,-1,-13,-6,-7
720575940630086204,right,Tm2,755,4,19,5,14
720575940635635823,right,Tm2,757,0,-6,-3,-3
720575940625153267,right,Tm2,758,5,-1,-6,5
720575940626900376,right,Tm2,759,7,14,0,14
720575940605438398,right,Tm2,760,0,17,8,9
720575940617916450,right,Tm2,761,-4,-18,-5,-13
720575940616843293,right,Tm2,762,0,14,7,7
720575940628809723,right,Tm2,763,-5,14,12,2
720575940623966090,right,Tm2,764,-8,-6,5,-11
720575940630949391,right,Tm2,765,-3,9,7,2
720575940629828864,right,Tm2,766,2,-4,-4,0
720575940621868276,right,Tm2,767,1,28,13,15
720575940627956605,right,Tm2,772,1,12,5,7
720575940620850567,right,Tm2,773,5,-19,-15,-4
720575940628963279,right,Tm2,774,-8,6,11,-5
720575940626284034,right,Tm2,775,5,22,6,16
720575940615045226,right,Tm2,776,5,21,5,16
720575940623757582,right,Tm2,777,6,20,4,16
720575940604734641,right,Tm2,778,4,25,8,17
720575940640867968,right,Tm2,779,5,24,7,17
720575940632569155,right,Tm2,780,-6,25,18,7
720575940625120812,right,Tm2,781,-5,26,18,8
720575940641322485,right,Tm2,782,-5,27,18,9
720575940611161646,right,Tm2,783,-4,28,18,10
720575940616164767,right,Tm2,786,-2,30,17,13
720575940629479323,right,Tm2,787,3,28,11,17
720575940632789933,right,Tm2,790,-2,-27,-12,-15
720575940627658066,right,Tm2,792,8,2,-7,9
720575940615836428,right,Tm2,793,8,-6,-11,5
720575940632458282,right,Tm2,794,5,-26,-18,-8
720575940630327772,right,Tm2,795,6,-21,-17,-4
720575940622380293,right,Tm2,796,4,26,9,17
720575940636043127,right,Tm20,1,-6,13,12,1
720575940628230659,right,Tm20,2,-8,2,9,-7
720575940622996504,right,Tm20,3,6,-12,-12,0
720575940612553957,right,Tm20,4,-5,-21,-6,-15
720575940620156551,right,Tm20,5,-1,16,9,7
720575940627594236,right,Tm20,6,-2,-4,0,-4
720575940621790555,right,Tm20,7,-6,-6,3,-9
720575940608403651,right,Tm20,8,-4,26,17,9
720575940619526198,right,Tm20,9,4,9,0,9
720575940625994515,right,Tm20,10,5,-15,-13,-2
720575940628038376,right,Tm20,11,7,-14,-14,0
720575940627542018,right,Tm20,12,-7,9,11,-2
720575940609719509,right,Tm20,13,-1,-26,-12,-14
720575940612825241,right,Tm20,14,0,-27,-14,-13
720575940638864829,right,Tm20,15,2,-3,-4,1
720575940630311954,right,Tm20,16,-2,-16,-6,-10
720575940645266542,right,Tm20,17,1,-5,-4,-1
720575940630683961,right,Tm20,18,5,-16,-13,-3
720575940619729648,right,Tm20,19,-7,17,15,2
720575940617577019,right,Tm20,20,3,-11,-9,-2
720575940631558483,right,Tm20,21,-2,19,11,8
720575940638210613,right,Tm20,22,-1,3,2,1
720575940615644066,right,Tm20,23,-3,-16,-5,-11
720575940620312779,right,Tm20,24,-1,-10,-4,-6
720575940620849078,right,Tm20,25,-9,3,10,-7
720575940621255521,right,Tm20,26,1,-3,-3,0
720575940625798076,right,Tm20,27,0,-25,-13,-12
720575940621333231,right,Tm20,28,5,6,-2,8
720575940649191289,right,Tm20,29,-1,-3,-1,-2
720575940632358030,right,Tm20,30,6,16,2,14
720575940625838128,right,Tm20,31,0,16,8,8
720575940633598689,right,Tm20,32,0,12,6,6
720575940633247652,right,Tm20,33,3,18,6,12
720575940644356296,right,Tm20,34,6,18,3,15
720575940614854952,right,Tm20,35,1,-24,-13,-11
720575940646263860,right,Tm20,36,6,8,-2,10
720575940624523411,right,Tm20,37,1,5,1,4
720575940631956051,right,Tm20,38,0,-2,-1,-1
720575940628492806,right,Tm20,39,0,20,10,10
720575940643576736,right,Tm20,40,-2,-6,-1,-5
720575940611481954,right,Tm20,41,-3,28,17,11
720575940613389795,right,Tm20,42,-1,14,8,6
720575940621725587,right,Tm20,43,-5,18,14,4
720575940629600335,right,Tm20,44,5,-10,-10,0
720575940632704047,right,Tm20,45,-5,-1,4,-5
720575940617875869,right,Tm20,46,-5,15,12,3
720575940629794616,right,Tm20,47,-9,-1,8,-9
720575940630281527,right,Tm20,48,-4,-22,-7,-15
720575940638199615,right,Tm20,49,4,-4,-6,2
720575940630741468,right,Tm20,50,-2,21,12,9
720575940617823355,right,Tm20,51,0,-19,-10,-9
720575940624291657,right,Tm20,52,-1,-22,-10,-12
720575940632915503,right,Tm20,53,5,14,2,12
720575940617525204,right,Tm20,54,-4,3,5,-2
720575940630881420,right,Tm20,55,-4,-11,-2,-9
720575940626806672,right,Tm20,56,1,-13,-8,-5
720575940635090201,right,Tm20,57,6,-11,-12,1
720575940608616149,right,Tm20,58,3,12,3,9
720575940621536609,right,Tm20,59,-2,2,3,-1
720575940625311124,right,Tm20,60,-8,8,12,-4
720575940627312773,right,Tm20,61,-4,-4,2,-6
720575940609069251,right,Tm20,63,4,12,2,10
720575940622181756,right,Tm20,64,4,-23,-16,-7
720575940637800245,right,Tm20,65,-1,28,15,13
720575940624837671,right,Tm20,66,2,15,5,10
720575940639237173,right,Tm20,67,-2,-13,-5,-8
720575940611999385,right,Tm20,68,3,16,5,11
720575940605952433,right,Tm20,70,-4,21,14,7
720575940617399809,right,Tm20,71,-2,-3,0,-3
720575940646844451,right,Tm20,72,0,-28,-14,-14
720575940629074170,right,Tm20,73,2,2,-1,3
720575940625456461,right,Tm20,74,-1,-9,-4,-5
720575940630250087,right,Tm20,75,-6,14,13,1
720575940621119414,right,Tm20,76,-3,-4,1,-5
720575940626174553,right,Tm20,77,2,-5,-5,0
720575940617283217,right,Tm20,78,2,20,8,12
720575940645548852,right,Tm20,79,2,1,-2,3
720575940630196480,right,Tm20,80,4,13,2,11
720575940624443912,right,Tm20,81,6,-2,-7,5
720575940631734840,right,Tm20,82,-7,7,10,-3
720575940624936974,right,Tm20,83,2,-21,-13,-8
720575940617604564,right,Tm20,84,-2,12,8,4
720575940626099493,right,Tm20,85,4,-22,-15,-7
720575940618588075,right,Tm20,86,-5,-7,1,-8
720575940649804153,right,Tm20,87,1,11,4,7
720575940612810905,right,Tm20,89,1,-19,-11,-8
720575940632059192,right,Tm20,90,-4,5,6,-1
720575940622429168,right,Tm20,91,-1,6,4,2
720575940624186153,right,Tm20,92,0,9,4,5
720575940612761598,right,Tm20,93,-6,3,7,-4
720575940631939395,right,Tm20,94,5,18,4,14
720575940617618388,right,Tm20,95,4,-21,-15,-6
720575940623485142,right,Tm20,96,1,-10,-6,-4
720575940629314754,right,Tm20,97,-5,2,6,-4
720575940628696838,right,Tm20,98,-1,-12,-5,-7
720575940614424062,right,Tm20,99,4,15,3,12
720575940650017401,right,Tm20,100,2,-10,-7,-3
720575940613475537,right,Tm20,101,-7,6,10,-4
720575940633623853,right,Tm20,102,3,13,3,10
720575940636685198,right,Tm20,103,7,9,-3,12
720575940616565958,right,Tm20,104,-1,-27,-13,-14
720575940623017221,right,Tm20,105,3,22,8,14
720575940631645836,right,Tm20,106,-7,11,12,-1
720575940612420338,right,Tm20,107,8,-2,-9,7
720575940626640539,right,Tm20,108,-3,-12,-3,-9
720575940633727059,right,Tm20,109,4,-5,-7,2
720575940626783687,right,Tm20,110,-7,0,7,-7
720575940633878623,right,Tm20,111,2,-24,-14,-10
720575940621522598,right,Tm20,112,-6,1,6,-5
720575940625461735,right,Tm20,113,-2,4,4,0
720575940606839218,right,Tm20,114,2,-13,-9,-4
720575940626877061,right,Tm20,115,-4,2,5,-3
720575940632389480,right,Tm20,116,-1,-8,-3,-5
720575940641742581,right,Tm20,117,-8,-2,7,-9
720575940637730394,right,Tm20,118,3,1,-3,4
720575940619661141,right,Tm20,119,-2,6,5,1
720575940614208977,right,Tm20,120,-1,-1,0,-1
720575940618242102,right,Tm20,121,-8,4,10,-6
720575940617276372,right,Tm20,122,-5,9,9,0
720575940634794138,right,Tm20,123,-8,10,13,-3
720575940644287524,right,Tm20,124,1,-7,-5,-2
720575940627635837,right,Tm20,125,5,9,-1,10
720575940605026784,right,Tm20,126,3,11,2,9
720575940625621808,right,Tm20,127,0,15,7,8
720575940638449380,right,Tm20,128,3,-22,-14,-8
720575940621639339,right,Tm20,129,0,-13,-7,-6
720575940621189473,right,Tm20,130,2,12,4,8
720575940612332494,right,Tm20,131,-6,20,16,4
720575940613215697,right,Tm20,133,-3,20,13,7
720575940623207688,right,Tm20,134,-5,-18,-4,-14
720575940628690179,right,Tm20,135,-3,-22,-8,-14
720575940620414912,right,Tm20,138,0,27,13,14
720575940609623049,right,Tm20,139,1,-14,-8,-6
720575940611588194,right,Tm20,141,5,-23,-17,-6
720575940621197132,right,Tm20,142,-2,-18,-7,-11
720575940609706820,right,Tm20,143,-4,16,12,4
720575940633719716,right,Tm20,144,7,-11,-13,2
720575940647759748,right,Tm20,145,0,4,2,2
720575940620037205,right,Tm20,146,1,-6,-4,-2
720575940623332232,right,Tm20,147,1,21,9,12
720575940618685268,right,Tm20,148,-7,-11,1,-12
720575940639472984,right,Tm20,149,6,-14,-13,-1
720575940621086452,right,Tm20,150,-8,5,10,-5
720575940627721295,right,Tm20,151,-3,-14,-4,-10
720575940619921232,right,Tm20,152,3,-15,-11,-4
720575940637016206,right,Tm20,153,8,0,-8,8
720575940627526140,right,Tm20,154,-8,0,8,-8
720575940628225847,right,Tm20,155,-8,13,14,-1
720575940603809452,right,Tm20,156,-9,1,9,-8
720575940628781111,right,Tm20,157,-1,-7,-3,-4
720575940627777297,right,Tm20,158,3,-5,-6,1
720575940628596739,right,Tm20,160,-2,20,12,8
720575940612957747,right,Tm20,161,4,-14,-11,-3
720575940620250759,right,Tm20,162,-4,-2,3,-5
720575940632389432,right,Tm20,164,-1,-2,0,-2
720575940626250384,right,Tm20,165,4,16,4,12
720575940614973115,right,Tm20,166,0,18,9,9
720575940620191508,right,Tm20,167,0,-17,-9,-8
720575940621908506,right,Tm20,168,-1,17,9,8
720575940617207645,right,Tm20,169,0,-18,-9,-9
720575940628392859,right,Tm20,170,-5,1,5,-4
720575940608683100,right,Tm20,171,6,-20,-16,-4
720575940609239305,right,Tm20,172,1,22,10,12
720575940617259893,right,Tm20,173,2,-25,-15,-10
720575940613884847,right,Tm20,174,4,-15,-12,-3
720575940615820703,right,Tm20,175,-6,-7,2,-9
720575940615161297,right,Tm20,176,-2,13,8,5
720575940625388365,right,Tm20,177,-2,-1,1,-2
720575940628725009,right,Tm20,178,2,11,3,8
720575940611370286,right,Tm20,179,-5,-16,-3,-13
720575940624400823,right,Tm20,180,2,-27,-16,-11
720575940631426297,right,Tm20,181,1,-4,-3,-1
720575940622430284,right,Tm20,182,7,-10,-12,2
720575940613740072,right,Tm20,183,-5,-15,-3,-12
720575940631741507,right,Tm20,184,-6,-5,3,-8
720575940616559519,right,Tm20,185,2,-11,-8,-3
720575940633490830,right,Tm20,186,-1,26,14,12
720575940628145064,right,Tm20,187,3,21,7,14
720575940626138314,right,Tm20,188,-5,17,13,4
720575940627762965,right,Tm20,189,6,13,0,13
720575940617790491,right,Tm20,190,-3,-5,0,-5
720575940637371493,right,Tm20,191,-1,-11,-5,-6
720575940624498869,right,Tm20,192,7,10,-2,12
720575940623972791,right,Tm20,193,-5,4,7,-3
720575940624362424,right,Tm20,194,0,-5,-3,-2
720575940622900265,right,Tm20,195,-3,-1,2,-3
720575940609096971,right,Tm20,196,-1,8,5,3
720575940639385397,right,Tm20,197,0,-20,-10,-10
720575940624101158,right,Tm20,198,6,2,-5,7
720575940636741231,right,Tm20,199,0,-12,-6,-6
720575940612986902,right,Tm20,200,-5,12,11,1
720575940619717942,right,Tm20,201,-8,9,12,-3
720575940636783790,right,Tm20,202,-1,27,14,13
720575940636554462,right,Tm20,203,3,-1,-4,3
720575940626891522,right,Tm20,204,5,-2,-6,4
720575940635666356,right,Tm20,205,5,-6,-8,2
720575940625577060,right,Tm20,206,-3,5,5,0
720575940635582399,right,Tm20,207,1,29,13,16
720575940624947207,right,Tm20,208,5,-21,-16,-5
720575940637937385,right,Tm20,209,-3,-8,-1,-7
720575940605293698,right,Tm20,210,-6,8,10,-2
720575940624762004,right,Tm20,211,-7,-1,6,-7
720575940613985576,right,Tm20,212,2,-16,-10,-6
720575940653550753,right,Tm20,213,3,-4,-5,1
720575940630379562,right,Tm20,214,-5,3,6,-3
720575940619432920,right,Tm20,216,2,19,7,12
720575940619060638,right,Tm20,217,6,15,1,14
720575940619640280,right,Tm20,218,2,10,3,7
720575940620814575,right,Tm20,219,6,-4,-8,4
720575940624446647,right,Tm20,220,2,-6,-5,-1
720575940627793482,right,Tm20,221,-7,3,8,-5
720575940631573037,right,Tm20,222,-3,26,16,10
720575940609570168,right,Tm20,223,-2,26,15,11
720575940608686684,right,Tm20,224,0,5,2,3
720575940625916965,right,Tm20,225,2,-26,-15,-11
720575940614876583,right,Tm20,226,5,19,4,15
720575940606855177,right,Tm20,227,-7,5,9,-4
720575940614987059,right,Tm20,228,-7,1,7,-6
720575940621382638,right,Tm20,229,5,2,-4,6
720575940621683078,right,Tm20,230,2,9,2,7
720575940634997695,right,Tm20,231,4,-12,-10,-2
720575940633916814,right,Tm20,232,-4,13,10,3
720575940614653950,right,Tm20,233,4,-13,-11,-2
720575940627671177,right,Tm20,235,4,11,1,10
720575940606915714,right,Tm20,236,-1,4,3,1
720575940625947173,right,Tm20,237,-2,27,15,12
720575940621135621,right,Tm20,238,-8,-3,6,-9
720575940617857025,right,Tm20,239,-6,6,9,-3
720575940637084271,right,Tm20,240,-4,-3,2,-5
720575940605454025,right,Tm20,241,2,-17,-11,-6
720575940636723118,right,Tm20,242,-4,6,7,-1
720575940627321118,right,Tm20,243,-1,-21,-10,-11
720575940614048749,right,Tm20,244,-4,-12,-2,-10
720575940624301287,right,Tm20,245,-5,-3,3,-6
720575940624354121,right,Tm20,246,-4,15,11,4
720575940623505348,right,Tm20,247,-4,-15,-4,-11
720575940616903451,right,Tm20,248,-6,0,6,-6
720575940637608846,right,Tm20,249,2,-12,-8,-4
720575940629766403,right,Tm20,250,-1,1,1,0
720575940624715244,right,Tm20,251,-1,-14,-6,-8
720575940629966380,right,Tm20,252,3,23,8,15
720575940614826130,right,Tm20,253,5,16,3,13
720575940629976594,right,Tm20,254,3,-24,-15,-9
720575940612566954,right,Tm20,255,-6,-13,-1,-12
720575940631236347,right,Tm20,256,5,-20,-15,-5
720575940607258891,right,Tm20,257,2,21,8,13
720575940624702727,right,Tm20,258,-4,-17,-5,-12
720575940635528184,right,Tm20,259,-7,-5,4,-9
720575940612832749,right,Tm20,260,-3,19,12,7
720575940630499831,right,Tm20,261,-1,13,7,6
720575940620910928,right,Tm20,262,1,-11,-7,-4
720575940631475287,right,Tm20,263,-3,4,5,-1
720575940636024687,right,Tm20,264,-1,-6,-2,-4
720575940606790834,right,Tm20,265,-6,-1,5,-6
720575940644104352,right,Tm20,266,-1,-25,-12,-13
720575940628320811,right,Tm20,267,-6,2,7,-5
720575940641254452,right,Tm20,268,7,-6,-10,4
720575940610914258,right,Tm20,269,2,-19,-12,-7
720575940611658482,right,Tm20,270,1,-8,-5,-3
720575940611545902,right,Tm20,271,4,6,-1,7
720575940619690968,right,Tm20,272,3,-2,-4,2
720575940637830709,right,Tm20,273,-6,23,17,6
720575940632258786,right,Tm20,275,-8,-1,7,-8
720575940624019637,right,Tm20,276,2,3,-1,4
720575940618645589,right,Tm20,277,7,-3,-9,6
720575940624066539,right,Tm20,278,-5,10,10,0
720575940623401962,right,Tm20,279,-4,8,8,0
720575940627397223,right,Tm20,281,-9,2,10,-8
720575940616984518,right,Tm20,282,0,26,13,13
720575940627146042,right,Tm20,283,-4,4,6,-2
720575940619105053,right,Tm20,284,0,25,12,13
720575940622139076,right,Tm20,285,6,-18,-15,-3
720575940638687814,right,Tm20,286,0,-24,-12,-12
720575940619234496,right,Tm20,287,-5,13,11,2
720575940638774086,right,Tm20,288,-1,30,16,14
720575940613131890,right,Tm20,290,5,-24,-17,-7
720575940626898072,right,Tm20,291,7,2,-6,8
720575940630687483,right,Tm20,292,-4,18,13,5
720575940623510221,right,Tm20,293,4,-17,-13,-4
720575940632611399,right,Tm20,294,1,-20,-11,-9
720575940614556822,right,Tm20,295,-2,29,16,13
720575940626237584,right,Tm20,296,1,-18,-10,-8
720575940628206023,right,Tm20,297,7,-9,-12,3
720575940611258670,right,Tm20,298,-5,5,7,-2
720575940633888910,right,Tm20,299,-4,12,10,2
720575940607332226,right,Tm20,300,4,-18,-13,-5
720575940627539755,right,Tm20,301,-5,16,13,3
720575940632786124,right,Tm20,302,2,17,6,11
720575940616167837,right,Tm20,303,-5,22,16,6
720575940621213936,right,Tm20,305,-7,4,9,-5
720575940624362749,right,Tm20,306,3,7,0,7
720575940635598443,right,Tm20,307,5,-25,-18,-7
720575940624084203,right,Tm20,308,-5,8,9,-1
720575940626981962,right,Tm20,309,-6,12,12,0
720575940623309960,right,Tm20,310,2,22,9,13
720575940623354348,right,Tm20,311,-7,15,14,1
720575940625934896,right,Tm20,312,4,-7,-8,1
720575940631169551,right,Tm20,313,7,3,-6,9
720575940626280344,right,Tm20,314,-9,5,11,-6
720575940625963085,right,Tm20,315,-3,-6,0,-6
720575940623491476,right,Tm20,316,5,-4,-7,3
720575940621383558,right,Tm20,317,-5,-4,3,-7
720575940630807503,right,Tm20,318,4,-19,-14,-5
720575940624422141,right,Tm20,319,-2,5,4,1
720575940618025629,right,Tm20,320,-2,-5,-1,-4
720575940638491224,right,Tm20,321,8,4,-6,10
720575940624722615,right,Tm20,322,2,26,11,15
720575940626223934,right,Tm20,323,-7,-13,0,-13
720575940635308479,right,Tm20,324,3,24,9,15
720575940647935540,right,Tm20,326,2,16,6,10
720575940614166690,right,Tm20,328,5,-9,-10,1
720575940644576804,right,Tm20,329,0,24,12,12
720575940627522898,right,Tm20,330,3,3,-2,5
720575940605225900,right,Tm20,331,1,-15,-9,-6
720575940629662311,right,Tm20,332,4,-26,-17,-9
720575940623588829,right,Tm20,333,0,-21,-11,-10
720575940628540904,right,Tm20,334,1,-26,-14,-12
720575940630764283,right,Tm20,336,0,23,11,12
720575940626271674,right,Tm20,337,-5,-6,2,-8
720575940617051682,right,Tm20,338,-1,0,1,-1
720575940627591503,right,Tm20,339,6,11,-1,12
720575940631849576,right,Tm20,340,-4,17,12,5
720575940613919784,right,Tm20,341,6,-17,-15,-2
720575940622073093,right,Tm20,342,2,-15,-10,-5
720575940605678270,right,Tm20,343,-3,27,16,11
720575940619505243,right,Tm20,344,-2,-15,-6,-9
720575940629077447,right,Tm20,345,3,-12,-9,-3
720575940630584313,right,Tm20,346,-7,-9,2,-11
720575940626195006,right,Tm20,347,-5,-13,-2,-11
720575940604892640,right,Tm20,348,3,14,4,10
720575940622485887,right,Tm20,349,-5,-14,-2,-12
720575940624623804,right,Tm20,350,1,15,6,9
720575940620875373,right,Tm20,351,-1,-17,-8,-9
720575940631298245,right,Tm20,352,-2,28,16,12
720575940629611002,right,Tm20,353,2,24,10,14
720575940627986821,right,Tm20,354,-2,-26,-11,-15
720575940628813571,right,Tm20,355,-7,-6,4,-10
720575940619859915,right,Tm20,356,0,22,11,11
720575940618016925,right,Tm20,357,4,17,4,13
720575940621437249,right,Tm20,358,-3,17,11,6
720575940622936346,right,Tm20,359,2,23,9,14
720575940626208714,right,Tm20,360,-5,19,14,5
720575940622596777,right,Tm20,361,0,-7,-4,-3
720575940612846643,right,Tm20,362,2,-20,-12,-8
720575940616334011,right,Tm20,363,7,-4,-9,5
720575940634678112,right,Tm20,365,4,7,-1,8
720575940646811444,right,Tm20,368,-4,-20,-6,-14
720575940628965873,right,Tm20,369,5,-5,-8,3
720575940628729360,right,Tm20,370,-3,21,13,8
720575940617594146,right,Tm20,371,6,-5,-9,4
720575940619006366,right,Tm20,372,1,-2,-2,0
720575940647457412,right,Tm20,373,1,-21,-12,-9
720575940631505739,right,Tm20,374,2,13,4,9
720575940614318754,right,Tm20,375,-6,7,9,-2
720575940622631351,right,Tm20,376,-7,-10,2,-12
720575940619160405,right,Tm20,377,0,7,3,4
720575940620866657,right,Tm20,378,-3,18,12,6
720575940624353065,right,Tm20,379,3,-17,-12,-5
720575940621217670,right,Tm20,380,-1,29,15,14
720575940627764105,right,Tm20,382,3,-6,-6,0
720575940630184234,right,Tm20,383,-6,11,11,0
720575940608816067,right,Tm20,384,-6,-2,5,-7
720575940628598633,right,Tm20,385,-3,-18,-6,-12
720575940627287890,right,Tm20,386,-6,19,15,4
720575940633612205,right,Tm20,387,-1,-15,-7,-8
720575940616161241,right,Tm20,388,3,19,6,13
720575940624697748,right,Tm20,389,-6,-16,-2,-14
720575940617411933,right,Tm20,390,-6,-9,1,-10
720575940612743410,right,Tm20,391,4,-3,-6,3
720575940627754492,right,Tm20,392,-4,7,7,0
720575940637352293,right,Tm20,393,-1,22,12,10
720575940644586400,right,Tm20,394,-7,-8,3,-11
720575940617575541,right,Tm20,395,0,-22,-11,-11
720575940614844603,right,Tm20,397,-3,-19,-7,-12
720575940610718869,right,Tm20,398,-3,22,14,8
720575940617269846,right,Tm20,400,1,-29,-16,-13
720575940619880395,right,Tm20,401,-2,-19,-8,-11
720575940616143922,right,Tm20,402,3,26,10,16
720575940620153536,right,Tm20,403,-2,-12,-4,-8
720575940638637894,right,Tm20,404,-1,20,11,9
720575940624243639,right,Tm20,405,3,10,2,8
720575940629897015,right,Tm20,406,1,-25,-14,-11
720575940638029284,right,Tm20,407,-5,-10,0,-10
720575940617745620,right,Tm20,408,-6,-4,4,-8
720575940623271562,right,Tm20,409,0,-3,-2,-1
720575940621401438,right,Tm20,410,-2,-2,1,-3
720575940626901593,right,Tm20,411,-5,-19,-5,-14
720575940619737453,right,Tm20,412,-6,21,16,5
720575940629780224,right,Tm20,413,-2,-7,-2,-5
720575940643561582,right,Tm20,414,4,21,6,15
720575940620226580,right,Tm20,415,6,12,0,12
720575940615320785,right,Tm20,416,3,-8,-7,-1
720575940639779005,right,Tm20,417,-6,-10,1,-11
720575940628096232,right,Tm20,418,-2,15,9,6
720575940636748462,right,Tm20,419,-3,-11,-3,-8
720575940614844562,right,Tm20,420,6,-3,-8,5
720575940636616334,right,Tm20,421,-1,12,7,5
720575940629837671,right,Tm20,422,-7,-4,5,-9
720575940622058480,right,Tm20,423,3,-18,-12,-6
720575940621724276,right,Tm20,424,-3,-2,2,-4
720575940629093737,right,Tm20,425,3,20,7,13
720575940626487677,right,Tm20,426,-3,0,3,-3
720575940631254156,right,Tm20,427,5,-18,-14,-4
720575940621711365,right,Tm20,428,-2,23,13,10
720575940623276938,right,Tm20,429,-2,14,9,5
720575940642663584,right,Tm20,430,-3,-7,-1,-6
720575940627974406,right,Tm20,431,-2,-10,-3,-7
720575940630310999,right,Tm20,432,-5,7,8,-1
720575940630869315,right,Tm20,433,0,-8,-4,-4
720575940633905038,right,Tm20,434,-3,7,6,1
720575940632344936,right,Tm20,435,5,-17,-14,-3
720575940625961509,right,Tm20,436,0,-15,-8,-7
720575940622883220,right,Tm20,437,-3,12,9,3
720575940636306424,right,Tm20,438,2,27,11,16
720575940622968158,right,Tm20,439,-3,-9,-2,-7
720575940618557248,right,Tm20,440,1,23,10,13
720575940627901864,right,Tm20,441,3,-16,-11,-5
720575940638137151,right,Tm20,442,-5,25,17,8
720575940638811982,right,Tm20,443,-6,4,8,-4
720575940617842459,right,Tm20,444,4,-10,-9,-1
720575940612654632,right,Tm20,445,-2,8,6,2
720575940621137318,right,Tm20,446,2,-14,-9,-5
720575940619505902,right,Tm20,447,-1,2,2,0
720575940612673498,right,Tm20,448,0,30,15,15
720575940616472507,right,Tm20,449,6,-16,-14,-2
720575940607670229,right,Tm20,450,2,-9,-7,-2
720575940630255324,right,Tm20,451,4,20,6,14
720575940613072754,right,Tm20,452,1,-9,-6,-3
720575940622191393,right,Tm20,453,3,25,9,16
720575940625241580,right,Tm20,454,5,-12,-11,-1
720575940631783747,right,Tm20,455,7,-7,-11,4
720575940634848151,right,Tm20,456,0,21,10,11
720575940618517662,right,Tm20,457,-2,17,10,7
720575940620386031,right,Tm20,458,5,0,-5,5
720575940604837344,right,Tm20,459,5,-3,-7,4
720575940618077725,right,Tm20,460,-3,-20,-7,-13
720575940619432773,right,Tm20,461,7,-5,-10,5
720575940626487829,right,Tm20,462,-1,18,10,8
720575940632146828,right,Tm20,463,5,17,3,14
720575940637124464,right,Tm20,464,4,0,-4,4
720575940619873377,right,Tm20,465,3,0,-3,3
720575940618528203,right,Tm20,466,1,14,6,8
720575940630936151,right,Tm20,467,-2,-20,-8,-12
720575940635715252,right,Tm20,468,-3,11,8,3
720575940616270619,right,Tm20,469,-7,13,13,0
720575940638175977,right,Tm20,470,4,-9,-9,0
720575940639571875,right,Tm20,471,3,-26,-16,-10
720575940617283899,right,Tm20,472,1,25,11,14
720575940612635122,right,Tm20,473,-4,23,15,8
720575940629743738,right,Tm20,474,-3,-17,-6,-11
720575940616063093,right,Tm20,475,-4,-1,3,-4
720575940621319077,right,Tm20,476,-1,15,8,7
720575940622335114,right,Tm20,477,-3,2,4,-2
720575940612630642,right,Tm20,478,-7,16,15,1
720575940627567620,right,Tm20,479,-2,10,7,3
720575940633288032,right,Tm20,480,3,-19,-13,-6
720575940606502066,right,Tm20,481,4,-8,-8,0
720575940625696660,right,Tm20,482,1,17,7,10
720575940624418045,right,Tm20,483,2,-7,-6,-1
720575940627158545,right,Tm20,484,3,-9,-8,-1
720575940612621590,right,Tm20,485,-3,-3,1,-4
720575940632411556,right,Tm20,486,0,1,0,1
720575940629828943,right,Tm20,487,1,-1,-2,1
720575940625379854,right,Tm20,488,7,5,-5,10
720575940614274302,right,Tm20,489,-3,10,8,2
720575940616382258,right,Tm20,490,-5,6,8,-2
720575940628487440,right,Tm20,491,7,-1,-8,7
720575940614345110,right,Tm20,492,-7,-2,6,-8
720575940617055062,right,Tm20,493,-3,23,14,9
720575940640395891,right,Tm20,494,0,29,14,15
720575940621330414,right,Tm20,496,7,8,-3,11
720575940625931045,right,Tm20,497,6,1,-6,7
720575940623692326,right,Tm20,498,6,10,-1,11
720575940630826106,right,Tm20,499,5,10,0,10
720575940635554296,right,Tm20,500,7,-8,-11,3
720575940622021552,right,Tm20,501,1,2,0,2
720575940610997060,right,Tm20,503,3,17,5,12
720575940642182619,right,Tm20,504,-2,9,6,3
720575940623801343,right,Tm20,505,6,-22,-17,-5
720575940613436182,right,Tm20,506,1,-12,-7,-5
720575940630250711,right,Tm20,507,-5,-12,-1,-11
720575940631332060,right,Tm20,508,-5,11,10,1
720575940634990746,right,Tm20,509,-4,10,9,1
720575940616918785,right,Tm20,510,-2,11,7,4
720575940616067378,right,Tm20,511,5,-11,-11,0
720575940628020303,right,Tm20,512,6,0,-6,6
720575940617448029,right,Tm20,513,-4,-13,-3,-10
720575940624309256,right,Tm20,514,-4,-10,-1,-9
720575940633225676,right,Tm20,515,-8,-7,4,-11
720575940626976664,right,Tm20,516,7,-18,-16,-2
720575940621953797,right,Tm20,518,-4,22,15,7
720575940622066721,right,Tm20,519,-5,-5,2,-7
720575940630084986,right,Tm20,520,-2,-22,-9,-13
720575940614615362,right,Tm20,521,6,-9,-11,2
720575940629190343,right,Tm20,522,-4,0,4,-4
720575940634015630,right,Tm20,523,2,14,5,9
720575940625267640,right,Tm20,524,4,-20,-14,-6
720575940623495364,right,Tm20,525,-1,-20,-9,-11
720575940627401353,right,Tm20,526,0,-10,-5,-5
720575940645581166,right,Tm20,527,-4,-8,0,-8
720575940631595660,right,Tm20,529,2,-2,-3,1
720575940656115105,right,Tm20,530,-3,-13,-4,-9
720575940622382964,right,Tm20,531,1,0,-1,1
720575940636556004,right,Tm20,532,-8,7,11,-4
720575940618936645,right,Tm20,533,0,-16,-8,-8
720575940627024536,right,Tm20,534,3,2,-2,4
720575940615403231,right,Tm20,535,8,-4,-10,6
720575940628275528,right,Tm20,536,3,4,-1,5
720575940609355054,right,Tm20,537,0,-23,-12,-11
720575940631305676,right,Tm20,538,-4,1,4,-3
720575940619717717,right,Tm20,539,-6,15,13,2
720575940614416815,right,Tm20,540,-2,-9,-3,-6
720575940642290421,right,Tm20,541,-4,14,11,3
720575940624883388,right,Tm20,542,6,-13,-13,0
720575940610524099,right,Tm20,543,-1,-4,-1,-3
720575940632080170,right,Tm20,544,3,-13,-10,-3
720575940630821676,right,Tm20,545,5,11,0,11
720575940624682167,right,Tm20,547,-1,21,11,10
720575940631624515,right,Tm20,548,1,-16,-9,-7
720575940603915436,right,Tm20,549,0,-9,-5,-4
720575940648459652,right,Tm20,550,-2,3,3,0
720575940618201371,right,Tm20,551,-4,-9,-1,-8
720575940616970838,right,Tm20,552,4,-1,-5,4
720575940626553231,right,Tm20,553,-3,16,11,5
720575940618381515,right,Tm20,554,-9,-3,7,-10
720575940643505312,right,Tm20,555,-4,9,8,1
720575940631575338,right,Tm20,556,0,10,5,5
720575940616338619,right,Tm20,557,6,-10,-11,1
720575940615084719,right,Tm20,558,-4,-21,-7,-14
720575940631801642,right,Tm20,559,-6,22,17,5
720575940626735209,right,Tm20,560,-7,14,14,0
720575940619748517,right,Tm20,562,-5,-2,4,-6
720575940627565650,right,Tm20,563,5,-13,-12,-1
720575940630159916,right,Tm20,564,3,-23,-15,-8
720575940620597208,right,Tm20,565,0,-26,-13,-13
720575940622050726,right,Tm20,566,5,-8,-9,1
720575940618417477,right,Tm20,567,-2,22,13,9
720575940617332258,right,Tm20,568,-6,-8,2,-10
720575940660273537,right,Tm20,570,2,25,10,15
720575940632501034,right,Tm20,571,0,-14,-7,-7
720575940639205464,right,Tm20,572,-8,3,9,-6
720575940628586737,right,Tm20,573,4,14,3,11
720575940621253708,right,Tm20,574,-6,5,8,-3
720575940646273902,right,Tm20,576,0,28,14,14
720575940635181978,right,Tm20,577,5,-14,-12,-2
720575940628809259,right,Tm20,578,4,-11,-10,-1
720575940627262553,right,Tm20,579,-3,-10,-2,-8
720575940652519926,right,Tm20,580,-2,-23,-10,-13
720575940616031903,right,Tm20,582,-1,23,12,11
720575940619782054,right,Tm20,583,3,-25,-16,-9
720575940629465047,right,Tm20,584,4,23,7,16
720575940621819980,right,Tm20,585,-1,-23,-11,-12
720575940622360188,right,Tm20,586,2,18,7,11
720575940622928739,right,Tm20,587,4,22,7,15
720575940632326370,right,Tm20,588,1,4,1,3
720575940606553289,right,Tm20,589,-1,-5,-2,-3
720575940630371287,right,Tm20,590,1,9,3,6
720575940635204759,right,Tm20,591,3,-3,-5,2
720575940614301905,right,Tm20,593,3,-14,-10,-4
720575940611892885,right,Tm20,594,7,-16,-15,-1
720575940634178771,right,Tm20,595,7,-12,-13,1
720575940604721376,right,Tm20,596,-4,-16,-4,-12
720575940628398441,right,Tm20,597,4,1,-4,5
720575940616970713,right,Tm20,598,2,-18,-11,-7
720575940646888500,right,Tm20,599,-1,9,5,4
720575940619037972,right,Tm20,600,3,-10,-8,-2
720575940635758746,right,Tm20,601,1,16,7,9
720575940624058119,right,Tm20,602,4,-2,-5,3
720575940615096231,right,Tm20,603,-3,-23,-9,-14
720575940624840179,right,Tm20,604,-6,-17,-3,-14
720575940618985630,right,Tm20,605,3,15,4,11
720575940625945843,right,Tm20,606,-1,-19,-9,-10
720575940636804442,right,Tm20,607,1,18,8,10
720575940617320379,right,Tm20,608,1,10,4,6
720575940624932282,right,Tm20,609,-2,0,2,-2
720575940620011736,right,Tm20,610,2,-23,-14,-9
720575940632266538,right,Tm20,611,-1,-18,-8,-10
720575940606290121,right,Tm20,614,-2,-8,-2,-6
720575940611363426,right,Tm20,615,-7,-7,3,-10
720575940630391162,right,Tm20,616,-3,15,10,5
720575940640275773,right,Tm20,617,-2,-17,-7,-10
720575940624924600,right,Tm20,618,-1,24,13,11
720575940625144624,right,Tm20,619,-4,-19,-6,-13
720575940621849699,right,Tm20,620,7,1,-7,8
720575940640755408,right,Tm20,621,1,24,11,13
720575940643245335,right,Tm20,622,-5,20,15,5
720575940637035918,right,Tm20,623,1,13,5,8
720575940629820571,right,Tm20,624,1,-17,-10,-7
720575940633491342,right,Tm20,625,-2,24,14,10
720575940639183549,right,Tm20,626,-5,-8,1,-9
720575940626395394,right,Tm20,627,0,-1,-1,0
720575940629062555,right,Tm20,628,0,0,0,0
720575940617859677,right,Tm20,630,4,8,0,8
720575940620496331,right,Tm20,631,1,26,12,14
720575940624643336,right,Tm20,632,3,-20,-13,-7
720575940623832781,right,Tm20,633,-1,-24,-11,-13
720575940639434566,right,Tm20,634,-3,-15,-5,-10
720575940620011467,right,Tm20,635,6,-6,-9,3
720575940628402760,right,Tm20,636,0,6,3,3
720575940620913232,right,Tm20,637,3,-21,-14,-7
720575940633593057,right,Tm20,638,-1,7,4,3
720575940625838885,right,Tm20,639,-4,19,13,6
720575940619043156,right,Tm20,640,-1,-16,-7,-9
720575940615857631,right,Tm20,641,-8,-5,5,-10
720575940636564622,right,Tm20,642,-5,-11,-1,-10
720575940612116337,right,Tm20,643,6,14,1,13
720575940625879433,right,Tm20,644,-6,18,15,3
720575940622740999,right,Tm20,645,-4,27,17,10
720575940642264461,right,Tm20,646,6,17,2,15
720575940630236375,right,Tm20,647,-4,-7,0,-7
720575940635070911,right,Tm20,648,1,7,2,5
720575940621601926,right,Tm20,650,-3,-25,-10,-15
720575940630833093,right,Tm20,651,-4,-5,1,-6
720575940629339756,right,Tm20,652,-6,-11,0,-11
720575940617727389,right,Tm20,654,-3,8,7,1
720575940645114647,right,Tm20,655,6,-1,-7,6
720575940627464734,right,Tm20,656,0,-11,-6,-5
720575940635237271,right,Tm20,657,-2,-25,-11,-14
720575940620404389,right,Tm20,658,1,20,9,11
720575940609098965,right,Tm20,659,-4,-6,1,-7
720575940637859246,right,Tm20,661,-3,14,10,4
720575940620908368,right,Tm20,662,2,-1,-3,2
720575940620306452,right,Tm20,664,1,-27,-15,-12
720575940618681920,right,Tm20,665,7,-2,-8,6
720575940630948695,right,Tm20,666,7,-13,-14,1
720575940610937646,right,Tm20,667,1,-28,-15,-13
720575940622947401,right,Tm20,668,1,19,8,11
720575940622743646,right,Tm20,669,4,-16,-12,-4
720575940618446912,right,Tm20,671,-4,-23,-8,-15
720575940612366061,right,Tm20,672,-8,11,13,-2
720575940605924320,right,Tm20,674,-4,-14,-3,-11
720575940620139467,right,Tm20,675,-7,19,16,3
720575940620650155,right,Tm20,678,3,-7,-7,0
720575940618881694,right,Tm20,679,4,18,5,13
720575940634809696,right,Tm20,680,-1,25,13,12
720575940610911864,right,Tm20,681,-2,-21,-9,-12
720575940643897760,right,Tm20,682,6,-8,-10,2
720575940615005590,right,Tm20,684,-6,17,14,3
720575940615567682,right,Tm20,685,-5,-9,0,-9
720575940616579487,right,Tm20,686,5,-22,-16,-6
720575940618718288,right,Tm20,687,-6,-3,4,-7
720575940613141466,right,Tm20,688,-7,10,12,-2
720575940614563734,right,Tm20,689,-2,18,11,7
720575940610029870,right,Tm20,690,-7,-3,5,-8
720575940629431314,right,Tm20,691,-9,4,11,-7
720575940626043180,right,Tm20,692,-4,24,16,8
720575940623508627,right,Tm20,693,-3,25,15,10
720575940628824835,right,Tm20,695,-6,10,11,-1
720575940625629844,right,Tm20,696,-2,16,10,6
720575940638007898,right,Tm20,697,1,-22,-12,-10
720575940646696227,right,Tm20,698,6,-7,-10,3
720575940620104059,right,Tm20,699,-5,0,5,-5
720575940625882768,right,Tm20,700,5,15,2,13
720575940631375435,right,Tm20,701,0,-4,-2,-2
720575940627315845,right,Tm20,702,-5,23,16,7
720575940624338215,right,Tm20,703,-3,1,3,-2
720575940625044716,right,Tm20,704,-7,8,11,-3
720575940622478836,right,Tm20,705,1,1,-1,2
720575940649752441,right,Tm20,707,-2,25,14,11
720575940624453268,right,Tm20,709,-2,-24,-10,-14
720575940625606328,right,Tm20,710,4,-25,-17,-8
720575940623368547,right,Tm20,711,-1,19,10,9
720575940620812880,right,Tm20,712,-7,12,13,-1
720575940631404239,right,Tm20,713,-6,16,14,2
720575940610675064,right,Tm20,714,5,12,1,11
720575940619828603,right,Tm20,715,4,10,1,9
720575940639409998,right,Tm20,716,4,-6,-7,1
720575940620854766,right,Tm20,717,2,-22,-13,-9
720575940614082867,right,Tm20,718,-5,24,17,7
720575940621064052,right,Tm20,719,1,27,12,15
720575940624412651,right,Tm20,720,-5,21,15,6
720575940617951316,right,Tm20,721,5,13,1,12
720575940612663722,right,Tm20,722,6,-15,-14,-1
720575940627404053,right,Tm20,723,-2,-11,-4,-7
720575940623788031,right,Tm20,724,4,2,-3,5
720575940626185104,right,Tm20,725,-3,-24,-9,-15
720575940646790532,right,Tm20,728,7,12,-1,13
720575940616937589,right,Tm20,729,-3,29,17,12
720575940623115363,right,Tm20,730,7,0,-7,7
720575940635380079,right,Tm20,731,-6,9,10,-1
720575940619659093,right,Tm20,732,-3,6,6,0
720575940620581766,right,Tm20,733,-5,-17,-4,-13
720575940635520608,right,Tm20,734,2,0,-2,2
720575940625177628,right,Tm20,735,1,-23,-13,-10
720575940624208520,right,Tm20,736,-8,1,8,-7
720575940622508876,right,Tm20,737,0,19,9,10
720575940626973053,right,Tm20,738,-3,13,9,4
720575940620305334,right,Tm20,739,-7,2,8,-6
720575940644697124,right,Tm20,740,2,-8,-6,-2
720575940630761979,right,Tm20,741,-2,-14,-5,-9
720575940620047124,right,Tm20,742,-4,11,9,2
720575940604711392,right,Tm20,744,-4,25,16,9
720575940630669568,right,Tm20,745,0,13,6,7
720575940619604534,right,Tm20,746,-3,3,4,-1
720575940624008373,right,Tm20,747,0,2,1,1
720575940635371662,right,Tm20,748,-4,20,14,6
720575940606851761,right,Tm20,749,-2,1,2,-1
720575940627894088,right,Tm20,750,4,-24,-16,-8
720575940616011882,right,Tm20,751,1,6,2,4
720575940653269238,right,Tm20,752,-2,7,5,2
720575940610480248,right,Tm20,753,-3,24,15,9
720575940626329893,right,Tm20,754,-1,-13,-6,-7
720575940631751215,right,Tm20,755,4,19,5,14
720575940628475048,right,Tm20,756,5,20,5,15
720575940607223218,right,Tm20,757,0,-6,-3,-3
720575940620705886,right,Tm20,758,5,-1,-6,5
720575940625198315,right,Tm20,759,7,14,0,14
720575940619781729,right,Tm20,760,0,17,8,9
720575940628677137,right,Tm20,762,0,14,7,7
720575940618547649,right,Tm20,763,-5,14,12,2
720575940634177250,right,Tm20,764,-8,-6,5,-11
720575940613277165,right,Tm20,765,-3,9,7,2
720575940622092253,right,Tm20,766,2,-4,-4,0
720575940618512197,right,Tm20,767,1,28,13,15
720575940622217904,right,Tm20,769,4,-27,-18,-9
720575940645973015,right,Tm20,771,3,-27,-17,-10
720575940632269639,right,Tm20,772,1,12,5,7
720575940638073919,right,Tm20,773,5,-19,-15,-4
720575940604529580,right,Tm20,774,-8,6,11,-5
720575940629059287,right,Tm20,775,5,22,6,16
720575940609233163,right,Tm20,776,5,21,5,16
720575940628973130,right,Tm20,777,6,20,4,16
720575940627781019,right,Tm20,778,4,25,8,17
720575940624151492,right,Tm20,779,5,24,7,17
720575940618051001,right,Tm20,780,-6,25,18,7
720575940614361263,right,Tm20,781,-5,26,18,8
720575940618345217,right,Tm20,783,-4,28,18,10
720575940626878210,right,Tm20,784,-4,29,18,11
720575940631567045,right,Tm20,785,-3,30,18,12
720575940628335432,right,Tm20,786,-2,30,17,13
720575940641502928,right,Tm20,787,3,28,11,17
720575940640469107,right,Tm20,788,3,27,10,17
720575940631237420,right,Tm20,789,-3,-27,-11,-16
720575940638654271,right,Tm20,791,-1,-28,-13,-15
720575940616399666,right,Tm20,792,8,2,-7,9
720575940633332947,right,Tm20,793,8,-6,-11,5
720575940623125372,right,Tm20,794,5,-26,-18,-8
720575940629819845,right,Tm20,795,6,-21,-17,-4
720575940632791087,right,Tm20,796,4,26,9,17
720575940618758278,right,Tm21,1,-6,13,12,1
720575940638837582,right,Tm21,2,-8,2,9,-7
720575940623713003,right,Tm21,3,6,-12,-12,0
720575940629578746,right,Tm21,6,-2,-4,0,-4
720575940631367439,right,Tm21,7,-6,-6,3,-9
720575940614781330,right,Tm21,8,-4,26,17,9
720575940643866784,right,Tm21,9,4,9,0,9
720575940631691624,right,Tm21,10,5,-15,-13,-2
720575940627311887,right,Tm21,11,7,-14,-14,0
720575940646213667,right,Tm21,12,-7,9,11,-2
720575940623130381,right,Tm21,13,-1,-26,-12,-14
720575940621616054,right,Tm21,14,0,-27,-14,-13
720575940623897744,right,Tm21,15,2,-3,-4,1
720575940617225019,right,Tm21,16,-2,-16,-6,-10
720575940621398182,right,Tm21,17,1,-5,-4,-1
720575940605680998,right,Tm21,18,5,-16,-13,-3
720575940616545437,right,Tm21,19,-7,17,15,2
720575940620460679,right,Tm21,21,-2,19,11,8
720575940615057420,right,Tm21,22,-1,3,2,1
720575940625672935,right,Tm21,23,-3,-16,-5,-11
720575940635682808,right,Tm21,24,-1,-10,-4,-6
720575940624164133,right,Tm21,25,-9,3,10,-7
720575940628458001,right,Tm21,26,1,-3,-3,0
720575940624875751,right,Tm21,27,0,-25,-13,-12
720575940625812880,right,Tm21,29,-1,-3,-1,-2
720575940647925124,right,Tm21,30,6,16,2,14
720575940634158361,right,Tm21,31,0,16,8,8
720575940615408039,right,Tm21,32,0,12,6,6
720575940659444865,right,Tm21,33,3,18,6,12
720575940627780229,right,Tm21,35,1,-24,-13,-11
720575940647336739,right,Tm21,38,0,-2,-1,-1
720575940638310197,right,Tm21,39,0,20,10,10
720575940619832661,right,Tm21,40,-2,-6,-1,-5
720575940620712784,right,Tm21,41,-3,28,17,11
720575940617953537,right,Tm21,42,-1,14,8,6
720575940632308025,right,Tm21,44,5,-10,-10,0
720575940627217393,right,Tm21,46,-5,15,12,3
720575940612129522,right,Tm21,47,-9,-1,8,-9
720575940612142834,right,Tm21,48,-4,-22,-7,-15
720575940632688804,right,Tm21,49,4,-4,-6,2
720575940613175666,right,Tm21,50,-2,21,12,9
720575940613222809,right,Tm21,51,0,-19,-10,-9
720575940612548325,right,Tm21,52,-1,-22,-10,-12
720575940630275900,right,Tm21,53,5,14,2,12
720575940629814138,right,Tm21,54,-4,3,5,-2
720575940621281729,right,Tm21,55,-4,-11,-2,-9
720575940639204029,right,Tm21,56,1,-13,-8,-5
720575940611493490,right,Tm21,57,6,-11,-12,1
720575940653226998,right,Tm21,58,3,12,3,9
720575940622264810,right,Tm21,59,-2,2,3,-1
720575940626825744,right,Tm21,60,-8,8,12,-4
720575940620314864,right,Tm21,61,-4,-4,2,-6
720575940625653235,right,Tm21,62,0,-29,-15,-14
720575940613797357,right,Tm21,63,4,12,2,10
720575940626626588,right,Tm21,64,4,-23,-16,-7
720575940629724519,right,Tm21,65,-1,28,15,13
720575940631403282,right,Tm21,66,2,15,5,10
720575940606908849,right,Tm21,67,-2,-13,-5,-8
720575940629394075,right,Tm21,68,3,16,5,11
720575940638200895,right,Tm21,69,1,8,3,5
720575940624809876,right,Tm21,70,-4,21,14,7
720575940625160200,right,Tm21,71,-2,-3,0,-3
720575940624323219,right,Tm21,73,2,2,-1,3
720575940620935360,right,Tm21,74,-1,-9,-4,-5
720575940642126989,right,Tm21,75,-6,14,13,1
720575940624762260,right,Tm21,76,-3,-4,1,-5
720575940608112139,right,Tm21,77,2,-5,-5,0
720575940625848464,right,Tm21,78,2,20,8,12
720575940631328727,right,Tm21,79,2,1,-2,3
720575940632636975,right,Tm21,80,4,13,2,11
720575940633199943,right,Tm21,81,6,-2,-7,5
720575940613326829,right,Tm21,82,-7,7,10,-3
720575940622085033,right,Tm21,83,2,-21,-13,-8
720575940631698447,right,Tm21,84,-2,12,8,4
720575940627732818,right,Tm21,85,4,-22,-15,-7
720575940623037208,right,Tm21,86,-5,-7,1,-8
720575940607060354,right,Tm21,87,1,11,4,7
720575940621628038,right,Tm21,89,1,-19,-11,-8
720575940625508843,right,Tm21,90,-4,5,6,-1
720575940624025187,right,Tm21,91,-1,6,4,2
720575940628035861,right,Tm21,93,-6,3,7,-4
720575940624955406,right,Tm21,94,5,18,4,14
720575940630675706,right,Tm21,95,4,-21,-15,-6
720575940635853675,right,Tm21,97,-5,2,6,-4
720575940624725140,right,Tm21,98,-1,-12,-5,-7
720575940615838826,right,Tm21,99,4,15,3,12
720575940616496385,right,Tm21,100,2,-10,-7,-3
720575940628787564,right,Tm21,101,-7,6,10,-4
720575940627924220,right,Tm21,105,3,22,8,14
720575940630387169,right,Tm21,106,-7,11,12,-1
720575940630057035,right,Tm21,108,-3,-12,-3,-9
720575940627274767,right,Tm21,109,4,-5,-7,2
720575940620705556,right,Tm21,110,-7,0,7,-7
720575940615702239,right,Tm21,111,2,-24,-14,-10
720575940638788686,right,Tm21,112,-6,1,6,-5
720575940646482308,right,Tm21,113,-2,4,4,0
720575940645585204,right,Tm21,114,2,-13,-9,-4
720575940622473174,right,Tm21,115,-4,2,5,-3
720575940632931615,right,Tm21,116,-1,-8,-3,-5
720575940616548923,right,Tm21,117,-8,-2,7,-9
720575940620597163,right,Tm21,118,3,1,-3,4
720575940619306325,right,Tm21,119,-2,6,5,1
720575940611411698,right,Tm21,120,-1,-1,0,-1
720575940627430087,right,Tm21,121,-8,4,10,-6
720575940629910844,right,Tm21,122,-5,9,9,0
720575940626171880,right,Tm21,123,-8,10,13,-3
720575940613121706,right,Tm21,124,1,-7,-5,-2
720575940631273676,right,Tm21,127,0,15,7,8
720575940627431301,right,Tm21,128,3,-22,-14,-8
720575940626886552,right,Tm21,129,0,-13,-7,-6
720575940621117360,right,Tm21,130,2,12,4,8
720575940618282576,right,Tm21,131,-6,20,16,4
720575940631276047,right,Tm21,132,2,4,0,4
720575940629638594,right,Tm21,133,-3,20,13,7
720575940620861121,right,Tm21,134,-5,-18,-4,-14
720575940632432866,right,Tm21,135,-3,-22,-8,-14
720575940621656602,right,Tm21,137,5,-7,-9,2
720575940643797664,right,Tm21,138,0,27,13,14
720575940631524111,right,Tm21,139,1,-14,-8,-6
720575940640746867,right,Tm21,140,3,8,1,7
720575940622156031,right,Tm21,142,-2,-18,-7,-11
720575940638901456,right,Tm21,143,-4,16,12,4
720575940625458958,right,Tm21,146,1,-6,-4,-2
720575940628445000,right,Tm21,147,1,21,9,12
720575940615497026,right,Tm21,149,6,-14,-13,-1
720575940628071162,right,Tm21,150,-8,5,10,-5
720575940615016598,right,Tm21,151,-3,-14,-4,-10
720575940631689723,right,Tm21,154,-8,0,8,-8
720575940622616712,right,Tm21,156,-9,1,9,-8
720575940629892668,right,Tm21,157,-1,-7,-3,-4
720575940622918911,right,Tm21,158,3,-5,-6,1
720575940628815207,right,Tm21,160,-2,20,12,8
720575940622457037,right,Tm21,162,-4,-2,3,-5
720575940617414237,right,Tm21,164,-1,-2,0,-2
720575940649870713,right,Tm21,165,4,16,4,12
720575940631779651,right,Tm21,166,0,18,9,9
720575940624741524,right,Tm21,167,0,-17,-9,-8
720575940605278636,right,Tm21,168,-1,17,9,8
720575940624948467,right,Tm21,170,-5,1,5,-4
720575940619748372,right,Tm21,171,6,-20,-16,-4
720575940622409571,right,Tm21,172,1,22,10,12
720575940641638107,right,Tm21,173,2,-25,-15,-10
720575940612335090,right,Tm21,174,4,-15,-12,-3
720575940612734358,right,Tm21,175,-6,-7,2,-9
720575940638482254,right,Tm21,177,-2,-1,1,-2
720575940613390250,right,Tm21,178,2,11,3,8
720575940629545744,right,Tm21,179,-5,-16,-3,-13
720575940626693776,right,Tm21,181,1,-4,-3,-1
720575940614222334,right,Tm21,182,7,-10,-12,2
720575940637176944,right,Tm21,183,-5,-15,-3,-12
720575940606208713,right,Tm21,184,-6,-5,3,-8
720575940618141780,right,Tm21,185,2,-11,-8,-3
720575940627681864,right,Tm21,186,-1,26,14,12
720575940623628076,right,Tm21,187,3,21,7,14
720575940628660329,right,Tm21,188,-5,17,13,4
720575940630356193,right,Tm21,189,6,13,0,13
720575940625603002,right,Tm21,190,-3,-5,0,-5
720575940612524202,right,Tm21,191,-1,-11,-5,-6
720575940622133286,right,Tm21,193,-5,4,7,-3
720575940615195202,right,Tm21,194,0,-5,-3,-2
720575940621232237,right,Tm21,195,-3,-1,2,-3
720575940650476409,right,Tm21,196,-1,8,5,3
720575940626606026,right,Tm21,197,0,-20,-10,-10
720575940630815051,right,Tm21,199,0,-12,-6,-6
720575940613598354,right,Tm21,200,-5,12,11,1
720575940631579500,right,Tm21,202,-1,27,14,13
720575940632804397,right,Tm21,203,3,-1,-4,3
720575940622873768,right,Tm21,205,5,-6,-8,2
720575940621546432,right,Tm21,206,-3,5,5,0
720575940626709797,right,Tm21,208,5,-21,-16,-5
720575940627820175,right,Tm21,209,-3,-8,-1,-7
720575940632065839,right,Tm21,210,-6,8,10,-2
720575940622122334,right,Tm21,211,-7,-1,6,-7
720575940617125947,right,Tm21,212,2,-16,-10,-6
720575940624423655,right,Tm21,213,3,-4,-5,1
720575940621851626,right,Tm21,214,-5,3,6,-3
720575940609791171,right,Tm21,215,6,7,-3,10
720575940620515009,right,Tm21,216,2,19,7,12
720575940624900851,right,Tm21,218,2,10,3,7
720575940622648541,right,Tm21,219,6,-4,-8,4
720575940620282550,right,Tm21,220,2,-6,-5,-1
720575940615415157,right,Tm21,221,-7,3,8,-5
720575940617942356,right,Tm21,222,-3,26,16,10
720575940627123081,right,Tm21,226,5,19,4,15
720575940627763016,right,Tm21,227,-7,5,9,-4
720575940626171261,right,Tm21,228,-7,1,7,-6
720575940618497093,right,Tm21,231,4,-12,-10,-2
720575940633810062,right,Tm21,232,-4,13,10,3
720575940620091989,right,Tm21,233,4,-13,-11,-2
720575940618503325,right,Tm21,235,4,11,1,10
720575940637994941,right,Tm21,236,-1,4,3,1
720575940623970045,right,Tm21,237,-2,27,15,12
720575940635655672,right,Tm21,238,-8,-3,6,-9
720575940619229912,right,Tm21,239,-6,6,9,-3
720575940623959549,right,Tm21,240,-4,-3,2,-5
720575940626769241,right,Tm21,241,2,-17,-11,-6
720575940627428106,right,Tm21,242,-4,6,7,-1
720575940630726139,right,Tm21,243,-1,-21,-10,-11
720575940620624879,right,Tm21,244,-4,-12,-2,-10
720575940654966177,right,Tm21,245,-5,-3,3,-6
720575940636586096,right,Tm21,246,-4,15,11,4
720575940627135113,right,Tm21,247,-4,-15,-4,-11
720575940627636423,right,Tm21,248,-6,0,6,-6
720575940632214242,right,Tm21,249,2,-12,-8,-4
720575940621675329,right,Tm21,250,-1,1,1,0
720575940622060585,right,Tm21,251,-1,-14,-6,-8
720575940614716639,right,Tm21,252,3,23,8,15
720575940609300419,right,Tm21,253,5,16,3,13
720575940616251835,right,Tm21,255,-6,-13,-1,-12
720575940630491191,right,Tm21,257,2,21,8,13
720575940626782010,right,Tm21,258,-4,-17,-5,-12
720575940605771040,right,Tm21,259,-7,-5,4,-9
720575940634171673,right,Tm21,260,-3,19,12,7
720575940623295949,right,Tm21,262,1,-11,-7,-4
720575940615137447,right,Tm21,264,-1,-6,-2,-4
720575940635051188,right,Tm21,265,-6,-1,5,-6
720575940633138093,right,Tm21,268,7,-6,-10,4
720575940609921803,right,Tm21,269,2,-19,-12,-7
720575940626931843,right,Tm21,270,1,-8,-5,-3
720575940638585149,right,Tm21,272,3,-2,-4,2
720575940632264263,right,Tm21,273,-6,23,17,6
720575940650943865,right,Tm21,276,2,3,-1,4
720575940605128876,right,Tm21,277,7,-3,-9,6
720575940635051199,right,Tm21,278,-5,10,10,0
720575940625552103,right,Tm21,279,-4,8,8,0
720575940629713743,right,Tm21,283,-4,4,6,-2
720575940649840505,right,Tm21,284,0,25,12,13
720575940610401860,right,Tm21,285,6,-18,-15,-3
720575940621657965,right,Tm21,286,0,-24,-12,-12
720575940627761674,right,Tm21,287,-5,13,11,2
720575940635466091,right,Tm21,290,5,-24,-17,-7
720575940617359138,right,Tm21,291,7,2,-6,8
720575940635848696,right,Tm21,292,-4,18,13,5
720575940637455278,right,Tm21,293,4,-17,-13,-4
720575940629512208,right,Tm21,294,1,-20,-11,-9
720575940627176793,right,Tm21,296,1,-18,-10,-8
720575940620148340,right,Tm21,298,-5,5,7,-2
720575940612932403,right,Tm21,299,-4,12,10,2
720575940630221178,right,Tm21,300,4,-18,-13,-5
720575940617871643,right,Tm21,301,-5,16,13,3
720575940639379253,right,Tm21,302,2,17,6,11
720575940632001849,right,Tm21,303,-5,22,16,6
720575940615081578,right,Tm21,305,-7,4,9,-5
720575940625523088,right,Tm21,308,-5,8,9,-1
720575940619714800,right,Tm21,309,-6,12,12,0
720575940637090927,right,Tm21,310,2,22,9,13
720575940627972090,right,Tm21,311,-7,15,14,1
720575940621573824,right,Tm21,312,4,-7,-8,1
720575940626020885,right,Tm21,313,7,3,-6,9
720575940645102883,right,Tm21,314,-9,5,11,-6
720575940612346074,right,Tm21,315,-3,-6,0,-6
720575940617640309,right,Tm21,316,5,-4,-7,3
720575940621619382,right,Tm21,317,-5,-4,3,-7
720575940639862435,right,Tm21,318,4,-19,-14,-5
720575940625103374,right,Tm21,319,-2,5,4,1
720575940617818973,right,Tm21,320,-2,-5,-1,-4
720575940640844632,right,Tm21,322,2,26,11,15
720575940624072885,right,Tm21,323,-7,-13,0,-13
720575940623167768,right,Tm21,324,3,24,9,15
720575940632585892,right,Tm21,325,5,1,-5,6
720575940622971169,right,Tm21,326,2,16,6,10
720575940619656664,right,Tm21,328,5,-9,-10,1
720575940627709839,right,Tm21,329,0,24,12,12
720575940622879331,right,Tm21,331,1,-15,-9,-6
720575940621754484,right,Tm21,332,4,-26,-17,-9
720575940622114992,right,Tm21,334,1,-26,-14,-12
720575940653562358,right,Tm21,335,2,8,2,6
720575940639344181,right,Tm21,336,0,23,11,12
720575940631219768,right,Tm21,337,-5,-6,2,-8
720575940630188396,right,Tm21,340,-4,17,12,5
720575940623022104,right,Tm21,342,2,-15,-10,-5
720575940609900299,right,Tm21,343,-3,27,16,11
720575940624988564,right,Tm21,344,-2,-15,-6,-9
720575940634455266,right,Tm21,345,3,-12,-9,-3
720575940621489517,right,Tm21,346,-7,-9,2,-11
720575940617607124,right,Tm21,348,3,14,4,10
720575940623507238,right,Tm21,350,1,15,6,9
720575940629417259,right,Tm21,352,-2,28,16,12
720575940621828848,right,Tm21,353,2,24,10,14
720575940625707278,right,Tm21,354,-2,-26,-11,-15
720575940605618720,right,Tm21,355,-7,-6,4,-10
720575940622231280,right,Tm21,356,0,22,11,11
720575940617894145,right,Tm21,357,4,17,4,13
720575940631400746,right,Tm21,358,-3,17,11,6
720575940627733593,right,Tm21,359,2,23,9,14
720575940627970106,right,Tm21,360,-5,19,14,5
720575940622264745,right,Tm21,363,7,-4,-9,5
720575940638128350,right,Tm21,368,-4,-20,-6,-14
720575940624299005,right,Tm21,369,5,-5,-8,3
720575940646762275,right,Tm21,370,-3,21,13,8
720575940628653564,right,Tm21,371,6,-5,-9,4
720575940621405318,right,Tm21,372,1,-2,-2,0
720575940627406162,right,Tm21,373,1,-21,-12,-9
720575940618881620,right,Tm21,374,2,13,4,9
720575940612045235,right,Tm21,375,-6,7,9,-2
720575940627683898,right,Tm21,378,-3,18,12,6
720575940616485515,right,Tm21,379,3,-17,-12,-5
720575940639327184,right,Tm21,380,-1,29,15,14
720575940619971975,right,Tm21,381,-8,-9,3,-12
720575940636496247,right,Tm21,382,3,-6,-6,0
720575940618120517,right,Tm21,383,-6,11,11,0
720575940620041455,right,Tm21,384,-6,-2,5,-7
720575940626468185,right,Tm21,386,-6,19,15,4
720575940627724616,right,Tm21,387,-1,-15,-7,-8
720575940625078460,right,Tm21,388,3,19,6,13
720575940624299784,right,Tm21,389,-6,-16,-2,-14
720575940628539591,right,Tm21,390,-6,-9,1,-10
720575940617462457,right,Tm21,391,4,-3,-6,3
720575940635079263,right,Tm21,392,-4,7,7,0
720575940613978262,right,Tm21,393,-1,22,12,10
720575940620857709,right,Tm21,394,-7,-8,3,-11
720575940609301038,right,Tm21,395,0,-22,-11,-11
720575940612687144,right,Tm21,396,-1,10,6,4
720575940621021099,right,Tm21,398,-3,22,14,8
720575940630947535,right,Tm21,399,-4,-24,-8,-16
720575940646961460,right,Tm21,401,-2,-19,-8,-11
720575940617592793,right,Tm21,402,3,26,10,16
720575940627771737,right,Tm21,403,-2,-12,-4,-8
720575940627835413,right,Tm21,404,-1,20,11,9
720575940616065130,right,Tm21,406,1,-25,-14,-11
720575940628806444,right,Tm21,407,-5,-10,0,-10
720575940645723940,right,Tm21,408,-6,-4,4,-8
720575940640557520,right,Tm21,409,0,-3,-2,-1
720575940625961561,right,Tm21,410,-2,-2,1,-3
720575940607179394,right,Tm21,412,-6,21,16,5
720575940623525645,right,Tm21,413,-2,-7,-2,-5
720575940627539528,right,Tm21,414,4,21,6,15
720575940629995820,right,Tm21,415,6,12,0,12
720575940635211365,right,Tm21,417,-6,-10,1,-11
720575940644658455,right,Tm21,418,-2,15,9,6
720575940623309080,right,Tm21,419,-3,-11,-3,-8
720575940622576141,right,Tm21,420,6,-3,-8,5
720575940607344770,right,Tm21,421,-1,12,7,5
720575940639636806,right,Tm21,422,-7,-4,5,-9
720575940622950424,right,Tm21,423,3,-18,-12,-6
720575940613525930,right,Tm21,424,-3,-2,2,-4
720575940627169929,right,Tm21,425,3,20,7,13
720575940645828974,right,Tm21,426,-3,0,3,-3
720575940660136577,right,Tm21,427,5,-18,-14,-4
720575940627007640,right,Tm21,429,-2,14,9,5
720575940625613287,right,Tm21,430,-3,-7,-1,-6
720575940616761686,right,Tm21,431,-2,-10,-3,-7
720575940617570333,right,Tm21,432,-5,7,8,-1
720575940632505484,right,Tm21,433,0,-8,-4,-4
720575940612942511,right,Tm21,434,-3,7,6,1
720575940628323861,right,Tm21,435,5,-17,-14,-3
720575940621802662,right,Tm21,436,0,-15,-8,-7
720575940624043363,right,Tm21,437,-3,12,9,3
720575940627084060,right,Tm21,439,-3,-9,-2,-7
720575940646570787,right,Tm21,440,1,23,10,13
720575940633310675,right,Tm21,441,3,-16,-11,-5
720575940613803798,right,Tm21,442,-5,25,17,8
720575940622929737,right,Tm21,443,-6,4,8,-4
720575940621781375,right,Tm21,444,4,-10,-9,-1
720575940626408188,right,Tm21,445,-2,8,6,2
720575940644727076,right,Tm21,446,2,-14,-9,-5
720575940651898358,right,Tm21,447,-1,2,2,0
720575940612592537,right,Tm21,449,6,-16,-14,-2
720575940613772269,right,Tm21,450,2,-9,-7,-2
720575940635139423,right,Tm21,451,4,20,6,14
720575940639810931,right,Tm21,452,1,-9,-6,-3
720575940640790691,right,Tm21,454,5,-12,-11,-1
720575940614635059,right,Tm21,455,7,-7,-11,4
720575940637822527,right,Tm21,456,0,21,10,11
720575940628667828,right,Tm21,458,5,0,-5,5
720575940638079578,right,Tm21,460,-3,-20,-7,-13
720575940640374131,right,Tm21,462,-1,18,10,8
720575940630343649,right,Tm21,463,5,17,3,14
720575940632360722,right,Tm21,464,4,0,-4,4
720575940625893157,right,Tm21,465,3,0,-3,3
720575940619143963,right,Tm21,466,1,14,6,8
720575940619039773,right,Tm21,467,-2,-20,-8,-12
720575940611817957,right,Tm21,468,-3,11,8,3
720575940630459863,right,Tm21,469,-7,13,13,0
720575940626860290,right,Tm21,470,4,-9,-9,0
720575940627862538,right,Tm21,471,3,-26,-16,-10
720575940618065989,right,Tm21,472,1,25,11,14
720575940604825824,right,Tm21,473,-4,23,15,8
720575940625465836,right,Tm21,474,-3,-17,-6,-11
720575940613309157,right,Tm21,475,-4,-1,3,-4
720575940619182646,right,Tm21,476,-1,15,8,7
720575940647459460,right,Tm21,477,-3,2,4,-2
720575940624447588,right,Tm21,478,-7,16,15,1
720575940621097142,right,Tm21,479,-2,10,7,3
720575940632811821,right,Tm21,480,3,-19,-13,-6
720575940637793589,right,Tm21,481,4,-8,-8,0
720575940610074210,right,Tm21,482,1,17,7,10
720575940612235214,right,Tm21,483,2,-7,-6,-1
720575940655108513,right,Tm21,484,3,-9,-8,-1
720575940632478893,right,Tm21,485,-3,-3,1,-4
720575940610493123,right,Tm21,486,0,1,0,1
720575940605575090,right,Tm21,487,1,-1,-2,1
720575940621294435,right,Tm21,489,-3,10,8,2
720575940625020088,right,Tm21,490,-5,6,8,-2
720575940611620306,right,Tm21,491,7,-1,-8,7
720575940619831316,right,Tm21,492,-7,-2,6,-8
720575940628117510,right,Tm21,493,-3,23,14,9
720575940623918216,right,Tm21,497,6,1,-6,7
720575940615219367,right,Tm21,498,6,10,-1,11
720575940624750921,right,Tm21,499,5,10,0,10
720575940615730594,right,Tm21,500,7,-8,-11,3
720575940613580438,right,Tm21,501,1,2,0,2
720575940632912941,right,Tm21,503,3,17,5,12
720575940630605007,right,Tm21,504,-2,9,6,3
720575940630655737,right,Tm21,505,6,-22,-17,-5
720575940609219595,right,Tm21,506,1,-12,-7,-5
720575940636272526,right,Tm21,507,-5,-12,-1,-11
720575940620215744,right,Tm21,508,-5,11,10,1
720575940611602274,right,Tm21,509,-4,10,9,1
720575940624940019,right,Tm21,510,-2,11,7,4
720575940630110172,right,Tm21,512,6,0,-6,6
720575940635638008,right,Tm21,513,-4,-13,-3,-10
720575940639955059,right,Tm21,514,-4,-10,-1,-9
720575940624737277,right,Tm21,518,-4,22,15,7
720575940617982209,right,Tm21,519,-5,-5,2,-7
720575940634661601,right,Tm21,520,-2,-22,-9,-13
720575940608356617,right,Tm21,521,6,-9,-11,2
720575940618470779,right,Tm21,522,-4,0,4,-4
720575940612840562,right,Tm21,523,2,14,5,9
720575940620808286,right,Tm21,524,4,-20,-14,-6
720575940618683456,right,Tm21,525,-1,-20,-9,-11
720575940640173264,right,Tm21,526,0,-10,-5,-5
720575940625009848,right,Tm21,527,-4,-8,0,-8
720575940633401683,right,Tm21,529,2,-2,-3,1
720575940629222147,right,Tm21,530,-3,-13,-4,-9
720575940608731972,right,Tm21,531,1,0,-1,1
720575940631069381,right,Tm21,532,-8,7,11,-4
720575940616950341,right,Tm21,533,0,-16,-8,-8
720575940623443725,right,Tm21,534,3,2,-2,4
720575940623766468,right,Tm21,537,0,-23,-12,-11
720575940617808418,right,Tm21,538,-4,1,4,-3
720575940632115256,right,Tm21,539,-6,15,13,2
720575940623047437,right,Tm21,540,-2,-9,-3,-6
720575940612208090,right,Tm21,541,-4,14,11,3
720575940639655229,right,Tm21,542,6,-13,-13,0
720575940604553150,right,Tm21,543,-1,-4,-1,-3
720575940622269693,right,Tm21,545,5,11,0,11
720575940638813766,right,Tm21,547,-1,21,11,10
720575940632252130,right,Tm21,548,1,-16,-9,-7
720575940627954182,right,Tm21,549,0,-9,-5,-4
720575940635758222,right,Tm21,550,-2,3,3,0
720575940626515556,right,Tm21,551,-4,-9,-1,-8
720575940618095163,right,Tm21,552,4,-1,-5,4
720575940618864542,right,Tm21,553,-3,16,11,5
720575940606939010,right,Tm21,554,-9,-3,7,-10
720575940618731899,right,Tm21,555,-4,9,8,1
720575940633638625,right,Tm21,556,0,10,5,5
720575940605773758,right,Tm21,557,6,-10,-11,1
720575940629576463,right,Tm21,560,-7,14,14,0
720575940641629429,right,Tm21,561,5,7,-2,9
720575940614945990,right,Tm21,562,-5,-2,4,-6
720575940627905354,right,Tm21,564,3,-23,-15,-8
720575940615454206,right,Tm21,565,0,-26,-13,-13
720575940619462814,right,Tm21,566,5,-8,-9,1
720575940625425703,right,Tm21,567,-2,22,13,9
720575940650722681,right,Tm21,568,-6,-8,2,-10
720575940624694932,right,Tm21,571,0,-14,-7,-7
720575940624138933,right,Tm21,572,-8,3,9,-6
720575940616210994,right,Tm21,573,4,14,3,11
720575940625912248,right,Tm21,575,6,9,-2,11
720575940620495343,right,Tm21,576,0,28,14,14
720575940632789924,right,Tm21,578,4,-11,-10,-1
720575940633573089,right,Tm21,579,-3,-10,-2,-8
720575940628302357,right,Tm21,580,-2,-23,-10,-13
720575940645529710,right,Tm21,582,-1,23,12,11
720575940617460317,right,Tm21,585,-1,-23,-11,-12
720575940622687657,right,Tm21,586,2,18,7,11
720575940635496366,right,Tm21,588,1,4,1,3
720575940627637586,right,Tm21,589,-1,-5,-2,-3
720575940616928651,right,Tm21,590,1,9,3,6
720575940636916398,right,Tm21,591,3,-3,-5,2
720575940618657088,right,Tm21,593,3,-14,-10,-4
720575940623222410,right,Tm21,594,7,-16,-15,-1
720575940628761084,right,Tm21,595,7,-12,-13,1
720575940622935956,right,Tm21,597,4,1,-4,5
720575940627503635,right,Tm21,598,2,-18,-11,-7
720575940612368754,right,Tm21,600,3,-10,-8,-2
720575940627906308,right,Tm21,602,4,-2,-5,3
720575940628236487,right,Tm21,604,-6,-17,-3,-14
720575940635463007,right,Tm21,605,3,15,4,11
720575940626486300,right,Tm21,606,-1,-19,-9,-10
720575940617729254,right,Tm21,607,1,18,8,10
720575940615906165,right,Tm21,608,1,10,4,6
720575940618093529,right,Tm21,609,-2,0,2,-2
720575940625830525,right,Tm21,611,-1,-18,-8,-10
720575940611984789,right,Tm21,614,-2,-8,-2,-6
720575940645162775,right,Tm21,615,-7,-7,3,-10
720575940618266907,right,Tm21,616,-3,15,10,5
720575940623346473,right,Tm21,617,-2,-17,-7,-10
720575940619957077,right,Tm21,618,-1,24,13,11
720575940628358226,right,Tm21,619,-4,-19,-6,-13
720575940626835500,right,Tm21,621,1,24,11,13
720575940636309940,right,Tm21,622,-5,20,15,5
720575940620884133,right,Tm21,624,1,-17,-10,-7
720575940626822700,right,Tm21,625,-2,24,14,10
720575940619753419,right,Tm21,626,-5,-8,1,-9
720575940616817081,right,Tm21,627,0,-1,-1,0
720575940632563681,right,Tm21,628,0,0,0,0
720575940621326982,right,Tm21,629,4,24,8,16
720575940634510817,right,Tm21,630,4,8,0,8
720575940645506414,right,Tm21,631,1,26,12,14
720575940624112935,right,Tm21,632,3,-20,-13,-7
720575940635351964,right,Tm21,633,-1,-24,-11,-13
720575940644991511,right,Tm21,634,-3,-15,-5,-10
720575940612610789,right,Tm21,635,6,-6,-9,3
720575940645258532,right,Tm21,637,3,-21,-14,-7
720575940627471759,right,Tm21,638,-1,7,4,3
720575940605185964,right,Tm21,639,-4,19,13,6
720575940637104496,right,Tm21,640,-1,-16,-7,-9
720575940622199390,right,Tm21,641,-8,-5,5,-10
720575940618068454,right,Tm21,642,-5,-11,-1,-10
720575940623089944,right,Tm21,643,6,14,1,13
720575940615944514,right,Tm21,644,-6,18,15,3
720575940607032194,right,Tm21,645,-4,27,17,10
720575940609647829,right,Tm21,647,-4,-7,0,-7
720575940613710102,right,Tm21,650,-3,-25,-10,-15
720575940628751209,right,Tm21,651,-4,-5,1,-6
720575940614098739,right,Tm21,652,-6,-11,0,-11
720575940623022886,right,Tm21,653,-6,-12,0,-12
720575940632599182,right,Tm21,654,-3,8,7,1
720575940648641412,right,Tm21,656,0,-11,-6,-5
720575940626298156,right,Tm21,658,1,20,9,11
720575940627253912,right,Tm21,659,-4,-6,1,-7
720575940616715381,right,Tm21,660,2,28,12,16
720575940616219577,right,Tm21,661,-3,14,10,4
720575940641274164,right,Tm21,662,2,-1,-3,2
720575940609990595,right,Tm21,663,0,8,4,4
720575940635957183,right,Tm21,665,7,-2,-8,6
720575940637154661,right,Tm21,668,1,19,8,11
720575940626518334,right,Tm21,669,4,-16,-12,-4
720575940638242432,right,Tm21,672,-8,11,13,-2
720575940639242805,right,Tm21,673,2,5,0,5
720575940625769108,right,Tm21,674,-4,-14,-3,-11
720575940624052989,right,Tm21,675,-7,19,16,3
720575940636087919,right,Tm21,676,-3,-21,-8,-13
720575940606595430,right,Tm21,677,0,11,5,6
720575940639193203,right,Tm21,678,3,-7,-7,0
720575940630365562,right,Tm21,679,4,18,5,13
720575940631961740,right,Tm21,680,-1,25,13,12
720575940609343683,right,Tm21,681,-2,-21,-9,-12
720575940629146923,right,Tm21,682,6,-8,-10,2
720575940616961565,right,Tm21,684,-6,17,14,3
720575940617255773,right,Tm21,685,-5,-9,0,-9
720575940626430014,right,Tm21,686,5,-22,-16,-6
720575940621616065,right,Tm21,687,-6,-3,4,-7
720575940629760890,right,Tm21,688,-7,10,12,-2
720575940633832403,right,Tm21,689,-2,18,11,7
720575940611813299,right,Tm21,690,-7,-3,5,-8
720575940626123353,right,Tm21,691,-9,4,11,-7
720575940630369335,right,Tm21,692,-4,24,16,8
720575940613367789,right,Tm21,693,-3,25,15,10
720575940620020278,right,Tm21,695,-6,10,11,-1
720575940633305058,right,Tm21,696,-2,16,10,6
720575940618096212,right,Tm21,697,1,-22,-12,-10
720575940644710180,right,Tm21,698,6,-7,-10,3
720575940647380276,right,Tm21,699,-5,0,5,-5
720575940612933594,right,Tm21,700,5,15,2,13
720575940630156887,right,Tm21,701,0,-4,-2,-2
720575940614621694,right,Tm21,702,-5,23,16,7
720575940629974735,right,Tm21,703,-3,1,3,-2
720575940653015713,right,Tm21,704,-7,8,11,-3
720575940627981553,right,Tm21,705,1,1,-1,2
720575940630988818,right,Tm21,707,-2,25,14,11
720575940629831783,right,Tm21,708,-4,-25,-9,-16
720575940624523773,right,Tm21,709,-2,-24,-10,-14
720575940623474902,right,Tm21,710,4,-25,-17,-8
720575940622466636,right,Tm21,711,-1,19,10,9
720575940616589853,right,Tm21,712,-7,12,13,-1
720575940644121032,right,Tm21,713,-6,16,14,2
720575940635609012,right,Tm21,716,4,-6,-7,1
720575940630339066,right,Tm21,717,2,-22,-13,-9
720575940646868532,right,Tm21,719,1,27,12,15
720575940621594206,right,Tm21,720,-5,21,15,6
720575940617649041,right,Tm21,721,5,13,1,12
720575940626887320,right,Tm21,722,6,-15,-14,-1
720575940622703621,right,Tm21,723,-2,-11,-4,-7
720575940630405632,right,Tm21,725,-3,-24,-9,-15
720575940618424645,right,Tm21,729,-3,29,17,12
720575940629224647,right,Tm21,730,7,0,-7,7
720575940620045588,right,Tm21,731,-6,9,10,-1
720575940632011050,right,Tm21,732,-3,6,6,0
720575940632703180,right,Tm21,733,-5,-17,-4,-13
720575940638564661,right,Tm21,734,2,0,-2,2
720575940619264891,right,Tm21,735,1,-23,-13,-10
720575940625412554,right,Tm21,736,-8,1,8,-7
720575940638927332,right,Tm21,737,0,19,9,10
720575940626855268,right,Tm21,738,-3,13,9,4
720575940629012418,right,Tm21,739,-7,2,8,-6
720575940624240520,right,Tm21,740,2,-8,-6,-2
720575940608130499,right,Tm21,741,-2,-14,-5,-9
720575940614272510,right,Tm21,742,-4,11,9,2
720575940642141147,right,Tm21,745,0,13,6,7
720575940629382730,right,Tm21,746,-3,3,4,-1
720575940636370665,right,Tm21,748,-4,20,14,6
720575940625003824,right,Tm21,749,-2,1,2,-1
720575940610016324,right,Tm21,750,4,-24,-16,-8
720575940629793691,right,Tm21,752,-2,7,5,2
720575940611699406,right,Tm21,753,-3,24,15,9
720575940607030658,right,Tm21,754,-1,-13,-6,-7
720575940615980044,right,Tm21,755,4,19,5,14
720575940625898014,right,Tm21,756,5,20,5,15
720575940609290435,right,Tm21,757,0,-6,-3,-3
720575940622491980,right,Tm21,758,5,-1,-6,5
720575940649943161,right,Tm21,760,0,17,8,9
720575940605705318,right,Tm21,761,-4,-18,-5,-13
720575940627715093,right,Tm21,762,0,14,7,7
720575940633917582,right,Tm21,763,-5,14,12,2
720575940614273534,right,Tm21,765,-3,9,7,2
720575940624424939,right,Tm21,766,2,-4,-4,0
720575940629870458,right,Tm21,768,3,5,-1,6
720575940615074572,right,Tm21,771,3,-27,-17,-10
720575940636111758,right,Tm21,772,1,12,5,7
720575940643799456,right,Tm21,773,5,-19,-15,-4
720575940625816860,right,Tm21,774,-8,6,11,-5
720575940640874624,right,Tm21,775,5,22,6,16
720575940633369252,right,Tm21,778,4,25,8,17
720575940625274957,right,Tm21,781,-5,26,18,8
720575940605697726,right,Tm21,783,-4,28,18,10
720575940611395682,right,Tm21,786,-2,30,17,13
720575940615067990,right,Tm3,1,-6,13,12,1
720575940630863159,right,Tm3,2,-8,2,9,-7
720575940615483103,right,Tm3,3,6,-12,-12,0
720575940615955643,right,Tm3,4,-5,-21,-6,-15
720575940620439717,right,Tm3,5,-1,16,9,7
720575940621639713,right,Tm3,6,-2,-4,0,-4
720575940621161862,right,Tm3,7,-6,-6,3,-9
720575940629070083,right,Tm3,8,-4,26,17,9
720575940613008051,right,Tm3,9,4,9,0,9
720575940636723557,right,Tm3,10,5,-15,-13,-2
720575940625877808,right,Tm3,11,7,-14,-14,0
720575940625114201,right,Tm3,12,-7,9,11,-2
720575940616549377,right,Tm3,13,-1,-26,-12,-14
720575940625067239,right,Tm3,14,0,-27,-14,-13
720575940642952500,right,Tm3,15,2,-3,-4,1
720575940622350156,right,Tm3,16,-2,-16,-6,-10
720575940626572218,right,Tm3,17,1,-5,-4,-1
720575940617490230,right,Tm3,18,5,-16,-13,-3
720575940625889929,right,Tm3,19,-7,17,15,2
720575940652679158,right,Tm3,20,3,-11,-9,-2
720575940616691573,right,Tm3,21,-2,19,11,8
720575940611007812,right,Tm3,22,-1,3,2,1
720575940639501965,right,Tm3,23,-3,-16,-5,-11
720575940617200187,right,Tm3,24,-1,-10,-4,-6
720575940639658880,right,Tm3,25,-9,3,10,-7
720575940617836774,right,Tm3,26,1,-3,-3,0
720575940627264030,right,Tm3,27,0,-25,-13,-12
720575940627711492,right,Tm3,29,-1,-3,-1,-2
720575940615486866,right,Tm3,30,6,16,2,14
720575940626943260,right,Tm3,31,0,16,8,8
720575940632379410,right,Tm3,32,0,12,6,6
720575940620139124,right,Tm3,33,3,18,6,12
720575940624860972,right,Tm3,34,6,18,3,15
720575940607469746,right,Tm3,35,1,-24,-13,-11
720575940620620820,right,Tm3,37,1,5,1,4
720575940622270088,right,Tm3,38,0,-2,-1,-1
720575940620906734,right,Tm3,39,0,20,10,10
720575940620272263,right,Tm3,40,-2,-6,-1,-5
720575940622879453,right,Tm3,41,-3,28,17,11
720575940638661446,right,Tm3,42,-1,14,8,6
720575940617769105,right,Tm3,43,-5,18,14,4
720575940617160862,right,Tm3,44,5,-10,-10,0
720575940629671468,right,Tm3,45,-5,-1,4,-5
720575940618249812,right,Tm3,46,-5,15,12,3
720575940616215709,right,Tm3,47,-9,-1,8,-9
720575940633966192,right,Tm3,48,-4,-22,-7,-15
720575940617468121,right,Tm3,49,4,-4,-6,2
720575940622073840,right,Tm3,50,-2,21,12,9
720575940616058811,right,Tm3,51,0,-19,-10,-9
720575940626674378,right,Tm3,52,-1,-22,-10,-12
720575940643503924,right,Tm3,53,5,14,2,12
720575940618490269,right,Tm3,54,-4,3,5,-2
720575940615330001,right,Tm3,55,-4,-11,-2,-9
720575940625096743,right,Tm3,56,1,-13,-8,-5
720575940644850468,right,Tm3,57,6,-11,-12,1
720575940619691569,right,Tm3,58,3,12,3,9
720575940642873229,right,Tm3,59,-2,2,3,-1
720575940613058162,right,Tm3,61,-4,-4,2,-6
720575940622763288,right,Tm3,62,0,-29,-15,-14
720575940625417293,right,Tm3,63,4,12,2,10
720575940616561494,right,Tm3,64,4,-23,-16,-7
720575940614981672,right,Tm3,65,-1,28,15,13
720575940626926920,right,Tm3,66,2,15,5,10
720575940644306980,right,Tm3,67,-2,-13,-5,-8
720575940633415054,right,Tm3,68,3,16,5,11
720575940620344084,right,Tm3,69,1,8,3,5
720575940612206771,right,Tm3,70,-4,21,14,7
720575940637243364,right,Tm3,71,-2,-3,0,-3
720575940632680588,right,Tm3,72,0,-28,-14,-14
720575940632299916,right,Tm3,73,2,2,-1,3
720575940614118097,right,Tm3,74,-1,-9,-4,-5
720575940629903951,right,Tm3,75,-6,14,13,1
720575940647793972,right,Tm3,76,-3,-4,1,-5
720575940623700371,right,Tm3,77,2,-5,-5,0
720575940626844474,right,Tm3,78,2,20,8,12
720575940628589824,right,Tm3,79,2,1,-2,3
720575940638136666,right,Tm3,80,4,13,2,11
720575940618228763,right,Tm3,81,6,-2,-7,5
720575940619598452,right,Tm3,82,-7,7,10,-3
720575940614182055,right,Tm3,83,2,-21,-13,-8
720575940630616863,right,Tm3,84,-2,12,8,4
720575940611435474,right,Tm3,85,4,-22,-15,-7
720575940635798008,right,Tm3,86,-5,-7,1,-8
720575940618693716,right,Tm3,87,1,11,4,7
720575940622167329,right,Tm3,88,7,4,-5,9
720575940614543569,right,Tm3,89,1,-19,-11,-8
720575940613420658,right,Tm3,90,-4,5,6,-1
720575940636278384,right,Tm3,91,-1,6,4,2
720575940621799960,right,Tm3,92,0,9,4,5
720575940627271823,right,Tm3,93,-6,3,7,-4
720575940634311580,right,Tm3,94,5,18,4,14
720575940627404298,right,Tm3,95,4,-21,-15,-6
720575940632262760,right,Tm3,96,1,-10,-6,-4
720575940635204250,right,Tm3,97,-5,2,6,-4
720575940610655186,right,Tm3,98,-1,-12,-5,-7
720575940624020648,right,Tm3,99,4,15,3,12
720575940626005287,right,Tm3,100,2,-10,-7,-3
720575940619990804,right,Tm3,101,-7,6,10,-4
720575940623493161,right,Tm3,102,3,13,3,10
720575940626830692,right,Tm3,104,-1,-27,-13,-14
720575940626328126,right,Tm3,105,3,22,8,14
720575940627517592,right,Tm3,106,-7,11,12,-1
720575940617719163,right,Tm3,107,8,-2,-9,7
720575940622120900,right,Tm3,108,-3,-12,-3,-9
720575940625225511,right,Tm3,109,4,-5,-7,2
720575940616498498,right,Tm3,110,-7,0,7,-7
720575940607284098,right,Tm3,111,2,-24,-14,-10
720575940646897796,right,Tm3,112,-6,1,6,-5
720575940648696452,right,Tm3,113,-2,4,4,0
720575940607472050,right,Tm3,114,2,-13,-9,-4
720575940618311734,right,Tm3,115,-4,2,5,-3
720575940633914263,right,Tm3,116,-1,-8,-3,-5
720575940621111431,right,Tm3,117,-8,-2,7,-9
720575940620596651,right,Tm3,118,3,1,-3,4
720575940627535272,right,Tm3,119,-2,6,5,1
720575940628943226,right,Tm3,120,-1,-1,0,-1
720575940618065984,right,Tm3,121,-8,4,10,-6
720575940612190248,right,Tm3,122,-5,9,9,0
720575940618161099,right,Tm3,123,-8,10,13,-3
720575940607123586,right,Tm3,124,1,-7,-5,-2
720575940618293720,right,Tm3,125,5,9,-1,10
720575940625537176,right,Tm3,126,3,11,2,9
720575940621449654,right,Tm3,127,0,15,7,8
720575940621936666,right,Tm3,128,3,-22,-14,-8
720575940610511314,right,Tm3,129,0,-13,-7,-6
720575940620478629,right,Tm3,130,2,12,4,8
720575940629455415,right,Tm3,131,-6,20,16,4
720575940623440678,right,Tm3,132,2,4,0,4
720575940625601613,right,Tm3,133,-3,20,13,7
720575940638140132,right,Tm3,134,-5,-18,-4,-14
720575940632438546,right,Tm3,135,-3,-22,-8,-14
720575940633546015,right,Tm3,136,0,3,1,2
720575940623666116,right,Tm3,137,5,-7,-9,2
720575940614534142,right,Tm3,138,0,27,13,14
720575940626616322,right,Tm3,139,1,-14,-8,-6
720575940623392148,right,Tm3,141,5,-23,-17,-6
720575940621659374,right,Tm3,142,-2,-18,-7,-11
720575940623144141,right,Tm3,143,-4,16,12,4
720575940660081537,right,Tm3,144,7,-11,-13,2
720575940632783160,right,Tm3,145,0,4,2,2
720575940631136825,right,Tm3,146,1,-6,-4,-2
720575940626890284,right,Tm3,147,1,21,9,12
720575940624698004,right,Tm3,148,-7,-11,1,-12
720575940604561510,right,Tm3,149,6,-14,-13,-1
720575940619430064,right,Tm3,150,-8,5,10,-5
720575940605597886,right,Tm3,151,-3,-14,-4,-10
720575940620901759,right,Tm3,152,3,-15,-11,-4
720575940638937789,right,Tm3,154,-8,0,8,-8
720575940628887772,right,Tm3,155,-8,13,14,-1
720575940631306600,right,Tm3,156,-9,1,9,-8
720575940635144372,right,Tm3,157,-1,-7,-3,-4
720575940632461881,right,Tm3,158,3,-5,-6,1
720575940620443007,right,Tm3,160,-2,20,12,8
720575940627837713,right,Tm3,161,4,-14,-11,-3
720575940624262379,right,Tm3,162,-4,-2,3,-5
720575940626639485,right,Tm3,164,-1,-2,0,-2
720575940636102030,right,Tm3,165,4,16,4,12
720575940611967125,right,Tm3,166,0,18,9,9
720575940618734144,right,Tm3,167,0,-17,-9,-8
720575940639886707,right,Tm3,168,-1,17,9,8
720575940627963934,right,Tm3,169,0,-18,-9,-9
720575940624888812,right,Tm3,170,-5,1,5,-4
720575940615260522,right,Tm3,171,6,-20,-16,-4
720575940636794766,right,Tm3,172,1,22,10,12
720575940636579191,right,Tm3,173,2,-25,-15,-10
720575940617876293,right,Tm3,174,4,-15,-12,-3
720575940624363261,right,Tm3,175,-6,-7,2,-9
720575940631288647,right,Tm3,176,-2,13,8,5
720575940616412219,right,Tm3,177,-2,-1,1,-2
720575940642878772,right,Tm3,178,2,11,3,8
720575940630288695,right,Tm3,179,-5,-16,-3,-13
720575940644772388,right,Tm3,180,2,-27,-16,-11
720575940616190258,right,Tm3,181,1,-4,-3,-1
720575940629196111,right,Tm3,182,7,-10,-12,2
720575940622804830,right,Tm3,183,-5,-15,-3,-12
720575940632752588,right,Tm3,184,-6,-5,3,-8
720575940620159573,right,Tm3,185,2,-11,-8,-3
720575940610686766,right,Tm3,186,-1,26,14,12
720575940645608046,right,Tm3,187,3,21,7,14
720575940614973546,right,Tm3,188,-5,17,13,4
720575940627851592,right,Tm3,189,6,13,0,13
720575940616386705,right,Tm3,190,-3,-5,0,-5
720575940628673027,right,Tm3,191,-1,-11,-5,-6
720575940611126392,right,Tm3,193,-5,4,7,-3
720575940629025027,right,Tm3,194,0,-5,-3,-2
720575940651954166,right,Tm3,195,-3,-1,2,-3
720575940638551273,right,Tm3,196,-1,8,5,3
720575940619929479,right,Tm3,197,0,-20,-10,-10
720575940639208164,right,Tm3,198,6,2,-5,7
720575940621484982,right,Tm3,199,0,-12,-6,-6
720575940620401505,right,Tm3,200,-5,12,11,1
720575940634817178,right,Tm3,202,-1,27,14,13
720575940618902619,right,Tm3,203,3,-1,-4,3
720575940624569276,right,Tm3,204,5,-2,-6,4
720575940647657604,right,Tm3,205,5,-6,-8,2
720575940617790548,right,Tm3,206,-3,5,5,0
720575940622981500,right,Tm3,207,1,29,13,16
720575940619287198,right,Tm3,208,5,-21,-16,-5
720575940634356193,right,Tm3,209,-3,-8,-1,-7
720575940618242384,right,Tm3,210,-6,8,10,-2
720575940630721295,right,Tm3,211,-7,-1,6,-7
720575940626490024,right,Tm3,212,2,-16,-10,-6
720575940620446228,right,Tm3,213,3,-4,-5,1
720575940622351137,right,Tm3,214,-5,3,6,-3
720575940626874133,right,Tm3,215,6,7,-3,10
720575940639533646,right,Tm3,216,2,19,7,12
720575940614872738,right,Tm3,218,2,10,3,7
720575940636686734,right,Tm3,219,6,-4,-8,4
720575940618579797,right,Tm3,220,2,-6,-5,-1
720575940619971755,right,Tm3,221,-7,3,8,-5
720575940633560462,right,Tm3,222,-3,26,16,10
720575940638300388,right,Tm3,223,-2,26,15,11
720575940637348464,right,Tm3,224,0,5,2,3
720575940626573886,right,Tm3,225,2,-26,-15,-11
720575940611981283,right,Tm3,226,5,19,4,15
720575940636383600,right,Tm3,227,-7,5,9,-4
720575940617829445,right,Tm3,228,-7,1,7,-6
720575940626476184,right,Tm3,229,5,2,-4,6
720575940626661050,right,Tm3,230,2,9,2,7
720575940625431652,right,Tm3,231,4,-12,-10,-2
720575940633808270,right,Tm3,232,-4,13,10,3
720575940627226895,right,Tm3,233,4,-13,-11,-2
720575940611550254,right,Tm3,234,1,3,0,3
720575940629040487,right,Tm3,235,4,11,1,10
720575940629867515,right,Tm3,236,-1,4,3,1
720575940625091149,right,Tm3,237,-2,27,15,12
720575940621546501,right,Tm3,238,-8,-3,6,-9
720575940620293824,right,Tm3,240,-4,-3,2,-5
720575940635799476,right,Tm3,241,2,-17,-11,-6
720575940618880566,right,Tm3,242,-4,6,7,-1
720575940621859354,right,Tm3,243,-1,-21,-10,-11
720575940629383754,right,Tm3,244,-4,-12,-2,-10
720575940618283293,right,Tm3,245,-5,-3,3,-6
720575940617529049,right,Tm3,246,-4,15,11,4
720575940617328982,right,Tm3,247,-4,-15,-4,-11
720575940629626368,right,Tm3,248,-6,0,6,-6
720575940625569101,right,Tm3,249,2,-12,-8,-4
720575940634123418,right,Tm3,250,-1,1,1,0
720575940660027009,right,Tm3,251,-1,-14,-6,-8
720575940605787494,right,Tm3,252,3,23,8,15
720575940639542606,right,Tm3,253,5,16,3,13
720575940635151641,right,Tm3,254,3,-24,-15,-9
720575940626156365,right,Tm3,255,-6,-13,-1,-12
720575940620827841,right,Tm3,256,5,-20,-15,-5
720575940620677056,right,Tm3,257,2,21,8,13
720575940625140238,right,Tm3,258,-4,-17,-5,-12
720575940652021750,right,Tm3,259,-7,-5,4,-9
720575940630093628,right,Tm3,260,-3,19,12,7
720575940626138298,right,Tm3,261,-1,13,7,6
720575940606806961,right,Tm3,262,1,-11,-7,-4
720575940621496959,right,Tm3,263,-3,4,5,-1
720575940639687283,right,Tm3,264,-1,-6,-2,-4
720575940630127932,right,Tm3,265,-6,-1,5,-6
720575940606809009,right,Tm3,266,-1,-25,-12,-13
720575940632314705,right,Tm3,268,7,-6,-10,4
720575940615935756,right,Tm3,269,2,-19,-12,-7
720575940617654365,right,Tm3,270,1,-8,-5,-3
720575940624557565,right,Tm3,271,4,6,-1,7
720575940625337637,right,Tm3,272,3,-2,-4,2
720575940622602334,right,Tm3,273,-6,23,17,6
720575940632211596,right,Tm3,275,-8,-1,7,-8
720575940602398473,right,Tm3,276,2,3,-1,4
720575940630196279,right,Tm3,277,7,-3,-9,6
720575940625442570,right,Tm3,278,-5,10,10,0
720575940621665988,right,Tm3,279,-4,8,8,0
720575940644016072,right,Tm3,280,-6,-14,-1,-13
720575940616548411,right,Tm3,281,-9,2,10,-8
720575940623550983,right,Tm3,282,0,26,13,13
720575940616114374,right,Tm3,283,-4,4,6,-2
720575940624832404,right,Tm3,284,0,25,12,13
720575940616751989,right,Tm3,285,6,-18,-15,-3
720575940619259806,right,Tm3,286,0,-24,-12,-12
720575940633913230,right,Tm3,287,-5,13,11,2
720575940613101541,right,Tm3,288,-1,30,16,14
720575940619119921,right,Tm3,289,-1,11,6,5
720575940620501780,right,Tm3,290,5,-24,-17,-7
720575940634225363,right,Tm3,291,7,2,-6,8
720575940623921847,right,Tm3,292,-4,18,13,5
720575940643950752,right,Tm3,293,4,-17,-13,-4
720575940621193825,right,Tm3,294,1,-20,-11,-9
720575940637139312,right,Tm3,295,-2,29,16,13
720575940620497172,right,Tm3,296,1,-18,-10,-8
720575940616398917,right,Tm3,298,-5,5,7,-2
720575940618101917,right,Tm3,299,-4,12,10,2
720575940608911113,right,Tm3,300,4,-18,-13,-5
720575940628956631,right,Tm3,301,-5,16,13,3
720575940633283373,right,Tm3,302,2,17,6,11
720575940618358299,right,Tm3,303,-5,22,16,6
720575940622914026,right,Tm3,305,-7,4,9,-5
720575940626381564,right,Tm3,308,-5,8,9,-1
720575940617134494,right,Tm3,309,-6,12,12,0
720575940614389969,right,Tm3,310,2,22,9,13
720575940620378239,right,Tm3,311,-7,15,14,1
720575940619319454,right,Tm3,312,4,-7,-8,1
720575940617355707,right,Tm3,313,7,3,-6,9
720575940624776380,right,Tm3,314,-9,5,11,-6
720575940628393988,right,Tm3,315,-3,-6,0,-6
720575940620745563,right,Tm3,316,5,-4,-7,3
720575940603383008,right,Tm3,317,-5,-4,3,-7
720575940617773851,right,Tm3,318,4,-19,-14,-5
720575940639558197,right,Tm3,319,-2,5,4,1
720575940627093766,right,Tm3,320,-2,-5,-1,-4
720575940616148383,right,Tm3,321,8,4,-6,10
720575940619987147,right,Tm3,322,2,26,11,15
720575940614838971,right,Tm3,323,-7,-13,0,-13
720575940623864554,right,Tm3,324,3,24,9,15
720575940612398834,right,Tm3,325,5,1,-5,6
720575940621380116,right,Tm3,326,2,16,6,10
720575940627997821,right,Tm3,327,5,3,-4,7
720575940627301391,right,Tm3,328,5,-9,-10,1
720575940625342908,right,Tm3,329,0,24,12,12
720575940610995832,right,Tm3,330,3,3,-2,5
720575940623189773,right,Tm3,331,1,-15,-9,-6
720575940617683857,right,Tm3,332,4,-26,-17,-9
720575940627677071,right,Tm3,333,0,-21,-11,-10
720575940627667794,right,Tm3,334,1,-26,-14,-12
720575940623948012,right,Tm3,335,2,8,2,6
720575940619170358,right,Tm3,336,0,23,11,12
720575940624627691,right,Tm3,337,-5,-6,2,-8
720575940621980365,right,Tm3,338,-1,0,1,-1
720575940632395662,right,Tm3,340,-4,17,12,5
720575940630819944,right,Tm3,341,6,-17,-15,-2
720575940622444179,right,Tm3,342,2,-15,-10,-5
720575940627257469,right,Tm3,343,-3,27,16,11
720575940608914018,right,Tm3,344,-2,-15,-6,-9
720575940627991812,right,Tm3,345,3,-12,-9,-3
720575940610066894,right,Tm3,346,-7,-9,2,-11
720575940632077368,right,Tm3,347,-5,-13,-2,-11
720575940616742517,right,Tm3,348,3,14,4,10
720575940627181955,right,Tm3,349,-5,-14,-2,-12
720575940615182759,right,Tm3,350,1,15,6,9
720575940636966377,right,Tm3,351,-1,-17,-8,-9
720575940627782673,right,Tm3,352,-2,28,16,12
720575940629716730,right,Tm3,353,2,24,10,14
720575940623300134,right,Tm3,354,-2,-26,-11,-15
720575940612763306,right,Tm3,355,-7,-6,4,-10
720575940636793486,right,Tm3,356,0,22,11,11
720575940623322637,right,Tm3,357,4,17,4,13
720575940617566347,right,Tm3,358,-3,17,11,6
720575940627241865,right,Tm3,359,2,23,9,14
720575940627745918,right,Tm3,360,-5,19,14,5
720575940616388831,right,Tm3,361,0,-7,-4,-3
720575940622993131,right,Tm3,362,2,-20,-12,-8
720575940615221354,right,Tm3,363,7,-4,-9,5
720575940639092713,right,Tm3,364,4,4,-2,6
720575940628304394,right,Tm3,365,4,7,-1,8
720575940629697834,right,Tm3,366,-5,-20,-5,-15
720575940610768504,right,Tm3,367,-6,-15,-2,-13
720575940619880692,right,Tm3,368,-4,-20,-6,-14
720575940618277917,right,Tm3,369,5,-5,-8,3
720575940632073612,right,Tm3,370,-3,21,13,8
720575940635595444,right,Tm3,371,6,-5,-9,4
720575940638333749,right,Tm3,372,1,-2,-2,0
720575940615308906,right,Tm3,373,1,-21,-12,-9
720575940619623070,right,Tm3,374,2,13,4,9
720575940605157990,right,Tm3,375,-6,7,9,-2
720575940613542314,right,Tm3,377,0,7,3,4
720575940617846941,right,Tm3,378,-3,18,12,6
720575940629740538,right,Tm3,379,3,-17,-12,-5
720575940613865842,right,Tm3,380,-1,29,15,14
720575940647437956,right,Tm3,381,-8,-9,3,-12
720575940618430923,right,Tm3,382,3,-6,-6,0
720575940642957860,right,Tm3,383,-6,11,11,0
720575940627642938,right,Tm3,384,-6,-2,5,-7
720575940625769253,right,Tm3,385,-3,-18,-6,-12
720575940612841890,right,Tm3,386,-6,19,15,4
720575940628476678,right,Tm3,387,-1,-15,-7,-8
720575940626786490,right,Tm3,388,3,19,6,13
720575940622224166,right,Tm3,390,-6,-9,1,-10
720575940608828425,right,Tm3,391,4,-3,-6,3
720575940629480314,right,Tm3,392,-4,7,7,0
720575940619779288,right,Tm3,393,-1,22,12,10
720575940604341280,right,Tm3,394,-7,-8,3,-11
720575940636888206,right,Tm3,395,0,-22,-11,-11
720575940615440295,right,Tm3,396,-1,10,6,4
720575940621659886,right,Tm3,397,-3,-19,-7,-12
720575940619281249,right,Tm3,398,-3,22,14,8
720575940626708482,right,Tm3,399,-4,-24,-8,-16
720575940625637048,right,Tm3,400,1,-29,-16,-13
720575940620950694,right,Tm3,401,-2,-19,-8,-11
720575940614972583,right,Tm3,402,3,26,10,16
720575940617550902,right,Tm3,403,-2,-12,-4,-8
720575940614707879,right,Tm3,404,-1,20,11,9
720575940628473084,right,Tm3,405,3,10,2,8
720575940632602415,right,Tm3,406,1,-25,-14,-11
720575940628164840,right,Tm3,407,-5,-10,0,-10
720575940623481781,right,Tm3,408,-6,-4,4,-8
720575940616792413,right,Tm3,409,0,-3,-2,-1
720575940629210668,right,Tm3,410,-2,-2,1,-3
720575940630237239,right,Tm3,411,-5,-19,-5,-14
720575940634533751,right,Tm3,412,-6,21,16,5
720575940606475465,right,Tm3,413,-2,-7,-2,-5
720575940622763485,right,Tm3,414,4,21,6,15
720575940622901033,right,Tm3,415,6,12,0,12
720575940629028880,right,Tm3,416,3,-8,-7,-1
720575940607365129,right,Tm3,417,-6,-10,1,-11
720575940627080236,right,Tm3,418,-2,15,9,6
720575940616166873,right,Tm3,419,-3,-11,-3,-8
720575940627824458,right,Tm3,420,6,-3,-8,5
720575940611903346,right,Tm3,421,-1,12,7,5
720575940609313884,right,Tm3,423,3,-18,-12,-6
720575940631989049,right,Tm3,424,-3,-2,2,-4
720575940605883494,right,Tm3,425,3,20,7,13
720575940641172213,right,Tm3,426,-3,0,3,-3
720575940648701572,right,Tm3,427,5,-18,-14,-4
720575940640868560,right,Tm3,428,-2,23,13,10
720575940630266619,right,Tm3,429,-2,14,9,5
720575940621235952,right,Tm3,430,-3,-7,-1,-6
720575940636727950,right,Tm3,431,-2,-10,-3,-7
720575940612722661,right,Tm3,432,-5,7,8,-1
720575940619785351,right,Tm3,433,0,-8,-4,-4
720575940634929003,right,Tm3,434,-3,7,6,1
720575940627129346,right,Tm3,435,5,-17,-14,-3
720575940624874900,right,Tm3,436,0,-15,-8,-7
720575940607106761,right,Tm3,437,-3,12,9,3
720575940604897248,right,Tm3,438,2,27,11,16
720575940611839893,right,Tm3,439,-3,-9,-2,-7
720575940638848326,right,Tm3,440,1,23,10,13
720575940629131516,right,Tm3,441,3,-16,-11,-5
720575940632464353,right,Tm3,442,-5,25,17,8
720575940612917922,right,Tm3,443,-6,4,8,-4
720575940612909029,right,Tm3,444,4,-10,-9,-1
720575940643512992,right,Tm3,445,-2,8,6,2
720575940627775019,right,Tm3,446,2,-14,-9,-5
720575940636343732,right,Tm3,447,-1,2,2,0
720575940629932666,right,Tm3,449,6,-16,-14,-2
720575940614653615,right,Tm3,450,2,-9,-7,-2
720575940607674034,right,Tm3,451,4,20,6,14
720575940627938314,right,Tm3,452,1,-9,-6,-3
720575940626914429,right,Tm3,453,3,25,9,16
720575940626078864,right,Tm3,454,5,-12,-11,-1
720575940655271585,right,Tm3,455,7,-7,-11,4
720575940621197900,right,Tm3,456,0,21,10,11
720575940614948674,right,Tm3,457,-2,17,10,7
720575940624165815,right,Tm3,458,5,0,-5,5
720575940641437173,right,Tm3,459,5,-3,-7,4
720575940645489518,right,Tm3,460,-3,-20,-7,-13
720575940616629282,right,Tm3,461,7,-5,-10,5
720575940620826388,right,Tm3,462,-1,18,10,8
720575940610535492,right,Tm3,463,5,17,3,14
720575940610463939,right,Tm3,464,4,0,-4,4
720575940612483606,right,Tm3,465,3,0,-3,3
720575940627071276,right,Tm3,466,1,14,6,8
720575940630989655,right,Tm3,467,-2,-20,-8,-12
720575940624067563,right,Tm3,468,-3,11,8,3
720575940642081440,right,Tm3,469,-7,13,13,0
720575940655067553,right,Tm3,470,4,-9,-9,0
720575940623319053,right,Tm3,472,1,25,11,14
720575940615432415,right,Tm3,473,-4,23,15,8
720575940616646289,right,Tm3,474,-3,-17,-6,-11
720575940652862198,right,Tm3,475,-4,-1,3,-4
720575940622298326,right,Tm3,476,-1,15,8,7
720575940608430091,right,Tm3,477,-3,2,4,-2
720575940642581920,right,Tm3,478,-7,16,15,1
720575940629473918,right,Tm3,479,-2,10,7,3
720575940627850343,right,Tm3,480,3,-19,-13,-6
720575940631685162,right,Tm3,481,4,-8,-8,0
720575940623764774,right,Tm3,482,1,17,7,10
720575940632834967,right,Tm3,483,2,-7,-6,-1
720575940625785617,right,Tm3,484,3,-9,-8,-1
720575940619502552,right,Tm3,485,-3,-3,1,-4
720575940625650434,right,Tm3,486,0,1,0,1
720575940608214852,right,Tm3,487,1,-1,-2,1
720575940609128405,right,Tm3,488,7,5,-5,10
720575940616203318,right,Tm3,489,-3,10,8,2
720575940623376362,right,Tm3,490,-5,6,8,-2
720575940632810188,right,Tm3,491,7,-1,-8,7
720575940629764858,right,Tm3,492,-7,-2,6,-8
720575940616310578,right,Tm3,493,-3,23,14,9
720575940608326274,right,Tm3,494,0,29,14,15
720575940624797223,right,Tm3,497,6,1,-6,7
720575940629947330,right,Tm3,498,6,10,-1,11
720575940627198564,right,Tm3,499,5,10,0,10
720575940622618913,right,Tm3,500,7,-8,-11,3
720575940644500334,right,Tm3,501,1,2,0,2
720575940611106680,right,Tm3,502,5,8,-1,9
720575940614608081,right,Tm3,503,3,17,5,12
720575940628387898,right,Tm3,504,-2,9,6,3
720575940627704316,right,Tm3,506,1,-12,-7,-5
720575940636272270,right,Tm3,507,-5,-12,-1,-11
720575940628127729,right,Tm3,508,-5,11,10,1
720575940606793906,right,Tm3,509,-4,10,9,1
720575940606496178,right,Tm3,510,-2,11,7,4
720575940625657786,right,Tm3,511,5,-11,-11,0
720575940622054832,right,Tm3,512,6,0,-6,6
720575940627217563,right,Tm3,513,-4,-13,-3,-10
720575940626282954,right,Tm3,514,-4,-10,-1,-9
720575940635212280,right,Tm3,515,-8,-7,4,-11
720575940624169165,right,Tm3,517,6,3,-5,8
720575940621627062,right,Tm3,518,-4,22,15,7
720575940607527602,right,Tm3,519,-5,-5,2,-7
720575940623416600,right,Tm3,520,-2,-22,-9,-13
720575940615997663,right,Tm3,521,6,-9,-11,2
720575940624322599,right,Tm3,522,-4,0,4,-4
720575940646642979,right,Tm3,523,2,14,5,9
720575940630780780,right,Tm3,524,4,-20,-14,-6
720575940635225791,right,Tm3,525,-1,-20,-9,-11
720575940630641372,right,Tm3,526,0,-10,-5,-5
720575940622417697,right,Tm3,527,-4,-8,0,-8
720575940622560244,right,Tm3,528,2,7,1,6
720575940632065640,right,Tm3,529,2,-2,-3,1
720575940634263196,right,Tm3,530,-3,-13,-4,-9
720575940615302818,right,Tm3,531,1,0,-1,1
720575940611687488,right,Tm3,532,-8,7,11,-4
720575940630491899,right,Tm3,533,0,-16,-8,-8
720575940613801965,right,Tm3,534,3,2,-2,4
720575940620697537,right,Tm3,535,8,-4,-10,6
720575940624202239,right,Tm3,536,3,4,-1,5
720575940635281247,right,Tm3,537,0,-23,-12,-11
720575940630439016,right,Tm3,538,-4,1,4,-3
720575940625177090,right,Tm3,539,-6,15,13,2
720575940619105985,right,Tm3,540,-2,-9,-3,-6
720575940633912718,right,Tm3,541,-4,14,11,3
720575940626533122,right,Tm3,542,6,-13,-13,0
720575940623318408,right,Tm3,543,-1,-4,-1,-3
720575940625544435,right,Tm3,544,3,-13,-10,-3
720575940641294837,right,Tm3,545,5,11,0,11
720575940618442917,right,Tm3,546,3,6,0,6
720575940642269325,right,Tm3,547,-1,21,11,10
720575940626020752,right,Tm3,548,1,-16,-9,-7
720575940625990146,right,Tm3,549,0,-9,-5,-4
720575940628905802,right,Tm3,550,-2,3,3,0
720575940616151238,right,Tm3,551,-4,-9,-1,-8
720575940611285858,right,Tm3,552,4,-1,-5,4
720575940639159273,right,Tm3,553,-3,16,11,5
720575940616336923,right,Tm3,555,-4,9,8,1
720575940619063892,right,Tm3,556,0,10,5,5
720575940628455546,right,Tm3,557,6,-10,-11,1
720575940630559488,right,Tm3,558,-4,-21,-7,-14
720575940645253155,right,Tm3,559,-6,22,17,5
720575940604076990,right,Tm3,560,-7,14,14,0
720575940631207468,right,Tm3,561,5,7,-2,9
720575940635936613,right,Tm3,562,-5,-2,4,-6
720575940631441464,right,Tm3,563,5,-13,-12,-1
720575940617808614,right,Tm3,564,3,-23,-15,-8
720575940612468965,right,Tm3,565,0,-26,-13,-13
720575940625025255,right,Tm3,566,5,-8,-9,1
720575940625319205,right,Tm3,567,-2,22,13,9
720575940626087568,right,Tm3,568,-6,-8,2,-10
720575940625071548,right,Tm3,570,2,25,10,15
720575940617582804,right,Tm3,571,0,-14,-7,-7
720575940635761144,right,Tm3,573,4,14,3,11
720575940629684474,right,Tm3,575,6,9,-2,11
720575940622206725,right,Tm3,576,0,28,14,14
720575940639593038,right,Tm3,577,5,-14,-12,-2
720575940627302415,right,Tm3,578,4,-11,-10,-1
720575940606806193,right,Tm3,579,-3,-10,-2,-8
720575940629573882,right,Tm3,580,-2,-23,-10,-13
720575940632701011,right,Tm3,581,3,9,1,8
720575940633117265,right,Tm3,582,-1,23,12,11
720575940607199945,right,Tm3,583,3,-25,-16,-9
720575940621173158,right,Tm3,584,4,23,7,16
720575940634308322,right,Tm3,585,-1,-23,-11,-12
720575940629900926,right,Tm3,586,2,18,7,11
720575940612592626,right,Tm3,587,4,22,7,15
720575940645190088,right,Tm3,588,1,4,1,3
720575940629251966,right,Tm3,589,-1,-5,-2,-3
720575940631099735,right,Tm3,590,1,9,3,6
720575940609277230,right,Tm3,591,3,-3,-5,2
720575940631505679,right,Tm3,593,3,-14,-10,-4
720575940631425611,right,Tm3,594,7,-16,-15,-1
720575940641416181,right,Tm3,595,7,-12,-13,1
720575940628038908,right,Tm3,596,-4,-16,-4,-12
720575940617472985,right,Tm3,597,4,1,-4,5
720575940608830475,right,Tm3,598,2,-18,-11,-7
720575940619872933,right,Tm3,599,-1,9,5,4
720575940605310398,right,Tm3,600,3,-10,-8,-2
720575940624365129,right,Tm3,601,1,16,7,9
720575940631193797,right,Tm3,602,4,-2,-5,3
720575940615419042,right,Tm3,603,-3,-23,-9,-14
720575940620335380,right,Tm3,604,-6,-17,-3,-14
720575940629849404,right,Tm3,605,3,15,4,11
720575940619888075,right,Tm3,606,-1,-19,-9,-10
720575940631316498,right,Tm3,607,1,18,8,10
720575940618215773,right,Tm3,608,1,10,4,6
720575940627218631,right,Tm3,609,-2,0,2,-2
720575940612662385,right,Tm3,610,2,-23,-14,-9
720575940618304216,right,Tm3,611,-1,-18,-8,-10
720575940615637159,right,Tm3,612,-3,-26,-10,-16
720575940630118200,right,Tm3,613,-8,-4,6,-10
720575940627254354,right,Tm3,614,-2,-8,-2,-6
720575940631341263,right,Tm3,615,-7,-7,3,-10
720575940611569198,right,Tm3,616,-3,15,10,5
720575940639563123,right,Tm3,617,-2,-17,-7,-10
720575940616710517,right,Tm3,618,-1,24,13,11
720575940630760296,right,Tm3,619,-4,-19,-6,-13
720575940632199186,right,Tm3,620,7,1,-7,8
720575940646617891,right,Tm3,621,1,24,11,13
720575940634805344,right,Tm3,622,-5,20,15,5
720575940622201112,right,Tm3,623,1,13,5,8
720575940629136970,right,Tm3,624,1,-17,-10,-7
720575940605917216,right,Tm3,625,-2,24,14,10
720575940623211022,right,Tm3,626,-5,-8,1,-9
720575940639052888,right,Tm3,627,0,-1,-1,0
720575940621153306,right,Tm3,628,0,0,0,0
720575940647522180,right,Tm3,629,4,24,8,16
720575940607710421,right,Tm3,630,4,8,0,8
720575940605799968,right,Tm3,631,1,26,12,14
720575940630750283,right,Tm3,632,3,-20,-13,-7
720575940630665465,right,Tm3,634,-3,-15,-5,-10
720575940649368441,right,Tm3,635,6,-6,-9,3
720575940611602090,right,Tm3,636,0,6,3,3
720575940618375803,right,Tm3,637,3,-21,-14,-7
720575940635619263,right,Tm3,638,-1,7,4,3
720575940638445402,right,Tm3,639,-4,19,13,6
720575940623915957,right,Tm3,640,-1,-16,-7,-9
720575940642518157,right,Tm3,641,-8,-5,5,-10
720575940615120234,right,Tm3,642,-5,-11,-1,-10
720575940607340555,right,Tm3,643,6,14,1,13
720575940619571021,right,Tm3,644,-6,18,15,3
720575940624811582,right,Tm3,645,-4,27,17,10
720575940615765866,right,Tm3,646,6,17,2,15
720575940632602195,right,Tm3,647,-4,-7,0,-7
720575940638122468,right,Tm3,648,1,7,2,5
720575940627767685,right,Tm3,649,-1,5,3,2
720575940624200701,right,Tm3,650,-3,-25,-10,-15
720575940629976888,right,Tm3,651,-4,-5,1,-6
720575940636058735,right,Tm3,652,-6,-11,0,-11
720575940615087978,right,Tm3,653,-6,-12,0,-12
720575940608373769,right,Tm3,654,-3,8,7,1
720575940614898850,right,Tm3,655,6,-1,-7,6
720575940632333103,right,Tm3,656,0,-11,-6,-5
720575940641226624,right,Tm3,657,-2,-25,-11,-14
720575940626335761,right,Tm3,658,1,20,9,11
720575940617714525,right,Tm3,659,-4,-6,1,-7
720575940628411409,right,Tm3,660,2,28,12,16
720575940626058128,right,Tm3,661,-3,14,10,4
720575940630266875,right,Tm3,662,2,-1,-3,2
720575940632170055,right,Tm3,663,0,8,4,4
720575940632110392,right,Tm3,664,1,-27,-15,-12
720575940615705693,right,Tm3,665,7,-2,-8,6
720575940644127432,right,Tm3,668,1,19,8,11
720575940628074345,right,Tm3,669,4,-16,-12,-4
720575940650461561,right,Tm3,670,5,5,-3,8
720575940623520264,right,Tm3,671,-4,-23,-8,-15
720575940633115859,right,Tm3,672,-8,11,13,-2
720575940627715407,right,Tm3,673,2,5,0,5
720575940616630050,right,Tm3,674,-4,-14,-3,-11
720575940613559525,right,Tm3,676,-3,-21,-8,-13
720575940660865409,right,Tm3,677,0,11,5,6
720575940606810633,right,Tm3,678,3,-7,-7,0
720575940627556233,right,Tm3,679,4,18,5,13
720575940618011426,right,Tm3,680,-1,25,13,12
720575940625650736,right,Tm3,681,-2,-21,-9,-12
720575940623655718,right,Tm3,682,6,-8,-10,2
720575940618551120,right,Tm3,684,-6,17,14,3
720575940630578396,right,Tm3,685,-5,-9,0,-9
720575940641566965,right,Tm3,686,5,-22,-16,-6
720575940640900304,right,Tm3,687,-6,-3,4,-7
720575940626671449,right,Tm3,688,-7,10,12,-2
720575940628138236,right,Tm3,689,-2,18,11,7
720575940611745230,right,Tm3,690,-7,-3,5,-8
720575940636286042,right,Tm3,691,-9,4,11,-7
720575940636584567,right,Tm3,692,-4,24,16,8
720575940626096016,right,Tm3,693,-3,25,15,10
720575940616445323,right,Tm3,694,4,3,-3,6
720575940618529927,right,Tm3,695,-6,10,11,-1
720575940631468306,right,Tm3,696,-2,16,10,6
720575940627897768,right,Tm3,697,1,-22,-12,-10
720575940609445474,right,Tm3,698,6,-7,-10,3
720575940616894235,right,Tm3,699,-5,0,5,-5
720575940625647404,right,Tm3,700,5,15,2,13
720575940627179416,right,Tm3,701,0,-4,-2,-2
720575940633558158,right,Tm3,702,-5,23,16,7
720575940630682998,right,Tm3,703,-3,1,3,-2
720575940621541542,right,Tm3,704,-7,8,11,-3
720575940620963316,right,Tm3,705,1,1,-1,2
720575940638795846,right,Tm3,707,-2,25,14,11
720575940620451974,right,Tm3,709,-2,-24,-10,-14
720575940623894029,right,Tm3,710,4,-25,-17,-8
720575940623799477,right,Tm3,711,-1,19,10,9
720575940608957705,right,Tm3,712,-7,12,13,-1
720575940637207366,right,Tm3,713,-6,16,14,2
720575940607248514,right,Tm3,714,5,12,1,11
720575940625851696,right,Tm3,715,4,10,1,9
720575940631662952,right,Tm3,716,4,-6,-7,1
720575940619712049,right,Tm3,717,2,-22,-13,-9
720575940639466549,right,Tm3,718,-5,24,17,7
720575940632261516,right,Tm3,719,1,27,12,15
720575940640905936,right,Tm3,720,-5,21,15,6
720575940617254261,right,Tm3,721,5,13,1,12
720575940615242357,right,Tm3,722,6,-15,-14,-1
720575940627211401,right,Tm3,723,-2,-11,-4,-7
720575940624047799,right,Tm3,724,4,2,-3,5
720575940630341180,right,Tm3,725,-3,-24,-9,-15
720575940631572588,right,Tm3,726,2,-28,-16,-12
720575940621112673,right,Tm3,728,7,12,-1,13
720575940618869789,right,Tm3,729,-3,29,17,12
720575940628159464,right,Tm3,730,7,0,-7,7
720575940616389789,right,Tm3,731,-6,9,10,-1
720575940621665732,right,Tm3,732,-3,6,6,0
720575940624037815,right,Tm3,733,-5,-17,-4,-13
720575940655186081,right,Tm3,734,2,0,-2,2
720575940625529843,right,Tm3,735,1,-23,-13,-10
720575940610879864,right,Tm3,737,0,19,9,10
720575940632814623,right,Tm3,738,-3,13,9,4
720575940620878928,right,Tm3,739,-7,2,8,-6
720575940625073959,right,Tm3,740,2,-8,-6,-2
720575940612938914,right,Tm3,741,-2,-14,-5,-9
720575940627095313,right,Tm3,742,-4,11,9,2
720575940622143159,right,Tm3,743,6,-19,-16,-3
720575940627141245,right,Tm3,744,-4,25,16,9
720575940632859020,right,Tm3,745,0,13,6,7
720575940622110925,right,Tm3,746,-3,3,4,-1
720575940638925731,right,Tm3,747,0,2,1,1
720575940622281686,right,Tm3,748,-4,20,14,6
720575940617762699,right,Tm3,749,-2,1,2,-1
720575940630234624,right,Tm3,750,4,-24,-16,-8
720575940605103806,right,Tm3,752,-2,7,5,2
720575940632428871,right,Tm3,753,-3,24,15,9
720575940633525985,right,Tm3,754,-1,-13,-6,-7
720575940626377060,right,Tm3,755,4,19,5,14
720575940633071260,right,Tm3,756,5,20,5,15
720575940626365212,right,Tm3,757,0,-6,-3,-3
720575940627065606,right,Tm3,758,5,-1,-6,5
720575940632801709,right,Tm3,759,7,14,0,14
720575940611648179,right,Tm3,760,0,17,8,9
720575940631867223,right,Tm3,761,-4,-18,-5,-13
720575940612019162,right,Tm3,762,0,14,7,7
720575940628709740,right,Tm3,763,-5,14,12,2
720575940627535439,right,Tm3,765,-3,9,7,2
720575940635233972,right,Tm3,766,2,-4,-4,0
720575940608964363,right,Tm3,767,1,28,13,15
720575940614096936,right,Tm3,768,3,5,-1,6
720575940633660333,right,Tm3,769,4,-27,-18,-9
720575940623987480,right,Tm3,772,1,12,5,7
720575940628003560,right,Tm3,773,5,-19,-15,-4
720575940621354888,right,Tm3,774,-8,6,11,-5
720575940631951004,right,Tm3,775,5,22,6,16
720575940627942430,right,Tm3,776,5,21,5,16
720575940615587222,right,Tm3,777,6,20,4,16
720575940625404686,right,Tm3,779,5,24,7,17
720575940618693965,right,Tm3,780,-6,25,18,7
720575940640214360,right,Tm3,782,-5,27,18,9
720575940610112068,right,Tm3,783,-4,28,18,10
720575940626475522,right,Tm3,784,-4,29,18,11
720575940620393131,right,Tm3,785,-3,30,18,12
720575940647105571,right,Tm3,786,-2,30,17,13
720575940623261654,right,Tm3,788,3,27,10,17
720575940609486787,right,Tm3,790,-2,-27,-12,-15
720575940625680060,right,Tm3,791,-1,-28,-13,-15
720575940616182834,right,Tm3,793,8,-6,-11,5
720575940622127877,right,Tm3,794,5,-26,-18,-8
720575940608725259,right,Tm3,796,4,26,9,17
720575940603384748,right,Tm4,1,-6,13,12,1
720575940623113802,right,Tm4,2,-8,2,9,-7
720575940621769409,right,Tm4,3,6,-12,-12,0
720575940629704062,right,Tm4,4,-5,-21,-6,-15
720575940615013738,right,Tm4,6,-2,-4,0,-4
720575940621018790,right,Tm4,7,-6,-6,3,-9
720575940623645064,right,Tm4,8,-4,26,17,9
720575940632769361,right,Tm4,9,4,9,0,9
720575940627501041,right,Tm4,10,5,-15,-13,-2
720575940619202497,right,Tm4,12,-7,9,11,-2
720575940606236192,right,Tm4,13,-1,-26,-12,-14
720575940629443313,right,Tm4,14,0,-27,-14,-13
720575940635620203,right,Tm4,15,2,-3,-4,1
720575940606372798,right,Tm4,16,-2,-16,-6,-10
720575940616272434,right,Tm4,17,1,-5,-4,-1
720575940633015981,right,Tm4,18,5,-16,-13,-3
720575940626684285,right,Tm4,19,-7,17,15,2
720575940621648566,right,Tm4,20,3,-11,-9,-2
720575940621251949,right,Tm4,21,-2,19,11,8
720575940622289101,right,Tm4,22,-1,3,2,1
720575940611214573,right,Tm4,23,-3,-16,-5,-11
720575940630046780,right,Tm4,24,-1,-10,-4,-6
720575940622960764,right,Tm4,26,1,-3,-3,0
720575940617685460,right,Tm4,27,0,-25,-13,-12
720575940613568493,right,Tm4,28,5,6,-2,8
720575940623222221,right,Tm4,29,-1,-3,-1,-2
720575940619087040,right,Tm4,30,6,16,2,14
720575940633003053,right,Tm4,31,0,16,8,8
720575940633199059,right,Tm4,32,0,12,6,6
720575940642558605,right,Tm4,33,3,18,6,12
720575940610744725,right,Tm4,34,6,18,3,15
720575940606737254,right,Tm4,35,1,-24,-13,-11
720575940619087739,right,Tm4,36,6,8,-2,10
720575940628538630,right,Tm4,37,1,5,1,4
720575940638965155,right,Tm4,38,0,-2,-1,-1
720575940607342210,right,Tm4,39,0,20,10,10
720575940618988190,right,Tm4,40,-2,-6,-1,-5
720575940618041501,right,Tm4,41,-3,28,17,11
720575940628188392,right,Tm4,42,-1,14,8,6
720575940615707078,right,Tm4,43,-5,18,14,4
720575940612203889,right,Tm4,44,5,-10,-10,0
720575940624183733,right,Tm4,45,-5,-1,4,-5
720575940633131418,right,Tm4,46,-5,15,12,3
720575940626497352,right,Tm4,47,-9,-1,8,-9
720575940610734229,right,Tm4,48,-4,-22,-7,-15
720575940613481955,right,Tm4,49,4,-4,-6,2
720575940611194322,right,Tm4,50,-2,21,12,9
720575940633356369,right,Tm4,51,0,-19,-10,-9
720575940619639419,right,Tm4,52,-1,-22,-10,-12
720575940626197690,right,Tm4,53,5,14,2,12
720575940608857099,right,Tm4,54,-4,3,5,-2
720575940623207949,right,Tm4,55,-4,-11,-2,-9
720575940636498862,right,Tm4,56,1,-13,-8,-5
720575940606615473,right,Tm4,57,6,-11,-12,1
720575940641971419,right,Tm4,58,3,12,3,9
720575940623260599,right,Tm4,59,-2,2,3,-1
720575940606727945,right,Tm4,60,-8,8,12,-4
720575940615204714,right,Tm4,61,-4,-4,2,-6
720575940625058889,right,Tm4,62,0,-29,-15,-14
720575940621897968,right,Tm4,63,4,12,2,10
720575940623236566,right,Tm4,64,4,-23,-16,-7
720575940619359611,right,Tm4,65,-1,28,15,13
720575940618630469,right,Tm4,66,2,15,5,10
720575940654980769,right,Tm4,67,-2,-13,-5,-8
720575940625308174,right,Tm4,68,3,16,5,11
720575940621915486,right,Tm4,70,-4,21,14,7
720575940629314682,right,Tm4,71,-2,-3,0,-3
720575940629886423,right,Tm4,72,0,-28,-14,-14
720575940619221041,right,Tm4,73,2,2,-1,3
720575940628593143,right,Tm4,75,-6,14,13,1
720575940633371232,right,Tm4,76,-3,-4,1,-5
720575940616333874,right,Tm4,77,2,-5,-5,0
720575940644197064,right,Tm4,78,2,20,8,12
720575940627167640,right,Tm4,79,2,1,-2,3
720575940632510094,right,Tm4,80,4,13,2,11
720575940639488976,right,Tm4,81,6,-2,-7,5
720575940630958122,right,Tm4,82,-7,7,10,-3
720575940635066475,right,Tm4,83,2,-21,-13,-8
720575940638750542,right,Tm4,84,-2,12,8,4
720575940617681108,right,Tm4,85,4,-22,-15,-7
720575940612531442,right,Tm4,86,-5,-7,1,-8
720575940614477999,right,Tm4,87,1,11,4,7
720575940623930153,right,Tm4,88,7,4,-5,9
720575940631653317,right,Tm4,89,1,-19,-11,-8
720575940630193146,right,Tm4,90,-4,5,6,-1
720575940625823577,right,Tm4,91,-1,6,4,2
720575940619923797,right,Tm4,94,5,18,4,14
720575940612460211,right,Tm4,95,4,-21,-15,-6
720575940621373678,right,Tm4,96,1,-10,-6,-4
720575940630598927,right,Tm4,97,-5,2,6,-4
720575940638901181,right,Tm4,98,-1,-12,-5,-7
720575940607287170,right,Tm4,99,4,15,3,12
720575940623445580,right,Tm4,100,2,-10,-7,-3
720575940622680772,right,Tm4,101,-7,6,10,-4
720575940612135010,right,Tm4,102,3,13,3,10
720575940606600638,right,Tm4,104,-1,-27,-13,-14
720575940626025104,right,Tm4,105,3,22,8,14
720575940626091672,right,Tm4,106,-7,11,12,-1
720575940620224116,right,Tm4,107,8,-2,-9,7
720575940624132605,right,Tm4,108,-3,-12,-3,-9
720575940633824225,right,Tm4,109,4,-5,-7,2
720575940630155003,right,Tm4,110,-7,0,7,-7
720575940617432025,right,Tm4,111,2,-24,-14,-10
720575940640665077,right,Tm4,112,-6,1,6,-5
720575940618623572,right,Tm4,113,-2,4,4,0
720575940616529894,right,Tm4,114,2,-13,-9,-4
720575940624656142,right,Tm4,116,-1,-8,-3,-5
720575940614051326,right,Tm4,117,-8,-2,7,-9
720575940644232904,right,Tm4,118,3,1,-3,4
720575940610897762,right,Tm4,119,-2,6,5,1
720575940629915641,right,Tm4,120,-1,-1,0,-1
720575940619674790,right,Tm4,122,-5,9,9,0
720575940621576624,right,Tm4,124,1,-7,-5,-2
720575940622633200,right,Tm4,125,5,9,-1,10
720575940612626650,right,Tm4,126,3,11,2,9
720575940614271903,right,Tm4,127,0,15,7,8
720575940626612228,right,Tm4,128,3,-22,-14,-8
720575940633241937,right,Tm4,129,0,-13,-7,-6
720575940623711305,right,Tm4,130,2,12,4,8
720575940626475526,right,Tm4,131,-6,20,16,4
720575940622239265,right,Tm4,132,2,4,0,4
720575940614166634,right,Tm4,133,-3,20,13,7
720575940641621979,right,Tm4,134,-5,-18,-4,-14
720575940636074863,right,Tm4,135,-3,-22,-8,-14
720575940628133714,right,Tm4,136,0,3,1,2
720575940642596256,right,Tm4,137,5,-7,-9,2
720575940621582401,right,Tm4,138,0,27,13,14
720575940612507890,right,Tm4,139,1,-14,-8,-6
720575940627962142,right,Tm4,140,3,8,1,7
720575940615452063,right,Tm4,142,-2,-18,-7,-11
720575940636819374,right,Tm4,143,-4,16,12,4
720575940631015505,right,Tm4,144,7,-11,-13,2
720575940620323121,right,Tm4,146,1,-6,-4,-2
720575940605223340,right,Tm4,147,1,21,9,12
720575940622775907,right,Tm4,148,-7,-11,1,-12
720575940648274052,right,Tm4,149,6,-14,-13,-1
720575940646285876,right,Tm4,150,-8,5,10,-5
720575940624229449,right,Tm4,151,-3,-14,-4,-10
720575940623042253,right,Tm4,152,3,-15,-11,-4
720575940639752509,right,Tm4,153,8,0,-8,8
720575940631730759,right,Tm4,154,-8,0,8,-8
720575940610289114,right,Tm4,155,-8,13,14,-1
720575940643520200,right,Tm4,156,-9,1,9,-8
720575940621985776,right,Tm4,157,-1,-7,-3,-4
720575940620350844,right,Tm4,158,3,-5,-6,1
720575940621886448,right,Tm4,160,-2,20,12,8
720575940619077174,right,Tm4,161,4,-14,-11,-3
720575940628204028,right,Tm4,162,-4,-2,3,-5
720575940610799566,right,Tm4,163,-9,7,12,-5
720575940637968496,right,Tm4,164,-1,-2,0,-2
720575940628623977,right,Tm4,165,4,16,4,12
720575940622933453,right,Tm4,167,0,-17,-9,-8
720575940629955840,right,Tm4,168,-1,17,9,8
720575940622406825,right,Tm4,169,0,-18,-9,-9
720575940629172303,right,Tm4,170,-5,1,5,-4
720575940645403502,right,Tm4,171,6,-20,-16,-4
720575940613092466,right,Tm4,172,1,22,10,12
720575940612502245,right,Tm4,173,2,-25,-15,-10
720575940647145012,right,Tm4,174,4,-15,-12,-3
720575940618753565,right,Tm4,175,-6,-7,2,-9
720575940617726272,right,Tm4,176,-2,13,8,5
720575940626675538,right,Tm4,177,-2,-1,1,-2
720575940617572642,right,Tm4,178,2,11,3,8
720575940620254891,right,Tm4,179,-5,-16,-3,-13
720575940633496268,right,Tm4,180,2,-27,-16,-11
720575940623920664,right,Tm4,181,1,-4,-3,-1
720575940642459789,right,Tm4,182,7,-10,-12,2
720575940626850393,right,Tm4,183,-5,-15,-3,-12
720575940626366782,right,Tm4,184,-6,-5,3,-8
720575940632837992,right,Tm4,185,2,-11,-8,-3
720575940627035198,right,Tm4,186,-1,26,14,12
720575940605584318,right,Tm4,187,3,21,7,14
720575940642570125,right,Tm4,188,-5,17,13,4
720575940627891784,right,Tm4,189,6,13,0,13
720575940641460944,right,Tm4,190,-3,-5,0,-5
720575940632905017,right,Tm4,191,-1,-11,-5,-6
720575940616061301,right,Tm4,192,7,10,-2,12
720575940631239491,right,Tm4,193,-5,4,7,-3
720575940627372540,right,Tm4,194,0,-5,-3,-2
720575940624248317,right,Tm4,195,-3,-1,2,-3
720575940620804267,right,Tm4,196,-1,8,5,3
720575940639685491,right,Tm4,197,0,-20,-10,-10
720575940631250652,right,Tm4,198,6,2,-5,7
720575940631545923,right,Tm4,199,0,-12,-6,-6
720575940624919482,right,Tm4,200,-5,12,11,1
720575940634622560,right,Tm4,201,-8,9,12,-3
720575940614824338,right,Tm4,202,-1,27,14,13
720575940627465226,right,Tm4,203,3,-1,-4,3
720575940636049775,right,Tm4,204,5,-2,-6,4
720575940617621460,right,Tm4,205,5,-6,-8,2
720575940614224031,right,Tm4,206,-3,5,5,0
720575940622692732,right,Tm4,207,1,29,13,16
720575940624493862,right,Tm4,208,5,-21,-16,-5
720575940604818144,right,Tm4,209,-3,-8,-1,-7
720575940636201061,right,Tm4,210,-6,8,10,-2
720575940636586932,right,Tm4,211,-7,-1,6,-7
720575940637060270,right,Tm4,212,2,-16,-10,-6
720575940626345305,right,Tm4,213,3,-4,-5,1
720575940613964962,right,Tm4,214,-5,3,6,-3
720575940612083427,right,Tm4,216,2,19,7,12
720575940615674770,right,Tm4,218,2,10,3,7
720575940620701978,right,Tm4,219,6,-4,-8,4
720575940627707785,right,Tm4,220,2,-6,-5,-1
720575940627045455,right,Tm4,221,-7,3,8,-5
720575940621893590,right,Tm4,222,-3,26,16,10
720575940627357801,right,Tm4,223,-2,26,15,11
720575940623384344,right,Tm4,224,0,5,2,3
720575940620604399,right,Tm4,225,2,-26,-15,-11
720575940604627889,right,Tm4,226,5,19,4,15
720575940658274433,right,Tm4,228,-7,1,7,-6
720575940621927094,right,Tm4,229,5,2,-4,6
720575940641658357,right,Tm4,230,2,9,2,7
720575940623655974,right,Tm4,231,4,-12,-10,-2
720575940626417027,right,Tm4,232,-4,13,10,3
720575940616565919,right,Tm4,233,4,-13,-11,-2
720575940626407001,right,Tm4,234,1,3,0,3
720575940636543095,right,Tm4,235,4,11,1,10
720575940622287309,right,Tm4,236,-1,4,3,1
720575940624406199,right,Tm4,237,-2,27,15,12
720575940628244094,right,Tm4,238,-8,-3,6,-9
720575940620430574,right,Tm4,239,-6,6,9,-3
720575940640698357,right,Tm4,240,-4,-3,2,-5
720575940644777252,right,Tm4,241,2,-17,-11,-6
720575940618803136,right,Tm4,242,-4,6,7,-1
720575940645207332,right,Tm4,243,-1,-21,-10,-11
720575940622736169,right,Tm4,244,-4,-12,-2,-10
720575940626100112,right,Tm4,245,-5,-3,3,-6
720575940634262684,right,Tm4,247,-4,-15,-4,-11
720575940646292276,right,Tm4,248,-6,0,6,-6
720575940618800088,right,Tm4,249,2,-12,-8,-4
720575940609993592,right,Tm4,250,-1,1,1,0
720575940612566634,right,Tm4,251,-1,-14,-6,-8
720575940616542169,right,Tm4,252,3,23,8,15
720575940639534158,right,Tm4,253,5,16,3,13
720575940638341860,right,Tm4,254,3,-24,-15,-9
720575940633417299,right,Tm4,255,-6,-13,-1,-12
720575940629697530,right,Tm4,256,5,-20,-15,-5
720575940619602648,right,Tm4,257,2,21,8,13
720575940639243573,right,Tm4,258,-4,-17,-5,-12
720575940605258668,right,Tm4,259,-7,-5,4,-9
720575940620069396,right,Tm4,260,-3,19,12,7
720575940629971578,right,Tm4,262,1,-11,-7,-4
720575940625768340,right,Tm4,263,-3,4,5,-1
720575940618568502,right,Tm4,264,-1,-6,-2,-4
720575940620666800,right,Tm4,265,-6,-1,5,-6
720575940644167584,right,Tm4,266,-1,-25,-12,-13
720575940617743429,right,Tm4,267,-6,2,7,-5
720575940617854438,right,Tm4,268,7,-6,-10,4
720575940620518821,right,Tm4,269,2,-19,-12,-7
720575940630220414,right,Tm4,270,1,-8,-5,-3
720575940627862549,right,Tm4,271,4,6,-1,7
720575940635543648,right,Tm4,272,3,-2,-4,2
720575940624867646,right,Tm4,273,-6,23,17,6
720575940615845014,right,Tm4,274,6,4,-4,8
720575940612184872,right,Tm4,275,-8,-1,7,-8
720575940614506961,right,Tm4,276,2,3,-1,4
720575940621819775,right,Tm4,277,7,-3,-9,6
720575940637211189,right,Tm4,278,-5,10,10,0
720575940617435110,right,Tm4,279,-4,8,8,0
720575940629161371,right,Tm4,280,-6,-14,-1,-13
720575940646505326,right,Tm4,281,-9,2,10,-8
720575940620782171,right,Tm4,282,0,26,13,13
720575940630939643,right,Tm4,283,-4,4,6,-2
720575940615720258,right,Tm4,284,0,25,12,13
720575940613568739,right,Tm4,285,6,-18,-15,-3
720575940618097181,right,Tm4,286,0,-24,-12,-12
720575940628171752,right,Tm4,287,-5,13,11,2
720575940627982353,right,Tm4,289,-1,11,6,5
720575940621477296,right,Tm4,290,5,-24,-17,-7
720575940619197504,right,Tm4,291,7,2,-6,8
720575940624215736,right,Tm4,292,-4,18,13,5
720575940644880932,right,Tm4,293,4,-17,-13,-4
720575940630544758,right,Tm4,295,-2,29,16,13
720575940628638146,right,Tm4,296,1,-18,-10,-8
720575940622720517,right,Tm4,298,-5,5,7,-2
720575940636516983,right,Tm4,299,-4,12,10,2
720575940639457333,right,Tm4,300,4,-18,-13,-5
720575940619250415,right,Tm4,301,-5,16,13,3
720575940645220119,right,Tm4,302,2,17,6,11
720575940620113741,right,Tm4,303,-5,22,16,6
720575940616024833,right,Tm4,305,-7,4,9,-5
720575940632372811,right,Tm4,306,3,7,0,7
720575940622145449,right,Tm4,307,5,-25,-18,-7
720575940632443731,right,Tm4,308,-5,8,9,-1
720575940622287031,right,Tm4,309,-6,12,12,0
720575940627415050,right,Tm4,310,2,22,9,13
720575940636290296,right,Tm4,312,4,-7,-8,1
720575940630102010,right,Tm4,313,7,3,-6,9
720575940627065167,right,Tm4,314,-9,5,11,-6
720575940633359187,right,Tm4,315,-3,-6,0,-6
720575940623002136,right,Tm4,316,5,-4,-7,3
720575940635270495,right,Tm4,317,-5,-4,3,-7
720575940625717944,right,Tm4,318,4,-19,-14,-5
720575940633696096,right,Tm4,319,-2,5,4,1
720575940626154629,right,Tm4,320,-2,-5,-1,-4
720575940640776819,right,Tm4,322,2,26,11,15
720575940616942678,right,Tm4,324,3,24,9,15
720575940627923272,right,Tm4,325,5,1,-5,6
720575940632365454,right,Tm4,326,2,16,6,10
720575940620460660,right,Tm4,328,5,-9,-10,1
720575940605942974,right,Tm4,329,0,24,12,12
720575940628769972,right,Tm4,330,3,3,-2,5
720575940627643005,right,Tm4,331,1,-15,-9,-6
720575940631045079,right,Tm4,332,4,-26,-17,-9
720575940625679106,right,Tm4,333,0,-21,-11,-10
720575940630527191,right,Tm4,334,1,-26,-14,-12
720575940638273513,right,Tm4,336,0,23,11,12
720575940620396969,right,Tm4,337,-5,-6,2,-8
720575940606569406,right,Tm4,338,-1,0,1,-1
720575940621140463,right,Tm4,340,-4,17,12,5
720575940627061690,right,Tm4,341,6,-17,-15,-2
720575940617019321,right,Tm4,342,2,-15,-10,-5
720575940638924863,right,Tm4,343,-3,27,16,11
720575940641717133,right,Tm4,344,-2,-15,-6,-9
720575940634824303,right,Tm4,345,3,-12,-9,-3
720575940626054032,right,Tm4,346,-7,-9,2,-11
720575940622186785,right,Tm4,347,-5,-13,-2,-11
720575940624519399,right,Tm4,348,3,14,4,10
720575940633496033,right,Tm4,349,-5,-14,-2,-12
720575940619665323,right,Tm4,350,1,15,6,9
720575940606005682,right,Tm4,351,-1,-17,-8,-9
720575940616082630,right,Tm4,352,-2,28,16,12
720575940634402143,right,Tm4,353,2,24,10,14
720575940619655488,right,Tm4,354,-2,-26,-11,-15
720575940637748669,right,Tm4,355,-7,-6,4,-10
720575940638140506,right,Tm4,356,0,22,11,11
720575940622409712,right,Tm4,357,4,17,4,13
720575940623419627,right,Tm4,358,-3,17,11,6
720575940635902047,right,Tm4,359,2,23,9,14
720575940614484530,right,Tm4,360,-5,19,14,5
720575940639342963,right,Tm4,361,0,-7,-4,-3
720575940621146221,right,Tm4,362,2,-20,-12,-8
720575940616166075,right,Tm4,363,7,-4,-9,5
720575940618670370,right,Tm4,365,4,7,-1,8
720575940621754885,right,Tm4,367,-6,-15,-2,-13
720575940620551662,right,Tm4,368,-4,-20,-6,-14
720575940636051311,right,Tm4,369,5,-5,-8,3
720575940622290570,right,Tm4,370,-3,21,13,8
720575940638074958,right,Tm4,371,6,-5,-9,4
720575940636099435,right,Tm4,372,1,-2,-2,0
720575940616303249,right,Tm4,373,1,-21,-12,-9
720575940620444436,right,Tm4,374,2,13,4,9
720575940621685859,right,Tm4,375,-6,7,9,-2
720575940612723314,right,Tm4,376,-7,-10,2,-12
720575940623440716,right,Tm4,378,-3,18,12,6
720575940620607424,right,Tm4,379,3,-17,-12,-5
720575940621721844,right,Tm4,380,-1,29,15,14
720575940613510038,right,Tm4,381,-8,-9,3,-12
720575940623809212,right,Tm4,382,3,-6,-6,0
720575940627400039,right,Tm4,383,-6,11,11,0
720575940612766873,right,Tm4,384,-6,-2,5,-7
720575940604829152,right,Tm4,385,-3,-18,-6,-12
720575940618511297,right,Tm4,386,-6,19,15,4
720575940628288241,right,Tm4,387,-1,-15,-7,-8
720575940626315820,right,Tm4,388,3,19,6,13
720575940616022066,right,Tm4,389,-6,-16,-2,-14
720575940631205071,right,Tm4,390,-6,-9,1,-10
720575940632442439,right,Tm4,391,4,-3,-6,3
720575940605523145,right,Tm4,392,-4,7,7,0
720575940606202290,right,Tm4,393,-1,22,12,10
720575940612157041,right,Tm4,394,-7,-8,3,-11
720575940626884926,right,Tm4,395,0,-22,-11,-11
720575940625137336,right,Tm4,396,-1,10,6,4
720575940636370807,right,Tm4,397,-3,-19,-7,-12
720575940629906748,right,Tm4,398,-3,22,14,8
720575940637148016,right,Tm4,399,-4,-24,-8,-16
720575940625847783,right,Tm4,400,1,-29,-16,-13
720575940606058668,right,Tm4,401,-2,-19,-8,-11
720575940620873045,right,Tm4,402,3,26,10,16
720575940622620599,right,Tm4,403,-2,-12,-4,-8
720575940627106200,right,Tm4,404,-1,20,11,9
720575940629307648,right,Tm4,405,3,10,2,8
720575940630400719,right,Tm4,406,1,-25,-14,-11
720575940634378265,right,Tm4,407,-5,-10,0,-10
720575940629406971,right,Tm4,408,-6,-4,4,-8
720575940629860603,right,Tm4,409,0,-3,-2,-1
720575940617530717,right,Tm4,410,-2,-2,1,-3
720575940636462313,right,Tm4,412,-6,21,16,5
720575940632086120,right,Tm4,413,-2,-7,-2,-5
720575940620685190,right,Tm4,415,6,12,0,12
720575940627298831,right,Tm4,416,3,-8,-7,-1
720575940615673739,right,Tm4,417,-6,-10,1,-11
720575940623279871,right,Tm4,418,-2,15,9,6
720575940614474642,right,Tm4,419,-3,-11,-3,-8
720575940621455598,right,Tm4,420,6,-3,-8,5
720575940644828782,right,Tm4,422,-7,-4,5,-9
720575940610563374,right,Tm4,423,3,-18,-12,-6
720575940624709564,right,Tm4,424,-3,-2,2,-4
720575940626299436,right,Tm4,425,3,20,7,13
720575940626827353,right,Tm4,426,-3,0,3,-3
720575940630251564,right,Tm4,427,5,-18,-14,-4
720575940617633117,right,Tm4,428,-2,23,13,10
720575940632355384,right,Tm4,429,-2,14,9,5
720575940624724204,right,Tm4,430,-3,-7,-1,-6
720575940630991119,right,Tm4,432,-5,7,8,-1
720575940635419060,right,Tm4,433,0,-8,-4,-4
720575940637763812,right,Tm4,434,-3,7,6,1
720575940625579804,right,Tm4,435,5,-17,-14,-3
720575940614665726,right,Tm4,436,0,-15,-8,-7
720575940618625620,right,Tm4,437,-3,12,9,3
720575940628134312,right,Tm4,438,2,27,11,16
720575940608674825,right,Tm4,439,-3,-9,-2,-7
720575940632469329,right,Tm4,440,1,23,10,13
720575940627825937,right,Tm4,441,3,-16,-11,-5
720575940620300167,right,Tm4,442,-5,25,17,8
720575940627267855,right,Tm4,444,4,-10,-9,-1
720575940652152310,right,Tm4,445,-2,8,6,2
720575940623431411,right,Tm4,446,2,-14,-9,-5
720575940627775562,right,Tm4,447,-1,2,2,0
720575940632578468,right,Tm4,448,0,30,15,15
720575940626489744,right,Tm4,449,6,-16,-14,-2
720575940630510031,right,Tm4,450,2,-9,-7,-2
720575940614724147,right,Tm4,451,4,20,6,14
720575940627963409,right,Tm4,452,1,-9,-6,-3
720575940629572081,right,Tm4,453,3,25,9,16
720575940626752796,right,Tm4,454,5,-12,-11,-1
720575940632255116,right,Tm4,455,7,-7,-11,4
720575940625171495,right,Tm4,456,0,21,10,11
720575940618274845,right,Tm4,457,-2,17,10,7
720575940631397394,right,Tm4,458,5,0,-5,5
720575940612560051,right,Tm4,459,5,-3,-7,4
720575940642595232,right,Tm4,460,-3,-20,-7,-13
720575940640884944,right,Tm4,461,7,-5,-10,5
720575940616312626,right,Tm4,462,-1,18,10,8
720575940623152639,right,Tm4,463,5,17,3,14
720575940638240090,right,Tm4,464,4,0,-4,4
720575940607480962,right,Tm4,465,3,0,-3,3
720575940620636075,right,Tm4,466,1,14,6,8
720575940629757050,right,Tm4,467,-2,-20,-8,-12
720575940633849998,right,Tm4,468,-3,11,8,3
720575940629132239,right,Tm4,469,-7,13,13,0
720575940614910626,right,Tm4,470,4,-9,-9,0
720575940619968561,right,Tm4,471,3,-26,-16,-10
720575940613610642,right,Tm4,472,1,25,11,14
720575940638255081,right,Tm4,473,-4,23,15,8
720575940608363100,right,Tm4,474,-3,-17,-6,-11
720575940627319464,right,Tm4,475,-4,-1,3,-4
720575940617530485,right,Tm4,477,-3,2,4,-2
720575940627131692,right,Tm4,479,-2,10,7,3
720575940624058409,right,Tm4,480,3,-19,-13,-6
720575940636585079,right,Tm4,481,4,-8,-8,0
720575940631912775,right,Tm4,482,1,17,7,10
720575940640620240,right,Tm4,483,2,-7,-6,-1
720575940622742279,right,Tm4,484,3,-9,-8,-1
720575940615790139,right,Tm4,485,-3,-3,1,-4
720575940642947636,right,Tm4,487,1,-1,-2,1
720575940634061664,right,Tm4,489,-3,10,8,2
720575940624478901,right,Tm4,490,-5,6,8,-2
720575940620390741,right,Tm4,491,7,-1,-8,7
720575940642958884,right,Tm4,492,-7,-2,6,-8
720575940620760923,right,Tm4,493,-3,23,14,9
720575940637976666,right,Tm4,494,0,29,14,15
720575940614848977,right,Tm4,497,6,1,-6,7
720575940616911243,right,Tm4,498,6,10,-1,11
720575940626038416,right,Tm4,499,5,10,0,10
720575940621839130,right,Tm4,500,7,-8,-11,3
720575940628718097,right,Tm4,501,1,2,0,2
720575940630013690,right,Tm4,502,5,8,-1,9
720575940605914470,right,Tm4,503,3,17,5,12
720575940650413177,right,Tm4,504,-2,9,6,3
720575940637967728,right,Tm4,506,1,-12,-7,-5
720575940628882960,right,Tm4,507,-5,-12,-1,-11
720575940622088375,right,Tm4,508,-5,11,10,1
720575940624056979,right,Tm4,509,-4,10,9,1
720575940622158889,right,Tm4,510,-2,11,7,4
720575940609819950,right,Tm4,511,5,-11,-11,0
720575940623820643,right,Tm4,512,6,0,-6,6
720575940626378896,right,Tm4,513,-4,-13,-3,-10
720575940636681358,right,Tm4,514,-4,-10,-1,-9
720575940627138545,right,Tm4,515,-8,-7,4,-11
720575940619453204,right,Tm4,517,6,3,-5,8
720575940639890365,right,Tm4,518,-4,22,15,7
720575940641596891,right,Tm4,519,-5,-5,2,-7
720575940635529140,right,Tm4,520,-2,-22,-9,-13
720575940621960063,right,Tm4,521,6,-9,-11,2
720575940619982501,right,Tm4,522,-4,0,4,-4
720575940627400220,right,Tm4,523,2,14,5,9
720575940622269418,right,Tm4,524,4,-20,-14,-6
720575940635344279,right,Tm4,525,-1,-20,-9,-11
720575940621806113,right,Tm4,526,0,-10,-5,-5
720575940620319215,right,Tm4,527,-4,-8,0,-8
720575940632337170,right,Tm4,528,2,7,1,6
720575940616178293,right,Tm4,529,2,-2,-3,1
720575940633639776,right,Tm4,530,-3,-13,-4,-9
720575940623982435,right,Tm4,531,1,0,-1,1
720575940628457410,right,Tm4,532,-8,7,11,-4
720575940614191535,right,Tm4,533,0,-16,-8,-8
720575940624288148,right,Tm4,534,3,2,-2,4
720575940622177630,right,Tm4,535,8,-4,-10,6
720575940616524731,right,Tm4,536,3,4,-1,5
720575940639869501,right,Tm4,537,0,-23,-12,-11
720575940613777662,right,Tm4,538,-4,1,4,-3
720575940633394830,right,Tm4,539,-6,15,13,2
720575940631150556,right,Tm4,540,-2,-9,-3,-6
720575940630712028,right,Tm4,541,-4,14,11,3
720575940618252445,right,Tm4,542,6,-13,-13,0
720575940637137520,right,Tm4,543,-1,-4,-1,-3
720575940639645766,right,Tm4,544,3,-13,-10,-3
720575940617421083,right,Tm4,545,5,11,0,11
720575940631923754,right,Tm4,546,3,6,0,6
720575940620989632,right,Tm4,547,-1,21,11,10
720575940628337171,right,Tm4,548,1,-16,-9,-7
720575940612219761,right,Tm4,549,0,-9,-5,-4
720575940627052681,right,Tm4,551,-4,-9,-1,-8
720575940631708921,right,Tm4,552,4,-1,-5,4
720575940623714186,right,Tm4,553,-3,16,11,5
720575940616971193,right,Tm4,554,-9,-3,7,-10
720575940629962693,right,Tm4,555,-4,9,8,1
720575940611174354,right,Tm4,556,0,10,5,5
720575940627418122,right,Tm4,557,6,-10,-11,1
720575940616866699,right,Tm4,558,-4,-21,-7,-14
720575940610602213,right,Tm4,559,-6,22,17,5
720575940617177211,right,Tm4,560,-7,14,14,0
720575940627450899,right,Tm4,561,5,7,-2,9
720575940616844761,right,Tm4,562,-5,-2,4,-6
720575940614780327,right,Tm4,563,5,-13,-12,-1
720575940606292512,right,Tm4,564,3,-23,-15,-8
720575940629694330,right,Tm4,565,0,-26,-13,-13
720575940633761188,right,Tm4,566,5,-8,-9,1
720575940626792292,right,Tm4,567,-2,22,13,9
720575940639017279,right,Tm4,568,-6,-8,2,-10
720575940618867357,right,Tm4,569,6,6,-3,9
720575940625041639,right,Tm4,570,2,25,10,15
720575940606216480,right,Tm4,571,0,-14,-7,-7
720575940606197961,right,Tm4,572,-8,3,9,-6
720575940618165917,right,Tm4,573,4,14,3,11
720575940628073216,right,Tm4,574,-6,5,8,-3
720575940649445753,right,Tm4,575,6,9,-2,11
720575940620745163,right,Tm4,576,0,28,14,14
720575940624738231,right,Tm4,577,5,-14,-12,-2
720575940632959443,right,Tm4,578,4,-11,-10,-1
720575940626176458,right,Tm4,579,-3,-10,-2,-8
720575940614469010,right,Tm4,580,-2,-23,-10,-13
720575940638118622,right,Tm4,581,3,9,1,8
720575940618211101,right,Tm4,582,-1,23,12,11
720575940619096886,right,Tm4,583,3,-25,-16,-9
720575940635971679,right,Tm4,584,4,23,7,16
720575940641250944,right,Tm4,585,-1,-23,-11,-12
720575940646228788,right,Tm4,586,2,18,7,11
720575940617707328,right,Tm4,587,4,22,7,15
720575940624630279,right,Tm4,588,1,4,1,3
720575940622076329,right,Tm4,589,-1,-5,-2,-3
720575940623255821,right,Tm4,590,1,9,3,6
720575940618622804,right,Tm4,591,3,-3,-5,2
720575940605477041,right,Tm4,593,3,-14,-10,-4
720575940604658912,right,Tm4,594,7,-16,-15,-1
720575940618157908,right,Tm4,595,7,-12,-13,1
720575940618037845,right,Tm4,596,-4,-16,-4,-12
720575940624280317,right,Tm4,597,4,1,-4,5
720575940620940015,right,Tm4,598,2,-18,-11,-7
720575940615737503,right,Tm4,599,-1,9,5,4
720575940622476156,right,Tm4,600,3,-10,-8,-2
720575940630267035,right,Tm4,601,1,16,7,9
720575940643520564,right,Tm4,602,4,-2,-5,3
720575940610200533,right,Tm4,603,-3,-23,-9,-14
720575940614936682,right,Tm4,604,-6,-17,-3,-14
720575940645654638,right,Tm4,605,3,15,4,11
720575940618490929,right,Tm4,606,-1,-19,-9,-10
720575940640259662,right,Tm4,608,1,10,4,6
720575940616128907,right,Tm4,609,-2,0,2,-2
720575940618171165,right,Tm4,610,2,-23,-14,-9
720575940613863599,right,Tm4,611,-1,-18,-8,-10
720575940620244053,right,Tm4,614,-2,-8,-2,-6
720575940642701256,right,Tm4,615,-7,-7,3,-10
720575940640081240,right,Tm4,616,-3,15,10,5
720575940634844351,right,Tm4,617,-2,-17,-7,-10
720575940631619468,right,Tm4,618,-1,24,13,11
720575940618981534,right,Tm4,620,7,1,-7,8
720575940625442492,right,Tm4,621,1,24,11,13
720575940644879908,right,Tm4,622,-5,20,15,5
720575940637405614,right,Tm4,624,1,-17,-10,-7
720575940610178884,right,Tm4,625,-2,24,14,10
720575940616735605,right,Tm4,626,-5,-8,1,-9
720575940627810576,right,Tm4,627,0,-1,-1,0
720575940623683854,right,Tm4,628,0,0,0,0
720575940636757902,right,Tm4,629,4,24,8,16
720575940608384860,right,Tm4,630,4,8,0,8
720575940640871376,right,Tm4,631,1,26,12,14
720575940618371028,right,Tm4,632,3,-20,-13,-7
720575940631102295,right,Tm4,633,-1,-24,-11,-13
720575940622407050,right,Tm4,634,-3,-15,-5,-10
720575940623682440,right,Tm4,635,6,-6,-9,3
720575940623170774,right,Tm4,636,0,6,3,3
720575940603934892,right,Tm4,637,3,-21,-14,-7
720575940621087470,right,Tm4,639,-4,19,13,6
720575940623233100,right,Tm4,640,-1,-16,-7,-9
720575940622977002,right,Tm4,641,-8,-5,5,-10
720575940613685043,right,Tm4,642,-5,-11,-1,-10
720575940605962370,right,Tm4,643,6,14,1,13
720575940625995780,right,Tm4,644,-6,18,15,3
720575940612775065,right,Tm4,645,-4,27,17,10
720575940652662262,right,Tm4,647,-4,-7,0,-7
720575940617111894,right,Tm4,650,-3,-25,-10,-15
720575940618290077,right,Tm4,651,-4,-5,1,-6
720575940622956131,right,Tm4,652,-6,-11,0,-11
720575940619386203,right,Tm4,653,-6,-12,0,-12
720575940633940366,right,Tm4,654,-3,8,7,1
720575940627872503,right,Tm4,655,6,-1,-7,6
720575940630344300,right,Tm4,656,0,-11,-6,-5
720575940640304437,right,Tm4,657,-2,-25,-11,-14
720575940638258522,right,Tm4,658,1,20,9,11
720575940624796874,right,Tm4,659,-4,-6,1,-7
720575940624923320,right,Tm4,660,2,28,12,16
720575940624215477,right,Tm4,661,-3,14,10,4
720575940652141558,right,Tm4,662,2,-1,-3,2
720575940623432572,right,Tm4,663,0,8,4,4
720575940623304216,right,Tm4,664,1,-27,-15,-12
720575940623115107,right,Tm4,665,7,-2,-8,6
720575940635025599,right,Tm4,667,1,-28,-15,-13
720575940625827476,right,Tm4,668,1,19,8,11
720575940609045443,right,Tm4,669,4,-16,-12,-4
720575940620309419,right,Tm4,671,-4,-23,-8,-15
720575940628727556,right,Tm4,672,-8,11,13,-2
720575940612819891,right,Tm4,673,2,5,0,5
720575940626653188,right,Tm4,674,-4,-14,-3,-11
720575940611482226,right,Tm4,675,-7,19,16,3
720575940623322879,right,Tm4,676,-3,-21,-8,-13
720575940634726079,right,Tm4,677,0,11,5,6
720575940616415419,right,Tm4,678,3,-7,-7,0
720575940627069242,right,Tm4,679,4,18,5,13
720575940639445582,right,Tm4,680,-1,25,13,12
720575940617608053,right,Tm4,681,-2,-21,-9,-12
720575940637511869,right,Tm4,682,6,-8,-10,2
720575940620093489,right,Tm4,683,2,6,1,5
720575940626335588,right,Tm4,684,-6,17,14,3
720575940620557446,right,Tm4,685,-5,-9,0,-9
720575940620409364,right,Tm4,686,5,-22,-16,-6
720575940626893208,right,Tm4,687,-6,-3,4,-7
720575940616130719,right,Tm4,688,-7,10,12,-2
720575940622314665,right,Tm4,689,-2,18,11,7
720575940619455829,right,Tm4,690,-7,-3,5,-8
720575940630540599,right,Tm4,691,-9,4,11,-7
720575940631930334,right,Tm4,692,-4,24,16,8
720575940623806908,right,Tm4,693,-3,25,15,10
720575940630736844,right,Tm4,695,-6,10,11,-1
720575940616606550,right,Tm4,696,-2,16,10,6
720575940612925866,right,Tm4,697,1,-22,-12,-10
720575940607090633,right,Tm4,698,6,-7,-10,3
720575940646325300,right,Tm4,699,-5,0,5,-5
720575940629317376,right,Tm4,700,5,15,2,13
720575940617182235,right,Tm4,701,0,-4,-2,-2
720575940623713939,right,Tm4,702,-5,23,16,7
720575940636783727,right,Tm4,703,-3,1,3,-2
720575940607111893,right,Tm4,704,-7,8,11,-3
720575940630390826,right,Tm4,705,1,1,-1,2
720575940632637999,right,Tm4,707,-2,25,14,11
720575940639660110,right,Tm4,709,-2,-24,-10,-14
720575940633195053,right,Tm4,710,4,-25,-17,-8
720575940629192527,right,Tm4,711,-1,19,10,9
720575940614095144,right,Tm4,712,-7,12,13,-1
720575940629800645,right,Tm4,714,5,12,1,11
720575940607129218,right,Tm4,715,4,10,1,9
720575940624217269,right,Tm4,716,4,-6,-7,1
720575940611419512,right,Tm4,717,2,-22,-13,-9
720575940633570702,right,Tm4,720,-5,21,15,6
720575940620063435,right,Tm4,722,6,-15,-14,-1
720575940616292241,right,Tm4,723,-2,-11,-4,-7
720575940632177706,right,Tm4,724,4,2,-3,5
720575940635171947,right,Tm4,725,-3,-24,-9,-15
720575940626761561,right,Tm4,728,7,12,-1,13
720575940640089984,right,Tm4,729,-3,29,17,12
720575940628747564,right,Tm4,730,7,0,-7,7
720575940625704714,right,Tm4,731,-6,9,10,-1
720575940617637003,right,Tm4,732,-3,6,6,0
720575940641601499,right,Tm4,733,-5,-17,-4,-13
720575940619073334,right,Tm4,734,2,0,-2,2
720575940630229760,right,Tm4,735,1,-23,-13,-10
720575940623218360,right,Tm4,736,-8,1,8,-7
720575940628223996,right,Tm4,737,0,19,9,10
720575940635194778,right,Tm4,738,-3,13,9,4
720575940630831738,right,Tm4,740,2,-8,-6,-2
720575940630218967,right,Tm4,741,-2,-14,-5,-9
720575940625197351,right,Tm4,742,-4,11,9,2
720575940614354129,right,Tm4,744,-4,25,16,9
720575940632205330,right,Tm4,745,0,13,6,7
720575940642461837,right,Tm4,746,-3,3,4,-1
720575940612667042,right,Tm4,747,0,2,1,1
720575940634888343,right,Tm4,748,-4,20,14,6
720575940625337290,right,Tm4,749,-2,1,2,-1
720575940620157269,right,Tm4,750,4,-24,-16,-8
720575940609772757,right,Tm4,751,1,6,2,4
720575940623260853,right,Tm4,752,-2,7,5,2
720575940616025100,right,Tm4,753,-3,24,15,9
720575940622102966,right,Tm4,754,-1,-13,-6,-7
720575940620725952,right,Tm4,755,4,19,5,14
720575940628346186,right,Tm4,756,5,20,5,15
720575940614125822,right,Tm4,757,0,-6,-3,-3
720575940612701354,right,Tm4,758,5,-1,-6,5
720575940609482947,right,Tm4,759,7,14,0,14
720575940633809306,right,Tm4,760,0,17,8,9
720575940612394931,right,Tm4,761,-4,-18,-5,-13
720575940617266571,right,Tm4,762,0,14,7,7
720575940636835910,right,Tm4,763,-5,14,12,2
720575940607594197,right,Tm4,764,-8,-6,5,-11
720575940629975868,right,Tm4,765,-3,9,7,2
720575940613165223,right,Tm4,766,2,-4,-4,0
720575940617429977,right,Tm4,767,1,28,13,15
720575940639908467,right,Tm4,768,3,5,-1,6
720575940624218119,right,Tm4,769,4,-27,-18,-9
720575940610646897,right,Tm4,771,3,-27,-17,-10
720575940634686304,right,Tm4,772,1,12,5,7
720575940628006824,right,Tm4,773,5,-19,-15,-4
720575940611706176,right,Tm4,774,-8,6,11,-5
720575940632069944,right,Tm4,775,5,22,6,16
720575940621070318,right,Tm4,776,5,21,5,16
720575940629385086,right,Tm4,777,6,20,4,16
720575940616852411,right,Tm4,778,4,25,8,17
720575940614230993,right,Tm4,779,5,24,7,17
720575940624633783,right,Tm4,780,-6,25,18,7
720575940611025784,right,Tm4,781,-5,26,18,8
720575940623959852,right,Tm4,783,-4,28,18,10
720575940633520526,right,Tm4,784,-4,29,18,11
720575940623976803,right,Tm4,786,-2,30,17,13
720575940636521591,right,Tm4,787,3,28,11,17
720575940628593169,right,Tm4,790,-2,-27,-12,-15
720575940624310013,right,Tm4,791,-1,-28,-13,-15
720575940626781672,right,Tm4,792,8,2,-7,9
720575940624016362,right,Tm4,795,6,-21,-17,-4
720575940625842320,right,Tm4,796,4,26,9,17
720575940622927541,right,Tm9,1,-6,13,12,1
720575940630930259,right,Tm9,2,-8,2,9,-7
720575940631502035,right,Tm9,3,6,-12,-12,0
720575940638773062,right,Tm9,4,-5,-21,-6,-15
720575940634202780,right,Tm9,5,-1,16,9,7
720575940615681804,right,Tm9,6,-2,-4,0,-4
720575940645323630,right,Tm9,7,-6,-6,3,-9
720575940630086188,right,Tm9,8,-4,26,17,9
720575940625679596,right,Tm9,9,4,9,0,9
720575940615234015,right,Tm9,10,5,-15,-13,-2
720575940626039315,right,Tm9,11,7,-14,-14,0
720575940631997752,right,Tm9,13,-1,-26,-12,-14
720575940631177231,right,Tm9,14,0,-27,-14,-13
720575940638584372,right,Tm9,15,2,-3,-4,1
720575940646763316,right,Tm9,16,-2,-16,-6,-10
720575940628906795,right,Tm9,17,1,-5,-4,-1
720575940627471887,right,Tm9,18,5,-16,-13,-3
720575940618601729,right,Tm9,19,-7,17,15,2
720575940637550221,right,Tm9,20,3,-11,-9,-2
720575940633362131,right,Tm9,21,-2,19,11,8
720575940611600298,right,Tm9,22,-1,3,2,1
720575940634723735,right,Tm9,23,-3,-16,-5,-11
720575940622941181,right,Tm9,24,-1,-10,-4,-6
720575940646290228,right,Tm9,25,-9,3,10,-7
720575940643866528,right,Tm9,26,1,-3,-3,0
720575940622505332,right,Tm9,27,0,-25,-13,-12
720575940636902767,right,Tm9,28,5,6,-2,8
720575940638249791,right,Tm9,29,-1,-3,-1,-2
720575940630779919,right,Tm9,30,6,16,2,14
720575940620810406,right,Tm9,31,0,16,8,8
720575940611754850,right,Tm9,32,0,12,6,6
720575940620425808,right,Tm9,33,3,18,6,12
720575940628437736,right,Tm9,34,6,18,3,15
720575940624735207,right,Tm9,35,1,-24,-13,-11
720575940619989383,right,Tm9,36,6,8,-2,10
720575940628791568,right,Tm9,38,0,-2,-1,-1
720575940641374861,right,Tm9,39,0,20,10,10
720575940623305107,right,Tm9,40,-2,-6,-1,-5
720575940605017260,right,Tm9,41,-3,28,17,11
720575940625355853,right,Tm9,43,-5,18,14,4
720575940618377029,right,Tm9,44,5,-10,-10,0
720575940632685516,right,Tm9,45,-5,-1,4,-5
720575940615901115,right,Tm9,46,-5,15,12,3
720575940612424470,right,Tm9,47,-9,-1,8,-9
720575940627756304,right,Tm9,48,-4,-22,-7,-15
720575940624447015,right,Tm9,49,4,-4,-6,2
720575940612657522,right,Tm9,50,-2,21,12,9
720575940622375894,right,Tm9,51,0,-19,-10,-9
720575940622375382,right,Tm9,52,-1,-22,-10,-12
720575940627175671,right,Tm9,53,5,14,2,12
720575940623407556,right,Tm9,54,-4,3,5,-2
720575940619815559,right,Tm9,55,-4,-11,-2,-9
720575940627342408,right,Tm9,56,1,-13,-8,-5
720575940612911283,right,Tm9,57,6,-11,-12,1
720575940622001833,right,Tm9,58,3,12,3,9
720575940629202298,right,Tm9,59,-2,2,3,-1
720575940626856496,right,Tm9,61,-4,-4,2,-6
720575940611861710,right,Tm9,62,0,-29,-15,-14
720575940626036922,right,Tm9,63,4,12,2,10
720575940624794888,right,Tm9,64,4,-23,-16,-7
720575940621332406,right,Tm9,65,-1,28,15,13
720575940616025542,right,Tm9,66,2,15,5,10
720575940627187849,right,Tm9,67,-2,-13,-5,-8
720575940635034719,right,Tm9,68,3,16,5,11
720575940613052330,right,Tm9,69,1,8,3,5
720575940614848658,right,Tm9,70,-4,21,14,7
720575940631225943,right,Tm9,71,-2,-3,0,-3
720575940637894110,right,Tm9,72,0,-28,-14,-14
720575940628721307,right,Tm9,73,2,2,-1,3
720575940614110673,right,Tm9,74,-1,-9,-4,-5
720575940652191990,right,Tm9,75,-6,14,13,1
720575940629883077,right,Tm9,76,-3,-4,1,-5
720575940638314330,right,Tm9,77,2,-5,-5,0
720575940615655730,right,Tm9,78,2,20,8,12
720575940642642996,right,Tm9,79,2,1,-2,3
720575940627990020,right,Tm9,80,4,13,2,11
720575940622223273,right,Tm9,81,6,-2,-7,5
720575940620017573,right,Tm9,82,-7,7,10,-3
720575940635068441,right,Tm9,83,2,-21,-13,-8
720575940629989635,right,Tm9,84,-2,12,8,4
720575940627787780,right,Tm9,85,4,-22,-15,-7
720575940616030770,right,Tm9,86,-5,-7,1,-8
720575940640913037,right,Tm9,87,1,11,4,7
720575940635061695,right,Tm9,88,7,4,-5,9
720575940617195579,right,Tm9,89,1,-19,-11,-8
720575940632213646,right,Tm9,90,-4,5,6,-1
720575940620556225,right,Tm9,91,-1,6,4,2
720575940629161724,right,Tm9,92,0,9,4,5
720575940625903678,right,Tm9,93,-6,3,7,-4
720575940623045512,right,Tm9,94,5,18,4,14
720575940619677166,right,Tm9,95,4,-21,-15,-6
720575940620413376,right,Tm9,96,1,-10,-6,-4
720575940612404502,right,Tm9,97,-5,2,6,-4
720575940631381975,right,Tm9,98,-1,-12,-5,-7
720575940630862799,right,Tm9,99,4,15,3,12
720575940626098725,right,Tm9,100,2,-10,-7,-3
720575940617597597,right,Tm9,101,-7,6,10,-4
720575940627513105,right,Tm9,102,3,13,3,10
720575940638752838,right,Tm9,104,-1,-27,-13,-14
720575940626549020,right,Tm9,105,3,22,8,14
720575940638607167,right,Tm9,106,-7,11,12,-1
720575940639898420,right,Tm9,107,8,-2,-9,7
720575940608295726,right,Tm9,108,-3,-12,-3,-9
720575940624919994,right,Tm9,109,4,-5,-7,2
720575940633726364,right,Tm9,110,-7,0,7,-7
720575940624636647,right,Tm9,111,2,-24,-14,-10
720575940638698842,right,Tm9,112,-6,1,6,-5
720575940604810208,right,Tm9,113,-2,4,4,0
720575940632565075,right,Tm9,114,2,-13,-9,-4
720575940615974854,right,Tm9,115,-4,2,5,-3
720575940621899269,right,Tm9,116,-1,-8,-3,-5
720575940659627137,right,Tm9,117,-8,-2,7,-9
720575940623629035,right,Tm9,118,3,1,-3,4
720575940610445922,right,Tm9,119,-2,6,5,1
720575940616301497,right,Tm9,120,-1,-1,0,-1
720575940612645234,right,Tm9,121,-8,4,10,-6
720575940619169752,right,Tm9,122,-5,9,9,0
720575940612989297,right,Tm9,124,1,-7,-5,-2
720575940619409232,right,Tm9,125,5,9,-1,10
720575940623245053,right,Tm9,126,3,11,2,9
720575940609798386,right,Tm9,127,0,15,7,8
720575940635099487,right,Tm9,128,3,-22,-14,-8
720575940647336068,right,Tm9,129,0,-13,-7,-6
720575940614168291,right,Tm9,130,2,12,4,8
720575940631014487,right,Tm9,131,-6,20,16,4
720575940626884652,right,Tm9,133,-3,20,13,7
720575940645463406,right,Tm9,134,-5,-18,-4,-14
720575940621211584,right,Tm9,135,-3,-22,-8,-14
720575940633243949,right,Tm9,136,0,3,1,2
720575940618294557,right,Tm9,137,5,-7,-9,2
720575940609254851,right,Tm9,138,0,27,13,14
720575940622773375,right,Tm9,139,1,-14,-8,-6
720575940624161975,right,Tm9,140,3,8,1,7
720575940630982711,right,Tm9,142,-2,-18,-7,-11
720575940612399986,right,Tm9,143,-4,16,12,4
720575940612861462,right,Tm9,144,7,-11,-13,2
720575940633004755,right,Tm9,145,0,4,2,2
720575940635000767,right,Tm9,146,1,-6,-4,-2
720575940617991764,right,Tm9,147,1,21,9,12
720575940628793329,right,Tm9,148,-7,-11,1,-12
720575940633825505,right,Tm9,149,6,-14,-13,-1
720575940613479074,right,Tm9,150,-8,5,10,-5
720575940627807877,right,Tm9,151,-3,-14,-4,-10
720575940618093888,right,Tm9,152,3,-15,-11,-4
720575940606095550,right,Tm9,153,8,0,-8,8
720575940630668871,right,Tm9,154,-8,0,8,-8
720575940628703079,right,Tm9,156,-9,1,9,-8
720575940609936139,right,Tm9,157,-1,-7,-3,-4
720575940632064331,right,Tm9,158,3,-5,-6,1
720575940620517312,right,Tm9,159,7,7,-4,11
720575940631873863,right,Tm9,160,-2,20,12,8
720575940618727760,right,Tm9,161,4,-14,-11,-3
720575940628552091,right,Tm9,162,-4,-2,3,-5
720575940622621990,right,Tm9,164,-1,-2,0,-2
720575940617507001,right,Tm9,165,4,16,4,12
720575940623442824,right,Tm9,166,0,18,9,9
720575940630925686,right,Tm9,167,0,-17,-9,-8
720575940647564932,right,Tm9,168,-1,17,9,8
720575940617143611,right,Tm9,169,0,-18,-9,-9
720575940640967413,right,Tm9,170,-5,1,5,-4
720575940626001296,right,Tm9,171,6,-20,-16,-4
720575940636348011,right,Tm9,172,1,22,10,12
720575940626935378,right,Tm9,173,2,-25,-15,-10
720575940620204678,right,Tm9,174,4,-15,-12,-3
720575940610014674,right,Tm9,175,-6,-7,2,-9
720575940626010652,right,Tm9,176,-2,13,8,5
720575940639136600,right,Tm9,177,-2,-1,1,-2
720575940624240580,right,Tm9,178,2,11,3,8
720575940640311971,right,Tm9,179,-5,-16,-3,-13
720575940616973836,right,Tm9,180,2,-27,-16,-11
720575940632916783,right,Tm9,181,1,-4,-3,-1
720575940616410909,right,Tm9,182,7,-10,-12,2
720575940638118975,right,Tm9,183,-5,-15,-3,-12
720575940621858943,right,Tm9,184,-6,-5,3,-8
720575940616149209,right,Tm9,185,2,-11,-8,-3
720575940633303648,right,Tm9,186,-1,26,14,12
720575940614873775,right,Tm9,187,3,21,7,14
720575940643763656,right,Tm9,188,-5,17,13,4
720575940630386679,right,Tm9,189,6,13,0,13
720575940615463327,right,Tm9,190,-3,-5,0,-5
720575940626985482,right,Tm9,191,-1,-11,-5,-6
720575940617614809,right,Tm9,192,7,10,-2,12
720575940625529381,right,Tm9,193,-5,4,7,-3
720575940624434320,right,Tm9,194,0,-5,-3,-2
720575940616682530,right,Tm9,195,-3,-1,2,-3
720575940630638073,right,Tm9,196,-1,8,5,3
720575940619812555,right,Tm9,197,0,-20,-10,-10
720575940631049291,right,Tm9,198,6,2,-5,7
720575940623587939,right,Tm9,199,0,-12,-6,-6
720575940621711128,right,Tm9,200,-5,12,11,1
720575940639382131,right,Tm9,201,-8,9,12,-3
720575940630942551,right,Tm9,202,-1,27,14,13
720575940642871604,right,Tm9,203,3,-1,-4,3
720575940642371981,right,Tm9,204,5,-2,-6,4
720575940640435152,right,Tm9,205,5,-6,-8,2
720575940618689950,right,Tm9,206,-3,5,5,0
720575940616384742,right,Tm9,207,1,29,13,16
720575940614705319,right,Tm9,208,5,-21,-16,-5
720575940620285861,right,Tm9,209,-3,-8,-1,-7
720575940612782899,right,Tm9,210,-6,8,10,-2
720575940621360349,right,Tm9,211,-7,-1,6,-7
720575940627174415,right,Tm9,212,2,-16,-10,-6
720575940626344510,right,Tm9,213,3,-4,-5,1
720575940621683494,right,Tm9,214,-5,3,6,-3
720575940621218324,right,Tm9,215,6,7,-3,10
720575940624613680,right,Tm9,216,2,19,7,12
720575940623720842,right,Tm9,217,6,15,1,14
720575940620083280,right,Tm9,218,2,10,3,7
720575940608690443,right,Tm9,219,6,-4,-8,4
720575940637834867,right,Tm9,220,2,-6,-5,-1
720575940609437653,right,Tm9,221,-7,3,8,-5
720575940625006855,right,Tm9,222,-3,26,16,10
720575940619959472,right,Tm9,223,-2,26,15,11
720575940621766365,right,Tm9,224,0,5,2,3
720575940615680874,right,Tm9,225,2,-26,-15,-11
720575940621678463,right,Tm9,226,5,19,4,15
720575940614270189,right,Tm9,227,-7,5,9,-4
720575940614233263,right,Tm9,228,-7,1,7,-6
720575940623444723,right,Tm9,229,5,2,-4,6
720575940631542646,right,Tm9,230,2,9,2,7
720575940622667784,right,Tm9,231,4,-12,-10,-2
720575940647437108,right,Tm9,232,-4,13,10,3
720575940619784545,right,Tm9,233,4,-13,-11,-2
720575940642842676,right,Tm9,234,1,3,0,3
720575940608543580,right,Tm9,235,4,11,1,10
720575940620550491,right,Tm9,236,-1,4,3,1
720575940628857387,right,Tm9,237,-2,27,15,12
720575940619813217,right,Tm9,238,-8,-3,6,-9
720575940632014673,right,Tm9,239,-6,6,9,-3
720575940626401869,right,Tm9,240,-4,-3,2,-5
720575940605783584,right,Tm9,241,2,-17,-11,-6
720575940613618216,right,Tm9,242,-4,6,7,-1
720575940610726776,right,Tm9,243,-1,-21,-10,-11
720575940624063669,right,Tm9,244,-4,-12,-2,-10
720575940639983192,right,Tm9,245,-5,-3,3,-6
720575940625769418,right,Tm9,246,-4,15,11,4
720575940638641478,right,Tm9,247,-4,-15,-4,-11
720575940614527594,right,Tm9,248,-6,0,6,-6
720575940629511874,right,Tm9,249,2,-12,-8,-4
720575940641625741,right,Tm9,250,-1,1,1,0
720575940608295433,right,Tm9,251,-1,-14,-6,-8
720575940634666847,right,Tm9,252,3,23,8,15
720575940618549061,right,Tm9,253,5,16,3,13
720575940605128550,right,Tm9,254,3,-24,-15,-9
720575940616141785,right,Tm9,255,-6,-13,-1,-12
720575940631087311,right,Tm9,256,5,-20,-15,-5
720575940623573292,right,Tm9,257,2,21,8,13
720575940620433345,right,Tm9,258,-4,-17,-5,-12
720575940635742063,right,Tm9,259,-7,-5,4,-9
720575940637854015,right,Tm9,260,-3,19,12,7
720575940627291578,right,Tm9,261,-1,13,7,6
720575940602880736,right,Tm9,262,1,-11,-7,-4
720575940628821520,right,Tm9,263,-3,4,5,-1
720575940612908054,right,Tm9,264,-1,-6,-2,-4
720575940630105964,right,Tm9,265,-6,-1,5,-6
720575940616575500,right,Tm9,266,-1,-25,-12,-13
720575940616595515,right,Tm9,267,-6,2,7,-5
720575940640563315,right,Tm9,268,7,-6,-10,4
720575940644891927,right,Tm9,269,2,-19,-12,-7
720575940635266411,right,Tm9,270,1,-8,-5,-3
720575940642701876,right,Tm9,272,3,-2,-4,2
720575940626258874,right,Tm9,273,-6,23,17,6
720575940642562267,right,Tm9,274,6,4,-4,8
720575940629900252,right,Tm9,275,-8,-1,7,-8
720575940633538771,right,Tm9,276,2,3,-1,4
720575940630462684,right,Tm9,277,7,-3,-9,6
720575940629851514,right,Tm9,278,-5,10,10,0
720575940614667462,right,Tm9,279,-4,8,8,0
720575940626579087,right,Tm9,280,-6,-14,-1,-13
720575940636216553,right,Tm9,281,-9,2,10,-8
720575940626578965,right,Tm9,282,0,26,13,13
720575940622802695,right,Tm9,283,-4,4,6,-2
720575940626242348,right,Tm9,284,0,25,12,13
720575940635924190,right,Tm9,285,6,-18,-15,-3
720575940632783673,right,Tm9,286,0,-24,-12,-12
720575940630963275,right,Tm9,287,-5,13,11,2
720575940655683489,right,Tm9,288,-1,30,16,14
720575940623472068,right,Tm9,291,7,2,-6,8
720575940621810949,right,Tm9,292,-4,18,13,5
720575940621604822,right,Tm9,293,4,-17,-13,-4
720575940627284666,right,Tm9,294,1,-20,-11,-9
720575940616813142,right,Tm9,295,-2,29,16,13
720575940621703920,right,Tm9,296,1,-18,-10,-8
720575940637504653,right,Tm9,297,7,-9,-12,3
720575940619699068,right,Tm9,298,-5,5,7,-2
720575940642273677,right,Tm9,299,-4,12,10,2
720575940627067919,right,Tm9,300,4,-18,-13,-5
720575940618076902,right,Tm9,301,-5,16,13,3
720575940609274563,right,Tm9,302,2,17,6,11
720575940615972294,right,Tm9,303,-5,22,16,6
720575940619717872,right,Tm9,305,-7,4,9,-5
720575940616246228,right,Tm9,307,5,-25,-18,-7
720575940643781320,right,Tm9,308,-5,8,9,-1
720575940652963830,right,Tm9,309,-6,12,12,0
720575940629892663,right,Tm9,310,2,22,9,13
720575940637446990,right,Tm9,311,-7,15,14,1
720575940603557920,right,Tm9,312,4,-7,-8,1
720575940638124265,right,Tm9,313,7,3,-6,9
720575940624407740,right,Tm9,314,-9,5,11,-6
720575940629678718,right,Tm9,315,-3,-6,0,-6
720575940623803114,right,Tm9,316,5,-4,-7,3
720575940626513173,right,Tm9,317,-5,-4,3,-7
720575940627086863,right,Tm9,318,4,-19,-14,-5
720575940608983235,right,Tm9,319,-2,5,4,1
720575940632157711,right,Tm9,320,-2,-5,-1,-4
720575940620641300,right,Tm9,322,2,26,11,15
720575940632133516,right,Tm9,323,-7,-13,0,-13
720575940621952392,right,Tm9,324,3,24,9,15
720575940638320256,right,Tm9,325,5,1,-5,6
720575940614703522,right,Tm9,326,2,16,6,10
720575940622198652,right,Tm9,327,5,3,-4,7
720575940638358643,right,Tm9,328,5,-9,-10,1
720575940610056654,right,Tm9,329,0,24,12,12
720575940630537078,right,Tm9,330,3,3,-2,5
720575940617931604,right,Tm9,331,1,-15,-9,-6
720575940629799362,right,Tm9,332,4,-26,-17,-9
720575940635762842,right,Tm9,333,0,-21,-11,-10
720575940604668094,right,Tm9,334,1,-26,-14,-12
720575940621336173,right,Tm9,335,2,8,2,6
720575940625797936,right,Tm9,336,0,23,11,12
720575940617561017,right,Tm9,337,-5,-6,2,-8
720575940622600644,right,Tm9,338,-1,0,1,-1
720575940618836737,right,Tm9,339,6,11,-1,12
720575940628945640,right,Tm9,340,-4,17,12,5
720575940607251292,right,Tm9,341,6,-17,-15,-2
720575940627250532,right,Tm9,342,2,-15,-10,-5
720575940615223199,right,Tm9,343,-3,27,16,11
720575940618326875,right,Tm9,344,-2,-15,-6,-9
720575940627437327,right,Tm9,345,3,-12,-9,-3
720575940615018146,right,Tm9,346,-7,-9,2,-11
720575940620570715,right,Tm9,347,-5,-13,-2,-11
720575940629010947,right,Tm9,348,3,14,4,10
720575940626521820,right,Tm9,349,-5,-14,-2,-12
720575940633455052,right,Tm9,350,1,15,6,9
720575940631675693,right,Tm9,351,-1,-17,-8,-9
720575940622104745,right,Tm9,352,-2,28,16,12
720575940621054324,right,Tm9,353,2,24,10,14
720575940611501154,right,Tm9,354,-2,-26,-11,-15
720575940636474286,right,Tm9,355,-7,-6,4,-10
720575940637539806,right,Tm9,356,0,22,11,11
720575940623166669,right,Tm9,357,4,17,4,13
720575940626292226,right,Tm9,358,-3,17,11,6
720575940621012929,right,Tm9,359,2,23,9,14
720575940627300485,right,Tm9,360,-5,19,14,5
720575940610477688,right,Tm9,361,0,-7,-4,-3
720575940624548332,right,Tm9,362,2,-20,-12,-8
720575940618334001,right,Tm9,363,7,-4,-9,5
720575940632399119,right,Tm9,364,4,4,-2,6
720575940627658259,right,Tm9,365,4,7,-1,8
720575940612568549,right,Tm9,366,-5,-20,-5,-15
720575940632526244,right,Tm9,367,-6,-15,-2,-13
720575940621398237,right,Tm9,368,-4,-20,-6,-14
720575940624427498,right,Tm9,369,5,-5,-8,3
720575940626912556,right,Tm9,370,-3,21,13,8
720575940616958347,right,Tm9,371,6,-5,-9,4
720575940613140442,right,Tm9,372,1,-2,-2,0
720575940624154355,right,Tm9,373,1,-21,-12,-9
720575940619301766,right,Tm9,374,2,13,4,9
720575940625164076,right,Tm9,375,-6,7,9,-2
720575940617341657,right,Tm9,376,-7,-10,2,-12
720575940637762879,right,Tm9,378,-3,18,12,6
720575940633269971,right,Tm9,379,3,-17,-12,-5
720575940612563891,right,Tm9,380,-1,29,15,14
720575940634679191,right,Tm9,381,-8,-9,3,-12
720575940620189934,right,Tm9,382,3,-6,-6,0
720575940629083215,right,Tm9,383,-6,11,11,0
720575940608057353,right,Tm9,384,-6,-2,5,-7
720575940617315033,right,Tm9,385,-3,-18,-6,-12
720575940620053707,right,Tm9,386,-6,19,15,4
720575940623045133,right,Tm9,387,-1,-15,-7,-8
720575940630497986,right,Tm9,388,3,19,6,13
720575940637324870,right,Tm9,389,-6,-16,-2,-14
720575940624783335,right,Tm9,390,-6,-9,1,-10
720575940618439478,right,Tm9,391,4,-3,-6,3
720575940610307886,right,Tm9,392,-4,7,7,0
720575940630041615,right,Tm9,394,-7,-8,3,-11
720575940632810797,right,Tm9,395,0,-22,-11,-11
720575940646534254,right,Tm9,396,-1,10,6,4
720575940625443315,right,Tm9,397,-3,-19,-7,-12
720575940626196456,right,Tm9,398,-3,22,14,8
720575940629865015,right,Tm9,399,-4,-24,-8,-16
720575940609981123,right,Tm9,401,-2,-19,-8,-11
720575940613445101,right,Tm9,402,3,26,10,16
720575940610735970,right,Tm9,403,-2,-12,-4,-8
720575940638007642,right,Tm9,404,-1,20,11,9
720575940613338341,right,Tm9,405,3,10,2,8
720575940639136701,right,Tm9,406,1,-25,-14,-11
720575940627600271,right,Tm9,407,-5,-10,0,-10
720575940632200007,right,Tm9,408,-6,-4,4,-8
720575940616487099,right,Tm9,409,0,-3,-2,-1
720575940612487405,right,Tm9,410,-2,-2,1,-3
720575940612551141,right,Tm9,411,-5,-19,-5,-14
720575940616191572,right,Tm9,412,-6,21,16,5
720575940604494694,right,Tm9,413,-2,-7,-2,-5
720575940623176233,right,Tm9,414,4,21,6,15
720575940637631333,right,Tm9,415,6,12,0,12
720575940604080318,right,Tm9,416,3,-8,-7,-1
720575940634532247,right,Tm9,417,-6,-10,1,-11
720575940628430065,right,Tm9,418,-2,15,9,6
720575940606996354,right,Tm9,419,-3,-11,-3,-8
720575940641389275,right,Tm9,420,6,-3,-8,5
720575940631182592,right,Tm9,421,-1,12,7,5
720575940626174522,right,Tm9,422,-7,-4,5,-9
720575940619831499,right,Tm9,423,3,-18,-12,-6
720575940608800451,right,Tm9,424,-3,-2,2,-4
720575940623338474,right,Tm9,426,-3,0,3,-3
720575940620358253,right,Tm9,427,5,-18,-14,-4
720575940613033907,right,Tm9,428,-2,23,13,10
720575940617429131,right,Tm9,429,-2,14,9,5
720575940622199688,right,Tm9,430,-3,-7,-1,-6
720575940617451409,right,Tm9,431,-2,-10,-3,-7
720575940614323106,right,Tm9,432,-5,7,8,-1
720575940626471196,right,Tm9,433,0,-8,-4,-4
720575940625199900,right,Tm9,434,-3,7,6,1
720575940623784940,right,Tm9,435,5,-17,-14,-3
720575940635858544,right,Tm9,436,0,-15,-8,-7
720575940627095340,right,Tm9,437,-3,12,9,3
720575940612568499,right,Tm9,438,2,27,11,16
720575940614599318,right,Tm9,439,-3,-9,-2,-7
720575940621776664,right,Tm9,440,1,23,10,13
720575940659650945,right,Tm9,441,3,-16,-11,-5
720575940625266616,right,Tm9,442,-5,25,17,8
720575940626674988,right,Tm9,443,-6,4,8,-4
720575940623588109,right,Tm9,444,4,-10,-9,-1
720575940639049038,right,Tm9,445,-2,8,6,2
720575940632804453,right,Tm9,446,2,-14,-9,-5
720575940625889155,right,Tm9,447,-1,2,2,0
720575940624558087,right,Tm9,448,0,30,15,15
720575940616417653,right,Tm9,449,6,-16,-14,-2
720575940612630130,right,Tm9,450,2,-9,-7,-2
720575940629612158,right,Tm9,451,4,20,6,14
720575940629904939,right,Tm9,452,1,-9,-6,-3
720575940605776672,right,Tm9,453,3,25,9,16
720575940630818422,right,Tm9,454,5,-12,-11,-1
720575940637127053,right,Tm9,455,7,-7,-11,4
720575940614704290,right,Tm9,456,0,21,10,11
720575940613881775,right,Tm9,457,-2,17,10,7
720575940638538804,right,Tm9,458,5,0,-5,5
720575940614368175,right,Tm9,459,5,-3,-7,4
720575940636791386,right,Tm9,460,-3,-20,-7,-13
720575940617452774,right,Tm9,461,7,-5,-10,5
720575940635391480,right,Tm9,462,-1,18,10,8
720575940605922993,right,Tm9,463,5,17,3,14
720575940648050553,right,Tm9,464,4,0,-4,4
720575940607121794,right,Tm9,465,3,0,-3,3
720575940629750844,right,Tm9,466,1,14,6,8
720575940626223716,right,Tm9,467,-2,-20,-8,-12
720575940621687073,right,Tm9,468,-3,11,8,3
720575940629424254,right,Tm9,469,-7,13,13,0
720575940637255821,right,Tm9,470,4,-9,-9,0
720575940649782393,right,Tm9,471,3,-26,-16,-10
720575940626254892,right,Tm9,472,1,25,11,14
720575940618034747,right,Tm9,473,-4,23,15,8
720575940622056572,right,Tm9,474,-3,-17,-6,-11
720575940614678431,right,Tm9,475,-4,-1,3,-4
720575940614557708,right,Tm9,476,-1,15,8,7
720575940626614202,right,Tm9,477,-3,2,4,-2
720575940625942372,right,Tm9,479,-2,10,7,3
720575940633285739,right,Tm9,480,3,-19,-13,-6
720575940637612429,right,Tm9,481,4,-8,-8,0
720575940640252800,right,Tm9,482,1,17,7,10
720575940631685587,right,Tm9,483,2,-7,-6,-1
720575940625142525,right,Tm9,484,3,-9,-8,-1
720575940606093490,right,Tm9,485,-3,-3,1,-4
720575940639565475,right,Tm9,486,0,1,0,1
720575940600084489,right,Tm9,487,1,-1,-2,1
720575940634829463,right,Tm9,488,7,5,-5,10
720575940610985058,right,Tm9,489,-3,10,8,2
720575940631531562,right,Tm9,490,-5,6,8,-2
720575940609255875,right,Tm9,491,7,-1,-8,7
720575940617372673,right,Tm9,492,-7,-2,6,-8
720575940623180799,right,Tm9,493,-3,23,14,9
720575940624565296,right,Tm9,494,0,29,14,15
720575940645555252,right,Tm9,497,6,1,-6,7
720575940622440150,right,Tm9,498,6,10,-1,11
720575940622466584,right,Tm9,499,5,10,0,10
720575940618751312,right,Tm9,500,7,-8,-11,3
720575940625428286,right,Tm9,501,1,2,0,2
720575940617618971,right,Tm9,502,5,8,-1,9
720575940617251387,right,Tm9,503,3,17,5,12
720575940626440492,right,Tm9,504,-2,9,6,3
720575940634615959,right,Tm9,506,1,-12,-7,-5
720575940628004358,right,Tm9,507,-5,-12,-1,-11
720575940638769990,right,Tm9,508,-5,11,10,1
720575940618650166,right,Tm9,509,-4,10,9,1
720575940609620747,right,Tm9,510,-2,11,7,4
720575940627331599,right,Tm9,511,5,-11,-11,0
720575940641658676,right,Tm9,512,6,0,-6,6
720575940615494303,right,Tm9,513,-4,-13,-3,-10
720575940606796489,right,Tm9,514,-4,-10,-1,-9
720575940622139844,right,Tm9,515,-8,-7,4,-11
720575940622687751,right,Tm9,516,7,-18,-16,-2
720575940630712151,right,Tm9,518,-4,22,15,7
720575940630130176,right,Tm9,519,-5,-5,2,-7
720575940634424056,right,Tm9,520,-2,-22,-9,-13
720575940616225209,right,Tm9,521,6,-9,-11,2
720575940630811723,right,Tm9,522,-4,0,4,-4
720575940617414585,right,Tm9,523,2,14,5,9
720575940626393858,right,Tm9,524,4,-20,-14,-6
720575940620955201,right,Tm9,525,-1,-20,-9,-11
720575940633880415,right,Tm9,526,0,-10,-5,-5
720575940628551680,right,Tm9,527,-4,-8,0,-8
720575940614972839,right,Tm9,528,2,7,1,6
720575940642834740,right,Tm9,529,2,-2,-3,1
720575940627300618,right,Tm9,530,-3,-13,-4,-9
720575940618883032,right,Tm9,531,1,0,-1,1
720575940645275939,right,Tm9,532,-8,7,11,-4
720575940639142589,right,Tm9,533,0,-16,-8,-8
720575940636669582,right,Tm9,534,3,2,-2,4
720575940629591930,right,Tm9,535,8,-4,-10,6
720575940638409700,right,Tm9,536,3,4,-1,5
720575940636288887,right,Tm9,537,0,-23,-12,-11
720575940605480369,right,Tm9,538,-4,1,4,-3
720575940633810367,right,Tm9,539,-6,15,13,2
720575940660103553,right,Tm9,540,-2,-9,-3,-6
720575940620204422,right,Tm9,541,-4,14,11,3
720575940620470187,right,Tm9,542,6,-13,-13,0
720575940638027965,right,Tm9,543,-1,-4,-1,-3
720575940632920621,right,Tm9,544,3,-13,-10,-3
720575940627182327,right,Tm9,545,5,11,0,11
720575940612052578,right,Tm9,546,3,6,0,6
720575940618287064,right,Tm9,547,-1,21,11,10
720575940608822281,right,Tm9,548,1,-16,-9,-7
720575940623302035,right,Tm9,549,0,-9,-5,-4
720575940618481733,right,Tm9,550,-2,3,3,0
720575940607889609,right,Tm9,551,-4,-9,-1,-8
720575940623866556,right,Tm9,552,4,-1,-5,4
720575940640670928,right,Tm9,553,-3,16,11,5
720575940639951182,right,Tm9,554,-9,-3,7,-10
720575940631777676,right,Tm9,555,-4,9,8,1
720575940639044942,right,Tm9,557,6,-10,-11,1
720575940632179783,right,Tm9,558,-4,-21,-7,-14
720575940621485739,right,Tm9,559,-6,22,17,5
720575940640962805,right,Tm9,560,-7,14,14,0
720575940608058889,right,Tm9,562,-5,-2,4,-6
720575940623320873,right,Tm9,563,5,-13,-12,-1
720575940625753744,right,Tm9,564,3,-23,-15,-8
720575940639690301,right,Tm9,565,0,-26,-13,-13
720575940620030633,right,Tm9,566,5,-8,-9,1
720575940630186571,right,Tm9,567,-2,22,13,9
720575940632118668,right,Tm9,568,-6,-8,2,-10
720575940623115213,right,Tm9,570,2,25,10,15
720575940626804825,right,Tm9,571,0,-14,-7,-7
720575940615404812,right,Tm9,572,-8,3,9,-6
720575940618170653,right,Tm9,573,4,14,3,11
720575940645592628,right,Tm9,574,-6,5,8,-3
720575940625477507,right,Tm9,575,6,9,-2,11
720575940630425564,right,Tm9,576,0,28,14,14
720575940627273487,right,Tm9,577,5,-14,-12,-2
720575940628133864,right,Tm9,578,4,-11,-10,-1
720575940632968860,right,Tm9,579,-3,-10,-2,-8
720575940620002068,right,Tm9,580,-2,-23,-10,-13
720575940629942019,right,Tm9,581,3,9,1,8
720575940620680277,right,Tm9,582,-1,23,12,11
720575940626710799,right,Tm9,583,3,-25,-16,-9
720575940620597586,right,Tm9,584,4,23,7,16
720575940624500372,right,Tm9,585,-1,-23,-11,-12
720575940630702188,right,Tm9,586,2,18,7,11
720575940637867241,right,Tm9,587,4,22,7,15
720575940615329602,right,Tm9,588,1,4,1,3
720575940632411410,right,Tm9,589,-1,-5,-2,-3
720575940624348100,right,Tm9,590,1,9,3,6
720575940639766606,right,Tm9,591,3,-3,-5,2
720575940614473011,right,Tm9,592,3,-28,-17,-11
720575940645130775,right,Tm9,593,3,-14,-10,-4
720575940613268915,right,Tm9,594,7,-16,-15,-1
720575940627055204,right,Tm9,595,7,-12,-13,1
720575940611805845,right,Tm9,596,-4,-16,-4,-12
720575940628564042,right,Tm9,597,4,1,-4,5
720575940631817539,right,Tm9,598,2,-18,-11,-7
720575940608683017,right,Tm9,600,3,-10,-8,-2
720575940632870701,right,Tm9,601,1,16,7,9
720575940615785834,right,Tm9,602,4,-2,-5,3
720575940608677641,right,Tm9,603,-3,-23,-9,-14
720575940623374377,right,Tm9,604,-6,-17,-3,-14
720575940628445425,right,Tm9,605,3,15,4,11
720575940636694117,right,Tm9,606,-1,-19,-9,-10
720575940632532536,right,Tm9,607,1,18,8,10
720575940612896682,right,Tm9,608,1,10,4,6
720575940612646826,right,Tm9,609,-2,0,2,-2
720575940622202582,right,Tm9,610,2,-23,-14,-9
720575940626564964,right,Tm9,611,-1,-18,-8,-10
720575940619730590,right,Tm9,612,-3,-26,-10,-16
720575940630438850,right,Tm9,613,-8,-4,6,-10
720575940629856471,right,Tm9,614,-2,-8,-2,-6
720575940627335557,right,Tm9,615,-7,-7,3,-10
720575940631324985,right,Tm9,616,-3,15,10,5
720575940610797010,right,Tm9,617,-2,-17,-7,-10
720575940653151649,right,Tm9,618,-1,24,13,11
720575940623853565,right,Tm9,619,-4,-19,-6,-13
720575940617488541,right,Tm9,620,7,1,-7,8
720575940623771061,right,Tm9,621,1,24,11,13
720575940627458618,right,Tm9,622,-5,20,15,5
720575940635525215,right,Tm9,623,1,13,5,8
720575940612881381,right,Tm9,624,1,-17,-10,-7
720575940623580659,right,Tm9,625,-2,24,14,10
720575940645816099,right,Tm9,626,-5,-8,1,-9
720575940617188923,right,Tm9,627,0,-1,-1,0
720575940617634772,right,Tm9,628,0,0,0,0
720575940646766883,right,Tm9,629,4,24,8,16
720575940632645401,right,Tm9,630,4,8,0,8
720575940620814356,right,Tm9,631,1,26,12,14
720575940616591755,right,Tm9,632,3,-20,-13,-7
720575940607291314,right,Tm9,633,-1,-24,-11,-13
720575940618082077,right,Tm9,634,-3,-15,-5,-10
720575940635503540,right,Tm9,635,6,-6,-9,3
720575940628769040,right,Tm9,637,3,-21,-14,-7
720575940610254275,right,Tm9,638,-1,7,4,3
720575940641730549,right,Tm9,639,-4,19,13,6
720575940630679670,right,Tm9,640,-1,-16,-7,-9
720575940611350882,right,Tm9,641,-8,-5,5,-10
720575940622953485,right,Tm9,642,-5,-11,-1,-10
720575940633908194,right,Tm9,643,6,14,1,13
720575940629148145,right,Tm9,644,-6,18,15,3
720575940633682574,right,Tm9,645,-4,27,17,10
720575940625744944,right,Tm9,646,6,17,2,15
720575940618268061,right,Tm9,647,-4,-7,0,-7
720575940620452544,right,Tm9,648,1,7,2,5
720575940632323640,right,Tm9,650,-3,-25,-10,-15
720575940644367396,right,Tm9,651,-4,-5,1,-6
720575940635098266,right,Tm9,652,-6,-11,0,-11
720575940608856533,right,Tm9,653,-6,-12,0,-12
720575940617727645,right,Tm9,654,-3,8,7,1
720575940623069208,right,Tm9,655,6,-1,-7,6
720575940617570358,right,Tm9,656,0,-11,-6,-5
720575940620016464,right,Tm9,657,-2,-25,-11,-14
720575940623897066,right,Tm9,658,1,20,9,11
720575940616789734,right,Tm9,659,-4,-6,1,-7
720575940628740039,right,Tm9,660,2,28,12,16
720575940627112748,right,Tm9,661,-3,14,10,4
720575940625520442,right,Tm9,662,2,-1,-3,2
720575940618568768,right,Tm9,664,1,-27,-15,-12
720575940650176889,right,Tm9,665,7,-2,-8,6
720575940621429620,right,Tm9,666,7,-13,-14,1
720575940628713732,right,Tm9,667,1,-28,-15,-13
720575940637942837,right,Tm9,668,1,19,8,11
720575940605191340,right,Tm9,669,4,-16,-12,-4
720575940638900352,right,Tm9,671,-4,-23,-8,-15
720575940629531002,right,Tm9,672,-8,11,13,-2
720575940626923070,right,Tm9,673,2,5,0,5
720575940630241239,right,Tm9,674,-4,-14,-3,-11
720575940621682017,right,Tm9,675,-7,19,16,3
720575940636607716,right,Tm9,676,-3,-21,-8,-13
720575940638132058,right,Tm9,677,0,11,5,6
720575940620974171,right,Tm9,678,3,-7,-7,0
720575940622028528,right,Tm9,679,4,18,5,13
720575940631934039,right,Tm9,680,-1,25,13,12
720575940620577518,right,Tm9,681,-2,-21,-9,-12
720575940622030106,right,Tm9,682,6,-8,-10,2
720575940622899745,right,Tm9,683,2,6,1,5
720575940634783898,right,Tm9,684,-6,17,14,3
720575940632250439,right,Tm9,685,-5,-9,0,-9
720575940623640600,right,Tm9,686,5,-22,-16,-6
720575940618985432,right,Tm9,687,-6,-3,4,-7
720575940635241908,right,Tm9,688,-7,10,12,-2
720575940628279292,right,Tm9,689,-2,18,11,7
720575940614954143,right,Tm9,690,-7,-3,5,-8
720575940614317499,right,Tm9,691,-9,4,11,-7
720575940629846784,right,Tm9,692,-4,24,16,8
720575940632747801,right,Tm9,693,-3,25,15,10
720575940605444966,right,Tm9,695,-6,10,11,-1
720575940636491877,right,Tm9,696,-2,16,10,6
720575940604872416,right,Tm9,697,1,-22,-12,-10
720575940627031570,right,Tm9,698,6,-7,-10,3
720575940611758834,right,Tm9,699,-5,0,5,-5
720575940625950245,right,Tm9,700,5,15,2,13
720575940640432848,right,Tm9,701,0,-4,-2,-2
720575940623285005,right,Tm9,702,-5,23,16,7
720575940629831806,right,Tm9,703,-3,1,3,-2
720575940625529232,right,Tm9,704,-7,8,11,-3
720575940610175381,right,Tm9,705,1,1,-1,2
720575940626245676,right,Tm9,707,-2,25,14,11
720575940627272122,right,Tm9,708,-4,-25,-9,-16
720575940606551217,right,Tm9,709,-2,-24,-10,-14
720575940634071659,right,Tm9,710,4,-25,-17,-8
720575940627687496,right,Tm9,711,-1,19,10,9
720575940630610852,right,Tm9,712,-7,12,13,-1
720575940625959610,right,Tm9,713,-6,16,14,2
720575940612125914,right,Tm9,714,5,12,1,11
720575940618919837,right,Tm9,715,4,10,1,9
720575940619897680,right,Tm9,716,4,-6,-7,1
720575940635672500,right,Tm9,717,2,-22,-13,-9
720575940623610867,right,Tm9,718,-5,24,17,7
720575940617906589,right,Tm9,719,1,27,12,15
720575940619852397,right,Tm9,720,-5,21,15,6
720575940634430456,right,Tm9,721,5,13,1,12
720575940612198835,right,Tm9,722,6,-15,-14,-1
720575940643778208,right,Tm9,723,-2,-11,-4,-7
720575940617854420,right,Tm9,724,4,2,-3,5
720575940617043542,right,Tm9,725,-3,-24,-9,-15
720575940622926853,right,Tm9,726,2,-28,-16,-12
720575940625298064,right,Tm9,728,7,12,-1,13
720575940638766720,right,Tm9,729,-3,29,17,12
720575940624013749,right,Tm9,730,7,0,-7,7
720575940624791596,right,Tm9,731,-6,9,10,-1
720575940625523856,right,Tm9,732,-3,6,6,0
720575940620757231,right,Tm9,733,-5,-17,-4,-13
720575940629309339,right,Tm9,734,2,0,-2,2
720575940609853963,right,Tm9,735,1,-23,-13,-10
720575940614212754,right,Tm9,736,-8,1,8,-7
720575940626345772,right,Tm9,737,0,19,9,10
720575940614207903,right,Tm9,738,-3,13,9,4
720575940616954297,right,Tm9,739,-7,2,8,-6
720575940622388458,right,Tm9,740,2,-8,-6,-2
720575940612371941,right,Tm9,741,-2,-14,-5,-9
720575940623070051,right,Tm9,742,-4,11,9,2
720575940631616975,right,Tm9,743,6,-19,-16,-3
720575940631729987,right,Tm9,744,-4,25,16,9
720575940620229467,right,Tm9,746,-3,3,4,-1
720575940635145241,right,Tm9,747,0,2,1,1
720575940625756208,right,Tm9,748,-4,20,14,6
720575940621069812,right,Tm9,749,-2,1,2,-1
720575940608117699,right,Tm9,750,4,-24,-16,-8
720575940639232575,right,Tm9,751,1,6,2,4
720575940605034161,right,Tm9,752,-2,7,5,2
720575940625188042,right,Tm9,753,-3,24,15,9
720575940624511940,right,Tm9,754,-1,-13,-6,-7
720575940640152448,right,Tm9,755,4,19,5,14
720575940620627538,right,Tm9,756,5,20,5,15
720575940615440543,right,Tm9,757,0,-6,-3,-3
720575940625762708,right,Tm9,758,5,-1,-6,5
720575940617040245,right,Tm9,759,7,14,0,14
720575940659599233,right,Tm9,760,0,17,8,9
720575940631940712,right,Tm9,761,-4,-18,-5,-13
720575940624226795,right,Tm9,762,0,14,7,7
720575940627084332,right,Tm9,763,-5,14,12,2
720575940618837332,right,Tm9,764,-8,-6,5,-11
720575940626434348,right,Tm9,765,-3,9,7,2
720575940622129832,right,Tm9,766,2,-4,-4,0
720575940613374873,right,Tm9,767,1,28,13,15
720575940624344516,right,Tm9,768,3,5,-1,6
720575940634593436,right,Tm9,769,4,-27,-18,-9
720575940631295020,right,Tm9,771,3,-27,-17,-10
720575940612048753,right,Tm9,773,5,-19,-15,-4
720575940630474307,right,Tm9,775,5,22,6,16
720575940624051381,right,Tm9,776,5,21,5,16
720575940610760312,right,Tm9,777,6,20,4,16
720575940616812315,right,Tm9,778,4,25,8,17
720575940635388607,right,Tm9,779,5,24,7,17
720575940618782797,right,Tm9,780,-6,25,18,7
720575940612556401,right,Tm9,781,-5,26,18,8
720575940626113061,right,Tm9,783,-4,28,18,10
720575940637461934,right,Tm9,784,-4,29,18,11
720575940629860664,right,Tm9,785,-3,30,18,12
720575940624614704,right,Tm9,786,-2,30,17,13
720575940629702699,right,Tm9,787,3,28,11,17
720575940626660298,right,Tm9,788,3,27,10,17
720575940639383349,right,Tm9,789,-3,-27,-11,-16
720575940640543603,right,Tm9,790,-2,-27,-12,-15
720575940614768179,right,Tm9,791,-1,-28,-13,-15
720575940617322101,right,Tm9,792,8,2,-7,9
720575940629639674,right,Tm9,793,8,-6,-11,5
720575940634654945,right,Tm9,795,6,-21,-17,-4
720575940616321602,right,Tm9,796,4,26,9,17
